aLevelData = [
[
2,2,3,3,3,3,3,3,3,3,3,3,3,3,3,3,2,171,236,144
],[
94,249,133,117,223,39,43,55,185,118,230,81,204,85,55,204,79,53,161,178
],[
111,153,104,198,57,108,153,114,186,152,74,1,101,212,35,14,181,189,30,60
],[
19,41,138,40,249,184,86,156,88,172,140,6,55,250,28,40,157,160,219,16
],[
178,58,203,75,33,208,157,86,192,243,116,85,115,8,236,7,78,227,91,250
],[
249,152,87,251,89,141,120,209,108,212,94,43,117,184,246,214,90,150,250,51
],[
74,239,183,233,162,186,19,215,18,255,206,77,252,161,8,123,28,124,4,41
],[
110,175,43,169,76,59,84,10,215,206,66,143,153,217,110,95,105,232,7,126
],[
142,51,56,252,39,112,169,109,202,236,72,153,107,218,73,116,127,235,107,80
],[
98,31,126,81,246,218,34,33,142,58,209,230,10,168,32,113,67,173,65,184
],[
169,7,205,135,42,253,192,114,86,239,198,14,193,49,181,97,169,26,90,150
],[
217,87,120,245,205,133,14,19,23,0,217,70,2,245,26,92,116,191,153,141
],[
25,112,234,173,189,173,239,167,250,192,158,38,20,232,4,149,33,243,138,74
],[
109,15,120,254,28,222,183,129,17,200,219,171,15,149,97,150,30,59,52,10
],[
49,244,118,57,5,148,126,173,76,26,29,126,11,133,38,200,65,233,45,92
],[
201,193,142,182,129,135,178,48,172,130,141,117,149,224,107,55,118,4,237,37
],[
151,33,78,23,186,8,235,140,183,62,3,87,100,82,187,149,183,109,101,226
],[
47,43,1,205,111,169,4,137,45,224,89,229,74,49,166,125,66,64,208,50
],[
199,6,193,217,169,34,105,48,249,112,2,22,110,221,153,251,7,122,202,149
],[
242,207,203,212,173,113,172,25,107,215,220,163,185,105,240,73,97,218,160,111
]
]