aLevelData = [
[
4,2,2,2,2,2,2,2,2,2,2,2,2,2,2,2,2,2,2,2
],[
5,2,5,3,2,2,2,2,2,2,2,2,2,2,2,2,2,2,2,2
],[
2,5,5,3,3,3,3,3,3,3,3,3,3,3,3,3,3,3,2,2
],[
3,3,5,5,5,5,5,5,5,5,3,2,2,2,2,2,2,2,2,2
],[
2,3,5,5,5,5,5,5,5,5,3,6,2,2,2,2,2,2,2,2
],[
117,128,203,86,96,111,40,253,113,109,228,237,121,17,5,161,84,216,230,156
],[
203,119,55,91,185,112,69,136,109,228,123,112,80,168,41,183,199,155,133,74
],[
91,54,240,150,24,100,122,248,50,148,167,116,239,13,116,169,192,130,149,4
],[
177,231,1,53,4,131,176,223,25,69,163,148,146,91,38,0,180,1,82,100
],[
15,151,213,71,97,247,246,104,184,5,211,246,215,136,237,3,219,56,231,55
],[
30,23,139,193,92,5,14,147,20,143,149,207,49,9,247,124,234,220,197,126
],[
231,32,136,197,165,110,73,196,27,239,87,37,158,185,68,187,2,92,49,184
],[
2,183,75,32,225,17,150,125,82,101,234,213,150,252,59,217,228,65,29,95
],[
13,210,134,18,96,211,214,104,203,135,22,213,68,33,125,63,103,215,57,177
],[
97,57,108,83,12,193,116,154,91,171,111,188,249,6,254,103,45,12,74,178
],[
1,175,69,84,163,116,51,19,11,132,104,128,222,1,83,226,147,150,187,112
],[
212,82,73,195,39,182,71,138,205,12,167,128,234,251,71,155,231,89,115,134
],[
21,64,172,82,147,100,167,105,113,163,153,195,21,222,178,92,222,8,231,229
],[
8,124,245,185,208,148,163,20,216,119,71,127,204,50,139,143,70,11,113,207
],[
239,17,149,251,232,248,179,111,104,36,104,222,166,4,61,71,249,161,225,37
]
]