aLevelData = [
[
12,2,2,2,2,2,2,2,2,2,2,2,253,11,209,37,228,96,240,168
],[
2,2,2,2,2,2,2,2,2,2,2,2,247,147,82,204,237,207,137,170
],[
2,2,3,3,3,3,3,3,3,3,2,3,7,158,3,201,70,81,222,157
],[
11,2,3,2,2,2,2,2,2,3,2,3,219,161,253,77,223,150,92,186
],[
2,2,3,2,2,2,2,2,2,3,2,3,68,168,160,188,12,37,243,174
],[
2,2,3,2,2,2,2,2,2,3,2,3,184,210,14,46,4,213,151,30
],[
10,2,3,2,2,2,2,2,2,2,2,2,209,210,174,238,99,85,195,30
],[
2,2,3,2,2,2,2,2,3,3,3,3,204,112,170,254,168,165,241,185
],[
2,2,3,2,2,2,2,3,2,2,2,2,11,5,113,145,184,154,35,108
],[
9,2,3,2,2,2,2,3,2,2,2,2,148,3,53,144,90,94,93,171
],[
2,2,3,2,2,2,3,2,2,2,2,2,143,107,110,22,185,237,41,90
],[
2,2,3,2,2,3,2,2,2,2,2,2,204,84,85,244,229,154,18,85
],[
8,2,3,2,2,3,2,2,2,2,2,2,58,107,106,45,81,136,41,233
],[
2,2,3,2,3,3,2,2,2,2,2,2,113,109,238,122,87,50,131,89
],[
2,2,3,2,3,2,2,2,2,2,2,2,41,175,106,200,176,227,184,90
],[
193,151,39,181,252,62,102,151,186,32,179,23,64,183,172,46,57,89,98,117
],[
99,24,176,48,136,231,203,140,176,254,25,37,149,127,71,203,87,89,150,134
],[
113,108,117,215,236,239,85,65,210,15,185,8,230,217,140,57,146,90,184,234
],[
33,5,244,195,46,85,221,190,92,179,73,42,72,153,216,246,188,248,204,44
],[
38,215,26,188,72,61,192,123,48,82,90,107,107,193,240,61,118,96,19,20
]
]