aLevelData = [
[
2,2,2,2,2,2,2,2,2,2,2,2,2,2,2,2,2,2,3,176
],[
2,2,13,5,5,2,2,12,5,5,2,3,2,5,5,2,2,2,88,66
],[
2,2,2,5,5,2,2,2,5,5,2,3,2,5,5,2,2,2,14,129
],[
2,2,2,2,2,2,2,2,2,2,2,3,2,2,2,2,2,2,89,41
],[
2,2,2,2,2,2,2,2,2,2,2,3,3,3,3,3,3,3,220,205
],[
2,2,2,2,2,2,2,2,2,2,2,2,2,2,6,2,2,2,140,141
],[
2,2,2,2,2,2,2,2,2,2,2,2,2,3,3,3,2,3,1,177
],[
2,2,2,2,2,2,2,2,2,2,2,2,2,2,2,2,2,2,45,6
],[
2,2,2,2,2,2,2,2,2,2,3,2,2,2,2,2,2,2,193,43
],[
2,2,2,2,2,2,2,2,2,3,3,2,3,2,2,2,2,2,207,44
],[
2,2,2,2,2,2,2,2,3,3,2,9,3,3,2,2,2,2,106,34
],[
2,2,2,2,2,2,2,2,3,2,2,2,3,3,2,2,2,2,81,180
],[
4,2,2,2,2,2,2,3,2,2,2,2,3,2,2,2,2,2,232,166
],[
14,220,147,122,84,10,75,207,24,175,199,83,231,114,42,106,32,139,215,187
],[
97,108,135,239,63,167,153,181,58,12,169,10,239,17,99,183,144,120,153,27
],[
146,43,148,42,165,107,168,182,233,41,11,238,95,180,232,36,158,149,174,211
],[
199,183,174,224,186,204,229,32,138,235,22,27,47,126,29,15,123,91,127,56
],[
80,49,69,79,15,38,11,81,83,190,84,129,224,255,32,176,214,211,193,188
],[
43,173,234,87,87,111,9,9,81,140,214,120,187,105,44,232,89,10,25,254
],[
200,234,49,201,109,42,39,3,171,238,158,147,89,5,60,87,115,200,0,33
]
]