aLevelData = [
[
4,2,5,5,2,2,2,2,2,2,2,2,2,105,176,70,57,110,18,9
],[
2,2,2,2,2,2,5,2,2,2,5,2,2,107,165,72,25,105,100,31
],[
2,2,2,2,2,2,3,3,3,3,3,3,3,154,19,29,17,177,77,50
],[
3,3,3,3,3,3,3,2,2,2,2,2,3,197,243,165,11,217,30,54
],[
2,2,3,2,2,2,2,2,2,2,2,2,3,103,222,7,203,239,164,212
],[
13,2,3,2,2,2,2,2,2,3,2,2,3,72,17,184,107,70,11,44
],[
2,5,3,2,2,2,2,2,2,3,2,2,3,43,254,70,150,217,104,230
],[
91,221,164,159,46,174,152,202,211,139,219,184,41,108,209,70,103,56,24,177
],[
166,56,35,172,160,204,37,176,183,92,49,148,57,146,159,93,226,198,177,87
],[
162,186,119,101,161,136,239,149,129,216,113,247,227,86,74,176,44,100,168,74
],[
137,11,182,78,48,56,7,21,233,37,56,219,205,21,209,21,78,68,109,4
],[
120,30,27,139,119,175,3,62,88,91,77,187,20,207,62,61,202,55,164,110
],[
76,177,117,125,221,2,179,113,57,137,146,189,214,113,221,20,106,42,150,126
],[
173,25,221,172,96,142,18,136,142,247,62,17,18,84,175,102,89,235,227,32
],[
105,61,168,229,34,56,128,59,196,174,74,153,178,6,31,196,118,50,123,89
],[
4,225,157,165,67,245,48,189,201,55,42,203,230,73,245,167,229,221,205,167
],[
142,37,105,183,240,138,221,172,93,161,191,213,181,91,136,211,232,124,62,171
],[
182,78,80,26,185,150,194,41,166,199,137,0,208,118,57,255,237,14,221,11
],[
29,197,38,38,40,206,201,67,7,208,34,88,167,152,29,180,233,11,86,147
],[
237,94,127,240,144,137,3,154,51,248,232,138,191,132,250,116,229,163,38,156
]
]