aLevelData = [
[
2,2,2,2,2,2,2,2,2,2,2,2,2,2,2,2,2,2,79,174
],[
2,2,2,2,2,2,2,2,2,2,2,2,2,2,2,2,2,2,13,44
],[
2,2,2,2,2,2,2,2,2,2,2,2,2,2,2,2,2,2,10,238
],[
2,2,2,3,3,3,3,3,3,3,3,3,3,3,3,3,3,3,55,44
],[
2,2,2,2,2,2,2,2,2,2,2,2,2,2,2,2,2,2,209,136
],[
2,2,2,2,2,2,2,2,2,2,2,2,2,2,2,2,2,2,223,23
],[
2,2,2,2,2,3,2,2,3,2,2,3,2,2,2,3,2,2,167,131
],[
2,2,2,3,3,3,3,3,3,3,3,3,3,3,3,3,3,3,188,89
],[
2,2,2,2,2,2,2,2,2,2,2,2,2,2,2,2,2,2,150,204
],[
2,2,2,2,2,2,2,2,2,2,2,2,2,2,2,2,2,2,214,102
],[
153,136,145,169,186,169,231,189,120,191,245,224,107,17,185,165,43,237,26,233
],[
109,60,40,7,111,89,166,80,151,36,198,181,87,82,51,199,83,7,84,226
],[
198,166,208,164,33,232,77,164,246,43,126,97,21,13,92,121,245,58,179,28
],[
85,130,225,191,34,47,218,21,156,149,112,59,181,234,210,51,185,88,82,147
],[
52,81,107,126,17,35,2,212,255,204,236,166,25,15,177,237,197,199,143,123
],[
220,124,194,49,12,52,3,115,123,139,79,217,173,6,233,39,168,165,162,128
],[
86,183,88,214,42,242,189,165,6,195,89,225,93,227,211,45,149,43,108,77
],[
175,169,204,222,41,243,1,68,35,187,197,229,194,164,255,149,210,84,141,80
],[
175,203,65,47,101,243,41,149,22,120,20,169,156,217,81,10,112,192,186,190
],[
202,143,242,107,10,59,234,201,87,93,170,87,134,134,78,77,61,211,78,210
]
]