aLevelData = [
[
5,5,5,5,136,68,24,249,239,48,47,90,21,31,127,90,133,196,247,250
],[
5,2,2,2,200,206,156,0,32,203,216,247,121,70,20,119,156,51,137,166
],[
5,2,5,3,166,142,82,255,184,62,198,82,241,63,6,12,153,0,210,185
],[
2,2,5,2,159,10,161,199,70,227,240,141,27,50,218,140,42,35,233,244
],[
2,2,3,2,113,13,44,106,149,83,137,8,212,136,85,165,59,214,34,87
],[
2,2,3,2,25,160,216,55,179,102,8,100,57,233,124,75,249,144,19,37
],[
4,2,3,2,211,11,204,192,237,54,32,131,168,64,149,173,210,12,144,221
],[
29,215,106,215,207,28,199,133,188,180,35,60,113,66,174,65,179,206,90,140
],[
40,176,50,203,83,176,237,170,198,107,195,82,146,249,127,47,3,204,214,247
],[
138,219,247,232,251,0,99,81,248,159,255,83,173,137,103,233,191,32,134,38
],[
126,187,100,190,98,76,62,200,181,64,220,194,141,166,31,214,253,148,218,91
],[
140,198,226,159,230,137,105,228,210,215,135,168,100,196,26,42,116,25,208,41
],[
79,62,130,239,171,93,196,142,225,196,186,106,86,139,45,247,58,119,221,196
],[
118,31,25,185,223,77,142,157,176,167,93,218,55,143,112,133,206,71,13,153
],[
13,89,171,131,62,54,5,228,17,29,110,146,146,62,100,224,87,32,103,31
],[
254,64,12,100,215,251,77,140,221,173,35,126,235,27,87,176,44,14,148,237
],[
212,65,194,85,13,125,143,165,52,3,78,184,70,42,5,78,149,73,193,13
],[
192,215,45,197,225,209,99,248,8,92,2,154,233,172,129,21,209,36,195,144
],[
223,191,235,113,112,174,113,32,219,67,118,14,95,13,84,247,89,69,122,100
],[
186,104,119,115,185,38,84,218,197,123,39,42,190,28,229,81,100,20,120,99
]
]