aLevelData = [
[
2,2,2,2,2,2,2,2,2,6,255,136,65,200,11,236,191,148,27,160
],[
2,3,5,3,5,5,5,3,5,3,52,190,67,121,245,216,25,198,225,214
],[
2,3,2,3,2,2,2,3,5,3,23,41,232,123,64,165,202,17,6,247
],[
2,2,2,2,2,2,2,2,2,2,33,93,108,42,162,210,104,102,160,5
],[
2,3,5,3,5,5,5,3,2,3,139,9,209,97,227,248,85,28,33,56
],[
2,3,5,3,5,5,5,3,2,3,244,105,247,184,168,240,196,113,91,123
],[
2,5,5,5,5,5,5,5,5,5,115,177,241,242,160,180,137,137,253,117
],[
2,3,5,3,5,5,5,3,5,3,0,56,245,195,183,108,143,151,151,252
],[
2,3,5,3,5,5,5,3,5,3,148,165,82,94,244,49,235,27,102,36
],[
2,5,5,5,5,5,5,5,5,5,120,128,79,95,39,150,229,79,127,85
],[
2,3,5,3,2,2,2,3,2,3,148,194,232,21,161,249,110,69,13,254
],[
5,3,5,3,2,2,2,3,2,3,194,95,188,56,129,27,214,60,185,228
],[
5,5,5,5,5,5,5,5,5,5,110,230,170,136,97,169,201,51,129,35
],[
5,3,5,3,5,5,5,3,5,3,11,158,243,244,95,132,214,209,124,86
],[
5,3,5,3,5,5,5,3,5,3,37,212,222,47,223,22,11,10,101,128
],[
1,5,5,5,5,5,5,5,5,5,27,51,35,222,119,251,114,53,225,176
],[
5,3,2,3,2,2,2,3,2,3,189,87,181,204,227,180,110,109,221,115
],[
2,3,2,3,2,2,2,3,2,3,107,5,161,194,244,83,70,106,120,146
],[
2,3,2,3,3,2,3,3,2,3,104,166,24,240,206,53,106,65,74,174
],[
2,2,2,2,2,2,2,2,2,2,118,245,225,20,5,71,44,170,28,184
]
]