aLevelData = [
[
2,204,75,59,204,231,96,10,125,196,60,91,26,125,162,182,156,120,110,92
],[
2,213,143,37,134,166,109,208,238,115,59,11,144,212,125,89,178,141,54,186
],[
2,34,193,83,128,191,98,70,94,58,236,242,194,30,83,199,100,14,57,46
],[
2,31,78,101,39,1,134,113,48,158,194,194,106,169,188,190,247,197,94,56
],[
2,166,152,131,47,210,33,254,185,135,76,221,58,231,196,239,217,204,9,131
],[
2,53,175,194,115,83,201,84,97,220,119,179,65,133,227,121,23,206,225,53
],[
2,2,239,23,5,122,15,97,103,214,184,116,76,17,136,193,110,205,41,156
],[
2,228,152,131,157,243,111,47,70,40,128,47,231,163,52,221,191,182,109,34
],[
2,100,175,13,232,101,241,183,210,45,74,217,42,42,128,234,27,47,45,240
],[
4,32,23,205,70,188,172,22,156,108,199,136,63,218,184,68,155,83,231,33
],[
2,254,123,188,253,158,63,189,81,222,12,246,8,205,62,158,146,239,220,247
],[
52,65,130,118,162,119,158,36,207,136,223,68,4,108,235,54,48,36,81,155
],[
127,252,190,186,45,13,115,35,157,5,246,145,165,43,8,21,44,157,216,113
],[
248,220,118,194,193,139,138,99,138,116,70,13,49,204,153,67,68,184,166,237
],[
22,16,116,67,18,98,231,236,80,58,239,103,102,160,255,171,129,227,193,10
],[
180,149,8,91,143,215,6,88,244,215,191,69,38,150,189,211,35,239,5,67
],[
52,213,75,206,194,220,98,69,107,250,246,245,85,143,125,205,194,164,107,195
],[
229,112,165,115,245,33,57,9,127,217,76,98,0,246,84,110,179,150,135,217
],[
168,90,146,234,22,107,143,171,242,187,49,74,192,142,66,191,170,56,80,175
],[
207,40,163,144,221,37,114,15,226,216,86,174,95,139,254,178,159,48,37,60
]
]