aLevelData = [
[
2,2,2,2,2,2,2,2,2,2,2,2,53,254,146,186,133,143,160,140
],[
2,2,13,5,5,2,2,12,5,5,2,3,90,109,50,151,55,32,123,212
],[
2,2,2,5,5,2,2,2,5,5,2,3,126,144,151,122,217,211,20,117
],[
2,2,2,2,2,2,2,2,2,2,2,3,217,68,176,20,221,213,100,2
],[
2,2,2,2,2,2,2,2,2,2,2,3,54,166,162,119,136,214,220,175
],[
2,2,2,2,2,2,2,2,2,2,2,2,115,153,69,156,115,138,219,216
],[
5,67,165,221,12,43,57,120,114,144,130,123,18,246,192,179,214,174,208,25
],[
28,170,174,76,95,143,56,63,19,12,53,47,208,107,149,217,179,101,250,233
],[
2,59,120,181,14,2,153,43,94,62,165,8,9,179,32,76,100,120,147,234
],[
221,77,144,195,39,46,240,213,152,41,95,176,207,108,27,42,153,162,248,84
],[
22,128,168,173,23,154,57,149,203,124,223,4,155,246,244,123,82,183,61,59
],[
129,29,111,182,34,76,241,67,123,126,228,21,69,154,97,110,14,7,1,16
],[
220,194,163,245,19,174,105,63,152,44,4,114,55,236,50,225,66,3,132,102
],[
123,61,101,86,52,180,88,180,181,161,129,165,222,115,103,36,14,30,248,247
],[
67,182,206,226,130,60,176,26,121,184,92,252,99,135,131,255,44,247,22,232
],[
213,17,192,61,27,182,180,251,83,238,168,139,153,124,33,243,41,182,242,74
],[
13,147,255,110,249,6,71,249,115,138,34,112,54,254,198,190,217,180,16,225
],[
172,197,130,228,227,167,136,13,246,1,255,87,71,189,247,34,6,95,184,42
],[
81,150,4,182,160,17,156,18,97,148,6,62,223,75,140,232,104,94,136,152
],[
175,197,223,43,111,94,204,130,81,61,223,123,16,67,69,32,219,242,73,31
]
]