aLevelData = [
[
5,5,5,5,110,5,253,78,94,20,116,61,209,58,195,81,220,138,191,212
],[
5,2,2,2,45,73,172,205,65,81,13,129,215,179,187,59,164,160,53,73
],[
5,2,5,3,72,138,55,71,129,134,142,160,158,245,42,81,55,99,117,240
],[
2,2,5,2,28,175,227,237,139,108,202,25,166,136,117,100,35,43,116,235
],[
2,2,3,2,70,226,53,50,12,253,217,173,170,54,64,134,53,147,102,154
],[
2,2,3,2,163,141,243,197,242,113,13,95,167,7,113,6,122,114,194,158
],[
4,2,3,2,80,87,32,151,105,65,253,110,219,68,44,119,63,225,59,217
],[
2,2,3,2,170,42,3,218,223,38,125,93,194,119,216,168,16,58,200,107
],[
2,2,2,2,78,47,32,254,255,26,163,235,26,105,23,172,187,22,156,182
],[
2,3,2,2,25,207,60,182,184,85,195,26,224,34,209,211,77,78,45,89
],[
2,3,2,2,40,179,92,240,54,80,115,43,80,235,41,174,19,250,48,55
],[
2,3,2,3,216,196,198,224,230,196,135,158,231,78,133,14,153,117,154,113
],[
198,43,253,244,118,170,20,54,99,19,137,4,173,85,160,103,207,81,200,224
],[
210,60,112,242,193,68,27,225,92,118,183,186,16,223,42,147,39,241,47,20
],[
61,41,96,54,243,239,147,75,231,190,106,63,227,132,38,29,84,76,188,212
],[
254,26,43,60,239,22,12,84,177,237,107,206,196,117,213,205,75,144,178,237
],[
6,82,214,132,128,102,82,39,138,173,144,112,231,41,159,255,73,26,203,191
],[
125,102,113,106,226,62,17,80,31,255,165,84,21,86,49,55,19,168,156,25
],[
73,177,190,60,128,107,186,12,8,49,142,92,241,36,232,243,126,206,60,71
],[
214,5,19,136,253,18,166,224,3,19,171,250,123,158,111,193,47,167,37,106
]
]