aLevelData = [
[
12,2,2,2,2,2,2,2,134,126,171,213,112,198,255,148,75,55,240,58
],[
2,2,2,2,2,2,2,2,42,95,94,123,6,47,9,101,197,186,74,65
],[
2,2,3,3,3,3,3,3,156,58,1,186,151,84,206,65,118,157,132,175
],[
187,92,218,44,1,146,100,80,143,55,194,137,45,199,24,189,55,253,190,48
],[
239,222,56,167,23,250,104,206,192,239,2,215,93,46,65,100,27,2,216,167
],[
117,206,44,199,2,150,192,134,146,192,240,34,122,28,227,120,44,35,187,111
],[
11,124,14,148,125,197,154,2,65,143,52,133,3,170,2,255,45,164,234,10
],[
1,140,74,222,229,251,234,118,253,86,47,238,255,77,145,48,67,167,78,207
],[
26,66,96,51,97,85,173,247,86,249,127,143,170,232,51,46,215,132,53,230
],[
179,27,44,18,69,105,113,241,216,94,198,147,79,34,69,249,184,87,150,120
],[
36,158,101,94,181,92,19,216,248,190,172,19,117,250,26,162,133,216,152,32
],[
100,114,105,22,135,55,201,30,48,54,36,73,63,154,134,191,75,112,83,165
],[
241,177,56,68,108,124,97,103,102,163,236,4,14,105,158,31,107,138,213,236
],[
240,124,190,52,80,245,200,249,148,173,89,93,106,101,191,192,192,40,105,41
],[
145,209,87,231,255,205,207,120,163,34,82,169,33,176,206,255,255,183,21,86
],[
183,154,142,200,10,227,42,208,152,134,154,175,174,106,192,15,95,37,99,231
],[
214,8,38,158,234,91,187,115,243,233,84,28,220,192,90,173,122,50,98,188
],[
28,31,93,195,100,119,14,197,85,250,194,53,172,66,59,19,116,4,237,88
],[
213,147,109,148,45,165,38,214,98,90,78,204,118,122,24,43,91,254,43,81
],[
9,211,84,42,207,218,119,80,230,51,204,118,76,187,71,6,207,211,88,9
]
]