aLevelData = [
[
2,2,2,2,5,5,2,2,40,9,215,137,208,213,101,75,136,243,122,1
],[
2,2,2,4,2,2,2,2,202,69,126,65,97,184,191,246,32,36,192,96
],[
5,3,3,3,5,5,3,3,211,116,213,92,118,6,236,230,165,85,174,220
],[
2,3,2,2,2,2,2,2,84,213,199,4,192,30,129,81,165,77,152,98
],[
2,3,2,2,2,2,2,2,178,167,74,76,58,128,173,153,44,92,69,145
],[
2,3,2,2,3,2,2,2,69,83,214,184,132,186,119,151,223,255,232,191
],[
2,3,2,2,3,2,2,2,52,213,37,12,130,145,59,39,89,212,91,78
],[
2,3,2,2,3,5,5,3,143,107,45,88,53,115,102,243,201,193,157,49
],[
2,3,3,2,3,2,2,3,173,129,91,67,216,28,113,132,204,96,142,185
],[
2,2,3,2,3,2,2,3,200,219,16,150,62,135,27,133,135,173,232,164
],[
2,2,3,2,3,2,2,3,214,3,96,12,107,23,234,89,9,241,129,103
],[
2,2,3,2,3,2,2,3,169,244,9,89,112,6,227,224,223,241,191,186
],[
2,2,2,2,3,2,2,3,74,8,177,120,139,13,136,133,247,82,91,100
],[
2,2,2,2,3,2,2,3,145,31,100,57,126,84,17,139,185,79,89,72
],[
2,2,2,2,3,2,2,3,8,16,77,9,47,155,239,152,99,158,70,176
],[
6,2,2,2,3,2,2,3,1,84,178,3,128,169,126,129,165,159,180,216
],[
8,2,2,2,3,2,2,3,245,240,53,55,112,245,8,88,124,198,243,189
],[
32,163,72,58,114,147,2,179,83,74,16,39,89,80,241,237,13,96,129,62
],[
87,15,19,244,54,174,191,145,180,112,254,131,26,208,116,167,96,45,12,11
],[
231,183,74,248,107,143,221,48,51,42,116,116,138,247,211,73,115,65,38,252
]
]