aLevelData = [
[
2,2,2,2,2,11,2,2,2,2,2,2,2,2,247,216,251,170,6,167
],[
2,2,2,2,2,2,2,2,2,2,2,2,2,2,214,133,112,185,244,113
],[
5,2,5,2,5,5,5,2,5,5,5,2,5,5,30,160,176,44,95,187
],[
5,2,5,2,5,2,5,2,5,2,5,2,5,2,252,176,224,90,248,108
],[
5,5,5,2,5,5,5,2,5,5,5,2,5,5,217,36,195,213,132,182
],[
144,29,211,141,253,66,98,38,161,75,171,99,228,207,121,49,20,182,159,104
],[
181,67,233,243,24,83,83,48,47,223,121,153,159,200,79,165,23,212,18,233
],[
224,243,126,131,182,200,66,184,215,100,177,220,89,85,186,114,192,223,26,149
],[
208,137,208,151,160,220,209,231,240,103,254,56,188,6,83,223,18,100,97,125
],[
32,191,254,223,145,235,59,34,26,154,150,27,79,218,113,246,188,223,195,28
],[
49,3,14,91,93,11,145,65,158,172,190,200,24,78,238,57,5,15,84,74
],[
75,11,47,137,84,219,68,254,26,91,140,12,129,176,42,153,234,138,159,111
],[
5,167,65,225,230,153,234,177,92,200,237,49,126,186,78,169,134,146,50,249
],[
227,215,148,127,137,119,58,59,140,12,231,49,237,93,211,15,180,40,88,16
],[
62,31,238,32,217,48,89,65,142,9,33,45,62,220,67,61,241,95,38,137
],[
106,24,208,81,255,215,90,156,167,132,161,30,85,26,63,95,132,244,186,26
],[
19,72,250,227,84,241,1,13,96,113,214,203,173,54,194,149,226,28,191,206
],[
233,52,46,163,70,196,200,54,168,142,215,252,190,85,166,99,76,158,54,185
],[
126,180,50,73,124,238,37,199,62,52,235,238,162,192,102,103,188,34,114,237
],[
109,135,26,175,55,58,12,245,79,107,74,7,244,48,35,75,0,201,98,173
]
]