aLevelData = [
[
12,2,2,2,2,2,2,2,2,2,2,2,183,106,234,145,92,39,238,19
],[
2,2,2,2,2,2,2,2,2,2,2,2,105,134,131,131,201,149,9,17
],[
2,2,3,3,3,3,3,3,3,3,2,3,254,157,60,220,184,96,99,89
],[
11,2,3,2,2,2,2,2,2,3,2,3,166,159,201,249,140,223,113,6
],[
2,2,3,2,2,2,2,2,2,3,2,3,150,109,6,206,236,160,17,4
],[
2,2,3,2,2,2,2,2,2,3,2,3,134,94,111,99,66,225,1,148
],[
10,2,3,2,2,2,2,2,2,2,2,2,51,187,165,82,60,24,101,204
],[
2,2,3,2,2,2,2,2,3,3,3,3,222,68,239,75,79,109,69,20
],[
2,2,3,2,2,2,2,3,2,2,2,2,204,169,182,144,47,59,13,170
],[
9,2,3,2,2,2,2,3,2,2,2,2,196,18,8,121,89,146,12,31
],[
2,2,3,2,2,2,3,2,2,2,2,2,148,151,22,241,138,183,245,216
],[
2,2,3,2,2,3,2,2,2,2,2,2,140,200,183,246,68,162,97,141
],[
8,2,3,2,2,3,2,2,2,2,2,2,2,38,227,29,80,128,74,205
],[
2,2,3,2,3,3,2,2,2,2,2,2,204,168,56,12,55,47,145,120
],[
2,2,3,2,3,2,2,2,2,2,2,2,201,56,120,255,199,197,122,68
],[
6,2,3,2,3,2,2,2,2,2,2,2,88,52,8,68,149,9,43,57
],[
2,2,3,3,3,2,2,2,2,2,2,3,223,237,115,191,117,247,49,53
],[
69,43,229,102,3,64,250,104,121,167,177,197,30,200,92,217,233,143,204,123
],[
103,39,12,224,12,5,80,187,199,41,40,169,216,160,249,205,230,78,174,183
],[
76,234,171,139,181,74,2,95,232,225,234,228,229,134,109,73,48,118,96,92
]
]