aLevelData = [
[
10,2,2,8,2,2,2,2,2,2,2,2,2,2,2,116,192,239,91,158
],[
2,2,2,2,2,2,2,2,2,2,2,2,2,2,2,246,120,133,24,222
],[
2,2,2,2,2,2,3,3,3,3,2,2,2,2,2,250,141,143,6,31
],[
9,2,2,2,2,2,2,2,2,3,2,2,2,2,2,139,145,80,141,155
],[
3,3,3,3,3,3,3,2,2,3,2,2,2,2,2,149,235,11,119,60
],[
2,2,2,2,2,2,2,2,2,3,2,2,2,2,2,129,229,75,214,178
],[
2,2,2,2,2,2,2,2,2,3,3,2,2,2,2,146,196,40,194,149
],[
2,2,2,2,2,2,2,2,2,2,3,2,2,2,2,106,109,142,161,49
],[
2,2,2,2,2,2,2,2,2,2,3,2,2,2,2,154,197,0,74,230
],[
2,2,2,2,3,3,3,3,2,2,3,2,2,2,2,84,54,63,138,34
],[
2,2,2,2,3,2,2,3,2,2,3,2,2,2,2,225,63,197,254,227
],[
2,2,2,2,3,2,2,3,2,2,3,3,3,5,2,183,36,214,195,34
],[
2,2,2,2,3,2,2,3,2,2,2,2,3,2,2,0,41,81,33,72
],[
190,137,206,129,151,186,77,10,33,232,165,165,173,110,206,51,35,231,12,191
],[
245,79,123,190,83,102,234,149,158,85,236,92,30,148,45,226,247,11,3,241
],[
89,120,69,211,248,16,96,20,188,105,167,138,185,151,235,147,97,150,76,158
],[
248,232,78,237,73,126,48,153,152,220,121,214,215,121,211,120,29,100,28,182
],[
83,45,187,46,49,3,48,42,105,26,239,34,33,80,111,130,167,15,126,172
],[
96,117,215,65,2,178,246,157,3,178,43,160,82,253,238,180,68,219,114,11
],[
209,187,125,41,0,213,118,163,160,15,192,38,57,29,70,186,66,237,87,72
]
]