aLevelData = [
[
2,2,40,118,86,138,228,170,199,77,149,226,128,71,125,234,102,214,79,57
],[
2,2,108,48,55,219,183,250,27,174,1,22,33,209,59,188,113,90,118,204
],[
2,2,60,71,3,98,253,184,217,171,254,91,56,248,30,39,140,17,211,77
],[
2,3,148,204,107,107,195,222,151,3,231,240,41,45,8,246,29,136,147,188
],[
2,3,214,118,184,193,171,137,16,73,162,56,131,174,123,215,105,247,241,198
],[
2,2,239,171,60,232,188,232,218,86,213,175,143,85,190,130,171,134,227,49
],[
2,2,139,93,54,241,98,212,24,174,58,97,125,162,53,37,75,39,25,102
],[
2,2,4,201,11,63,165,160,155,150,206,221,1,79,34,162,166,191,241,23
],[
2,2,231,100,21,186,21,211,25,246,192,241,161,248,53,102,5,190,69,79
],[
4,2,64,112,72,51,9,244,98,57,63,189,5,152,138,227,183,78,64,121
],[
2,2,22,21,133,27,25,147,183,198,152,209,9,236,15,238,109,200,159,21
],[
2,2,184,240,85,172,0,41,175,206,73,126,92,252,97,148,68,15,9,56
],[
200,113,85,58,75,141,86,126,241,132,246,80,166,34,34,248,99,16,47,142
],[
172,75,118,16,94,212,66,178,167,170,237,117,86,245,69,251,85,132,52,154
],[
115,121,161,175,103,67,145,53,18,205,146,150,5,245,89,192,67,64,170,124
],[
72,204,120,251,74,134,78,178,190,156,237,105,30,54,55,142,234,97,75,206
],[
237,75,242,231,193,182,58,183,149,167,96,153,46,94,243,242,44,139,55,7
],[
143,191,200,18,121,33,127,148,53,98,153,236,121,243,22,41,232,117,96,29
],[
219,113,45,178,97,73,166,130,133,110,201,161,207,212,12,189,13,163,67,106
],[
82,48,195,183,64,43,200,5,131,26,20,25,158,5,217,111,234,115,217,209
]
]