aLevelData = [
[
6,2,2,2,2,2,2,2,2,2,2,2,2,181,70,38,121,155,23,108
],[
2,2,2,2,2,2,2,2,2,2,2,2,2,192,194,242,45,201,2,92
],[
2,2,2,2,2,2,2,2,2,2,2,2,2,168,103,51,228,4,185,75
],[
3,3,3,3,3,3,3,3,3,3,3,3,3,180,146,90,198,101,83,217
],[
2,2,2,2,2,2,2,2,2,2,2,2,2,75,24,186,105,140,194,178
],[
2,2,2,2,2,2,2,2,2,2,2,2,2,217,110,199,227,198,106,203
],[
2,2,2,2,2,3,2,2,3,2,2,3,2,49,15,50,196,134,137,152
],[
2,2,3,3,3,3,3,3,3,3,3,3,3,84,210,244,172,87,80,46
],[
2,2,2,2,2,2,2,2,2,2,2,2,2,37,184,10,167,3,136,159
],[
2,2,2,2,2,2,2,2,2,4,2,2,2,21,114,81,68,105,240,167
],[
3,3,3,3,3,3,3,3,3,3,3,3,3,9,1,178,1,94,31,68
],[
2,2,2,2,2,2,2,2,2,2,2,2,2,199,213,154,113,172,41,211
],[
2,2,2,2,2,2,2,2,2,2,2,2,2,98,62,128,235,10,187,237
],[
2,2,3,3,3,3,3,3,3,3,2,3,3,51,193,39,57,228,46,155
],[
2,2,3,2,2,2,2,2,2,2,2,3,2,227,17,107,224,101,217,100
],[
2,2,3,2,2,2,2,2,2,2,2,3,2,61,185,225,128,140,28,2
],[
2,2,3,3,3,3,3,2,2,2,2,3,2,132,147,18,62,180,146,170
],[
2,2,2,2,2,2,3,2,2,2,2,3,2,249,59,25,3,101,204,28
],[
3,3,3,3,2,2,3,2,2,2,2,3,2,15,63,138,73,151,185,37
],[
153,127,183,70,38,76,61,46,60,227,40,154,178,147,29,233,123,86,192,128
]
]