aLevelData = [
[
2,2,2,2,2,2,2,2,2,2,2,2,2,2,2,2,2,222,74,193
],[
2,2,2,2,2,2,2,2,2,2,2,2,2,2,2,2,2,88,12,57
],[
2,2,2,2,2,2,2,2,2,2,2,2,2,2,2,2,2,200,5,0
],[
2,2,2,3,3,3,3,3,3,3,3,3,3,3,3,3,3,169,205,52
],[
2,2,2,2,2,2,2,2,2,2,2,2,2,2,2,2,2,247,120,135
],[
2,2,2,2,2,2,2,2,2,2,2,2,2,2,2,2,2,210,250,22
],[
2,2,2,2,2,3,2,2,3,2,2,3,2,2,2,3,2,246,240,168
],[
2,2,2,3,3,3,3,3,3,3,3,3,3,3,3,3,3,57,69,21
],[
2,2,2,2,2,2,2,2,2,2,2,2,2,2,2,2,2,54,210,245
],[
2,2,2,2,2,2,2,2,2,2,2,2,2,2,2,2,2,217,180,63
],[
2,2,3,3,3,3,3,3,3,3,3,3,3,3,3,3,3,56,175,146
],[
2,2,2,2,2,2,2,2,2,2,2,2,2,2,2,2,2,194,155,3
],[
2,2,2,2,2,2,2,2,2,2,2,2,2,2,2,2,2,98,50,232
],[
2,2,3,3,3,3,3,3,3,2,2,3,3,3,3,3,3,133,223,240
],[
75,196,47,29,179,254,101,10,123,54,74,240,74,136,93,226,56,186,24,255
],[
50,19,117,236,159,112,177,130,67,148,80,195,100,192,97,19,44,131,3,165
],[
79,212,40,51,238,94,153,242,186,27,59,197,92,36,144,176,21,200,128,144
],[
161,219,90,10,98,80,22,194,186,11,221,205,185,240,203,104,248,64,243,234
],[
196,37,163,247,127,139,234,247,68,50,88,198,202,1,5,173,139,158,212,146
],[
37,59,249,107,0,179,185,249,49,213,113,178,158,255,218,255,99,240,139,167
]
]