aLevelData = [
[
10,2,2,8,2,2,2,2,2,2,2,2,2,2,2,60,13,9,62,214
],[
2,2,2,2,2,2,2,2,2,2,2,2,2,2,2,87,46,10,1,107
],[
2,2,2,2,2,2,3,3,3,3,2,2,2,2,2,110,13,235,18,135
],[
9,2,2,2,2,2,2,2,2,3,2,2,2,2,2,225,86,90,87,181
],[
3,3,3,3,3,3,3,2,2,3,2,2,2,2,2,71,128,57,78,254
],[
2,2,2,2,2,2,2,2,2,3,2,2,2,2,2,19,146,76,43,87
],[
2,2,2,2,2,2,2,2,2,3,3,2,2,2,2,167,175,95,232,178
],[
2,2,2,2,2,2,2,2,2,2,3,2,2,2,2,153,193,159,52,85
],[
2,2,2,2,2,2,2,2,2,2,3,2,2,2,2,2,185,140,153,147
],[
2,2,2,2,3,3,3,3,2,2,3,2,2,2,2,54,201,8,21,128
],[
2,2,2,2,3,2,2,3,2,2,3,2,2,2,2,189,251,17,77,82
],[
2,2,2,2,3,2,2,3,2,2,3,3,3,5,2,129,233,198,34,165
],[
2,2,2,2,3,2,2,3,2,2,2,2,3,2,2,14,233,65,239,116
],[
2,2,2,2,3,2,2,3,2,2,2,2,3,2,2,44,93,45,67,99
],[
10,114,208,227,87,96,203,232,165,163,186,52,185,190,165,249,15,10,19,249
],[
113,251,54,236,201,166,99,34,52,128,197,105,87,105,81,49,246,233,252,238
],[
194,185,44,190,115,133,109,76,23,240,102,244,170,217,11,40,230,220,20,18
],[
92,28,173,122,196,64,111,235,146,188,143,17,202,82,85,102,20,216,208,14
],[
19,59,201,254,243,196,245,100,65,154,110,67,0,137,100,94,249,1,16,88
],[
82,98,234,25,98,118,28,116,196,63,54,6,170,244,35,97,116,70,92,106
]
]