aLevelData = [
[
2,2,2,5,2,2,2,5,2,163,100,49,202,117,197,209,232,97,105,228
],[
2,2,2,2,2,5,2,2,2,231,243,67,234,96,51,198,215,124,112,153
],[
2,2,3,3,3,3,3,3,3,0,81,60,146,59,111,184,226,66,181,18
],[
2,3,2,2,2,2,2,2,2,141,89,106,75,30,49,137,62,152,11,91
],[
2,3,2,2,2,2,2,2,2,222,175,32,75,191,56,65,247,216,223,187
],[
2,2,2,2,2,5,5,5,5,131,135,24,125,50,213,88,125,55,252,132
],[
2,2,3,3,3,3,2,3,2,87,200,38,170,55,117,120,239,250,184,79
],[
2,2,3,2,2,3,2,3,2,200,144,205,201,109,165,195,136,139,128,212
],[
2,2,3,2,2,3,2,3,2,178,57,43,242,60,46,212,162,105,49,115
],[
4,2,3,2,2,3,2,3,2,13,141,208,173,84,23,85,248,37,206,246
],[
2,2,3,3,3,2,2,3,2,1,140,91,76,75,11,8,7,24,236,199
],[
2,2,3,2,3,2,2,3,2,223,140,214,118,206,16,159,97,124,245,97
],[
9,251,89,208,36,180,79,202,228,161,58,48,124,189,122,245,225,185,75,116
],[
205,241,233,7,10,158,249,213,237,77,36,235,33,144,5,143,165,243,69,208
],[
24,49,4,98,53,168,123,169,154,11,224,20,205,87,138,172,128,8,86,237
],[
20,140,73,212,93,248,119,57,165,250,35,95,243,14,39,202,141,245,151,80
],[
187,100,161,115,206,249,183,238,97,114,241,142,223,33,172,67,69,155,120,119
],[
41,177,49,158,252,161,107,15,140,141,19,18,204,43,84,58,216,191,184,245
],[
52,70,144,97,84,244,149,97,98,225,207,241,59,0,182,182,187,80,152,217
],[
58,86,58,22,86,202,194,16,243,145,212,232,129,235,252,13,126,238,76,86
]
]