aLevelData = [
[
10,2,2,8,2,111,131,27,204,129,120,255,19,16,219,223,152,83,224,174
],[
2,2,2,2,2,209,247,71,190,23,255,221,51,80,206,69,184,203,130,248
],[
2,2,2,2,2,112,107,132,139,47,8,93,49,235,18,204,128,109,119,21
],[
9,2,2,2,2,120,76,199,155,193,28,151,177,52,227,35,174,157,204,55
],[
3,3,3,3,3,63,191,32,79,2,153,113,253,80,232,25,139,90,237,227
],[
2,2,2,2,2,225,119,112,7,170,188,5,92,179,206,142,201,147,244,1
],[
252,145,112,108,95,194,16,54,72,114,0,167,113,197,226,170,167,158,32,210
],[
198,192,129,156,228,52,251,244,205,234,201,250,176,163,189,5,23,13,214,232
],[
28,48,21,117,218,10,141,64,35,118,186,166,113,83,19,13,30,225,226,108
],[
215,110,84,15,78,51,204,148,47,121,125,58,86,0,56,91,63,160,130,54
],[
189,49,234,242,239,169,154,224,112,132,43,1,207,105,190,200,63,10,72,32
],[
143,76,45,177,92,168,17,95,133,208,234,20,223,150,90,192,42,10,61,158
],[
68,227,126,184,157,33,46,173,235,240,215,178,31,206,13,215,151,240,71,140
],[
149,226,237,99,240,111,178,23,9,192,36,206,1,200,129,155,41,223,205,71
],[
186,172,33,81,199,73,70,51,111,162,131,231,87,30,178,170,88,130,153,0
],[
116,18,120,248,15,249,223,177,91,234,194,29,21,8,207,5,111,3,255,77
],[
77,132,108,122,179,204,98,113,126,152,184,129,83,71,97,164,214,62,62,2
],[
28,140,54,183,98,202,137,214,255,69,97,174,151,96,171,76,146,51,36,65
],[
204,120,183,165,142,168,6,91,190,97,71,151,82,11,81,158,10,187,246,205
],[
95,87,148,221,183,252,231,101,218,156,33,160,169,236,61,113,14,125,144,164
]
]