aLevelData = [
[
4,2,2,2,2,2,2,2,2,2,2,2,2,2,2,2,153,104,217,154
],[
5,2,5,3,2,2,2,2,2,2,2,2,2,2,2,2,6,228,88,136
],[
2,5,5,3,3,3,3,3,3,3,3,3,3,3,3,3,66,100,131,67
],[
3,3,5,5,5,5,5,5,5,5,3,2,2,2,2,2,152,15,180,84
],[
2,3,5,5,5,5,5,5,5,5,3,6,2,2,2,2,188,224,208,151
],[
3,3,5,5,5,5,3,3,3,3,3,3,3,3,3,2,105,177,18,240
],[
3,5,5,5,5,5,3,2,2,2,2,2,2,2,2,2,72,153,10,58
],[
3,5,5,3,3,3,3,8,2,2,2,5,5,5,5,5,20,120,229,128
],[
3,5,5,3,2,2,3,3,3,3,2,5,3,3,3,5,252,208,238,112
],[
3,5,5,3,2,2,2,2,2,3,2,5,3,5,5,5,72,215,85,12
],[
3,5,5,3,2,2,3,2,2,3,2,5,3,5,5,5,64,202,47,163
],[
5,5,5,3,2,2,3,2,2,3,2,5,3,5,5,5,73,131,191,0
],[
5,5,5,3,2,2,3,2,2,3,2,5,3,3,3,5,82,78,244,225
],[
5,3,3,3,2,2,3,2,2,3,2,5,2,2,3,3,110,249,50,171
],[
5,3,2,2,2,2,3,2,2,3,2,5,2,2,2,2,194,42,86,91
],[
5,3,3,2,2,2,3,2,5,5,5,5,2,2,2,2,162,245,244,192
],[
5,5,3,3,2,2,3,2,5,3,5,5,3,3,3,3,247,174,226,232
],[
5,5,5,5,3,3,3,2,5,3,5,5,2,2,2,2,228,252,251,216
],[
5,5,5,5,5,5,3,2,5,3,5,5,2,2,2,2,169,47,29,127
],[
199,212,116,237,101,134,251,193,242,7,63,224,12,143,103,109,160,99,113,245
]
]