aLevelData = [
[
2,2,2,2,2,2,2,255,221,6,236,4,142,236,145,80,57,123,114,75
],[
2,2,2,2,2,2,2,181,1,49,91,224,181,188,7,51,247,127,91,154
],[
2,2,2,2,2,2,2,217,217,142,130,223,205,226,51,3,251,204,96,252
],[
2,2,2,3,3,3,3,206,85,252,192,246,192,80,72,25,109,75,147,197
],[
2,2,2,2,2,2,2,253,25,237,170,183,247,113,6,42,69,205,96,20
],[
2,2,2,2,2,2,2,220,69,121,131,163,251,128,58,93,109,133,86,197
],[
2,2,2,2,2,3,2,63,48,50,221,59,179,135,131,150,253,216,69,116
],[
2,2,2,3,3,3,3,48,13,118,175,86,94,129,212,80,114,126,111,14
],[
2,2,2,2,2,2,2,200,3,137,6,87,61,110,222,113,63,180,108,237
],[
2,2,2,2,2,2,2,153,120,225,133,45,235,65,125,62,14,23,134,202
],[
2,2,3,3,3,3,3,185,102,225,26,226,226,199,151,28,96,9,223,94
],[
2,2,2,2,2,2,2,140,244,24,6,218,119,133,29,191,136,86,221,32
],[
195,197,112,11,84,94,251,165,24,158,219,99,255,192,47,125,181,212,150,160
],[
129,17,58,228,109,108,13,253,167,106,82,181,39,50,96,154,146,230,162,243
],[
94,51,227,249,56,39,200,68,162,67,158,132,225,210,86,113,22,121,206,5
],[
171,14,83,232,240,173,99,44,6,9,183,58,253,1,129,12,57,116,242,157
],[
26,85,255,158,220,2,101,107,187,209,234,61,91,236,230,161,104,96,3,41
],[
121,112,65,97,59,47,61,4,203,78,178,112,99,50,64,88,57,73,108,185
],[
164,159,233,15,129,172,22,200,213,113,199,249,180,195,72,80,97,230,159,74
],[
182,93,18,165,198,1,233,25,194,81,117,67,25,9,81,226,227,246,232,69
]
]