aLevelData = [
[
2,2,2,2,2,2,2,2,2,2,2,2,2,2,2,2,2,2,2,2
],[
2,2,13,5,5,2,2,12,5,5,2,3,2,5,5,2,2,2,2,2
],[
2,2,2,5,5,2,2,2,5,5,2,3,2,5,5,2,2,2,2,2
],[
2,2,2,2,2,2,2,2,2,2,2,3,2,2,2,2,2,2,2,2
],[
2,2,2,2,2,2,2,2,2,2,2,3,3,3,3,3,3,3,3,2
],[
2,2,2,2,2,2,2,2,2,2,2,2,2,2,6,2,2,2,2,2
],[
2,2,2,2,2,2,2,2,2,2,2,2,2,3,3,3,2,3,3,2
],[
82,95,170,160,171,118,60,167,162,170,152,234,16,253,9,157,39,107,233,193
],[
178,31,6,248,158,231,75,152,186,230,156,254,187,137,1,37,131,188,7,119
],[
163,93,99,226,30,240,217,47,112,149,92,143,206,56,119,119,176,8,235,174
],[
141,42,154,165,229,174,163,6,133,194,207,143,7,37,44,33,152,223,247,20
],[
254,48,191,206,217,198,200,148,40,50,174,159,16,157,74,115,217,183,217,108
],[
58,241,91,154,214,236,58,207,6,49,44,245,217,34,90,165,89,49,194,246
],[
16,79,218,147,203,167,118,17,158,141,235,127,40,177,117,62,24,153,214,19
],[
240,78,64,122,10,85,117,61,216,224,45,70,111,70,184,177,71,177,228,38
],[
60,22,33,102,217,107,227,35,214,20,72,21,223,158,251,74,152,175,88,190
],[
221,61,209,43,78,255,144,34,11,33,93,91,188,60,195,74,213,133,110,242
],[
24,69,216,254,91,137,37,14,139,26,75,79,241,175,117,78,180,98,170,14
],[
159,97,169,88,37,230,24,82,162,105,222,83,228,20,206,246,234,119,133,109
],[
235,125,149,24,155,158,227,86,169,87,77,156,140,215,144,196,127,252,105,167
]
]