aLevelData = [
[
6,2,2,2,3,130,129,194,51,113,112,250,189,130,118,130,148,231,201,73
],[
2,2,2,2,67,18,222,125,139,206,47,67,78,136,60,171,172,237,207,227
],[
2,2,2,2,107,187,133,171,156,208,138,8,123,136,164,61,152,69,115,247
],[
3,3,3,3,52,79,247,200,238,223,82,214,159,118,207,213,130,115,36,50
],[
2,2,2,2,152,229,244,145,74,158,152,122,81,137,31,79,211,61,147,130
],[
2,2,2,2,206,209,126,4,186,242,173,1,106,52,52,202,52,166,179,19
],[
2,2,2,2,81,169,215,94,134,2,35,183,4,45,240,162,142,244,178,82
],[
2,2,3,3,217,65,126,27,56,49,201,42,121,105,115,116,9,173,4,236
],[
95,175,53,249,152,36,178,39,95,29,30,29,16,149,87,207,29,70,252,244
],[
176,194,45,187,146,190,146,185,75,177,159,38,139,158,22,74,200,45,205,50
],[
41,1,177,167,163,70,11,97,98,137,2,119,106,205,97,26,126,219,155,131
],[
64,217,13,42,155,30,130,57,94,69,252,64,41,128,178,42,141,47,85,112
],[
111,178,151,140,173,123,238,177,5,103,149,185,50,78,213,95,87,217,130,174
],[
161,147,200,185,40,67,40,141,23,122,189,100,13,104,196,27,195,243,91,230
],[
238,11,137,67,103,55,127,44,137,116,29,145,218,64,184,5,238,242,27,184
],[
137,76,203,165,4,83,144,12,242,94,48,35,3,110,126,9,40,189,147,251
],[
247,154,92,202,82,115,85,140,67,52,147,146,43,208,8,155,28,28,3,71
],[
131,228,246,207,10,57,124,242,188,8,154,51,106,241,69,65,78,85,37,183
],[
239,177,153,5,68,43,251,174,28,107,37,181,190,172,52,81,204,19,140,232
],[
109,63,28,59,170,33,227,223,25,14,178,236,185,18,52,249,30,136,45,71
]
]