aLevelData = [
[
2,2,2,2,2,2,2,2,2,6,5,2,2,2,2,2,2,2,2,231
],[
2,3,5,3,5,5,5,3,5,3,5,2,5,3,5,3,5,5,2,122
],[
2,3,2,3,2,2,2,3,5,3,5,2,5,3,5,3,5,5,3,238
],[
2,2,2,2,2,2,2,2,2,2,2,2,5,5,5,5,5,5,3,184
],[
2,3,5,3,5,5,5,3,2,3,5,5,5,3,2,3,5,5,3,216
],[
2,3,5,3,5,5,5,3,2,3,5,5,5,3,2,3,5,5,3,46
],[
2,5,5,5,5,5,5,5,5,5,5,5,5,2,2,5,5,5,3,116
],[
2,3,5,3,5,5,5,3,5,3,5,5,5,3,5,3,5,5,3,124
],[
2,3,5,3,5,5,5,3,5,3,5,5,5,3,5,3,5,5,3,202
],[
2,5,5,5,5,5,5,5,5,5,5,5,5,5,5,5,5,5,3,224
],[
2,3,5,3,2,2,2,3,2,3,2,2,2,3,2,3,5,5,3,11
],[
5,3,5,3,2,2,2,3,2,3,2,2,2,3,2,3,5,5,3,243
],[
5,5,5,5,5,5,5,5,5,5,5,5,5,5,5,5,5,5,3,244
],[
5,3,5,3,5,5,5,3,5,3,5,5,2,3,2,3,5,5,3,246
],[
5,3,5,3,5,5,5,3,5,3,5,5,2,3,2,3,5,5,3,79
],[
1,5,5,5,5,5,5,5,5,5,5,5,5,5,5,5,5,5,3,215
],[
5,3,2,3,2,2,2,3,2,3,2,2,2,3,2,3,5,5,3,120
],[
2,3,2,3,2,2,2,3,2,3,2,2,2,3,2,3,5,5,3,26
],[
16,72,69,144,86,193,60,199,162,75,146,46,119,240,117,72,25,115,242,3
],[
149,62,22,70,1,156,83,201,5,40,38,41,155,134,247,60,18,80,65,162
]
]