aLevelData = [
[
2,98,74,104,131,253,152,94,59,72,160,207,147,129,119,4,255,89,218,93
],[
2,178,74,42,66,191,42,181,93,126,1,55,6,49,24,161,255,231,82,24
],[
5,98,161,191,65,215,180,111,188,10,110,132,238,93,252,139,4,218,139,13
],[
2,52,107,174,96,70,77,0,195,84,194,10,171,206,6,103,87,192,133,37
],[
2,170,88,75,111,58,163,188,105,165,151,133,92,36,86,210,19,98,177,194
],[
2,133,142,235,23,180,174,192,51,212,55,166,64,176,219,83,174,74,163,127
],[
2,226,193,61,235,44,120,151,162,250,117,173,127,76,7,159,239,104,172,6
],[
2,248,207,49,136,123,111,27,170,182,26,70,230,12,55,204,254,9,184,40
],[
2,143,161,76,156,233,184,213,208,30,232,28,187,89,126,195,198,113,197,124
],[
2,47,190,136,121,172,44,210,36,82,141,248,15,180,52,217,46,79,191,101
],[
68,38,52,92,155,169,80,88,248,219,27,14,206,180,192,209,178,196,156,88
],[
15,26,149,192,27,100,173,212,9,88,214,141,129,82,9,213,77,62,146,144
],[
85,184,174,221,205,114,87,153,173,214,95,38,97,237,188,106,194,128,35,26
],[
70,125,216,56,115,155,196,218,154,65,200,46,193,165,81,187,225,49,44,233
],[
82,42,156,196,131,147,170,253,238,79,189,49,75,135,106,110,4,75,141,244
],[
234,124,153,56,38,233,44,47,114,184,231,200,137,8,124,187,219,212,8,129
],[
134,26,164,163,130,61,54,56,27,169,142,169,165,181,174,184,107,205,104,193
],[
232,208,47,63,58,183,39,145,211,120,126,255,114,41,255,248,81,105,228,157
],[
160,252,236,132,51,181,174,181,120,153,45,249,171,65,172,85,77,128,196,209
],[
210,70,179,125,154,196,247,182,34,209,28,166,124,141,210,10,252,68,66,56
]
]