aLevelData = [
[
2,2,2,2,2,2,2,2,2,2,2,2,2,188,157,168,241,138,84,103
],[
2,2,2,2,2,2,2,2,2,2,2,2,2,72,3,167,110,113,13,58
],[
2,2,2,2,2,2,2,2,2,2,2,2,2,228,199,39,224,92,96,156
],[
2,2,2,13,2,2,2,2,2,2,2,2,2,3,169,145,252,71,244,180
],[
2,2,2,2,2,2,2,2,2,2,2,2,2,204,106,12,40,125,111,252
],[
2,2,2,2,2,2,2,2,2,2,2,2,2,154,155,251,227,131,71,255
],[
2,2,2,2,2,2,2,2,2,2,2,2,2,0,242,231,151,13,140,28
],[
2,2,2,2,2,2,2,2,2,1,2,2,2,50,206,209,245,244,233,161
],[
2,2,11,2,2,2,2,2,2,2,2,2,2,98,88,248,254,235,26,221
],[
2,2,2,2,2,2,2,2,2,2,2,2,2,19,161,84,85,117,85,231
],[
2,2,2,2,2,2,2,2,2,2,2,2,2,209,170,9,28,129,232,164
],[
2,2,2,2,2,2,2,2,2,2,2,2,2,139,177,30,234,60,88,57
],[
2,2,2,2,2,2,2,2,2,2,2,2,2,170,13,238,160,57,83,127
],[
2,2,2,2,2,2,2,2,2,2,2,2,2,0,32,196,254,79,18,149
],[
2,9,2,2,2,2,2,2,2,2,2,2,2,219,11,33,223,215,195,49
],[
71,24,217,172,222,120,134,119,70,35,30,37,23,97,150,107,128,176,67,212
],[
50,22,228,182,121,181,227,101,172,160,216,166,200,237,79,103,88,12,203,173
],[
152,87,11,205,217,233,139,223,39,180,78,112,42,206,219,119,74,12,134,138
],[
22,210,240,82,231,41,209,61,192,18,245,114,121,27,133,10,29,47,136,125
],[
144,178,169,90,117,206,59,60,78,7,122,249,229,22,20,28,236,244,232,150
]
]