aLevelData = [
[
2,2,2,5,2,33,147,38,230,173,240,81,219,168,180,44,32,155,210,37
],[
2,2,2,2,2,117,24,43,239,214,248,189,224,81,231,24,151,20,35,18
],[
2,2,3,3,3,225,202,128,188,222,40,176,149,95,194,193,253,147,36,231
],[
2,3,2,2,2,236,227,30,124,227,26,95,69,35,201,69,247,30,234,244
],[
2,3,2,2,2,249,43,195,166,108,125,13,66,105,86,86,47,137,120,164
],[
2,2,2,2,2,106,171,221,91,214,241,167,96,212,12,90,127,20,186,73
],[
2,2,3,3,3,10,171,140,78,195,101,237,190,252,92,96,156,253,201,9
],[
2,2,3,2,2,13,166,27,111,12,86,70,128,95,11,94,214,202,202,100
],[
2,2,3,2,2,56,130,65,96,100,228,171,175,11,103,244,159,30,208,29
],[
4,2,3,2,2,57,72,165,227,94,188,227,155,22,48,243,97,36,41,219
],[
2,2,3,3,3,113,222,122,178,213,59,7,86,65,46,207,97,59,50,42
],[
88,126,38,78,38,161,92,24,201,244,237,10,76,171,79,144,245,62,41,135
],[
191,15,101,255,10,78,135,64,146,25,62,12,158,232,57,36,122,41,60,14
],[
38,39,115,20,80,48,6,144,128,247,237,103,147,55,6,212,106,153,101,103
],[
227,216,235,77,8,35,26,209,135,195,39,35,99,253,81,88,232,58,114,179
],[
228,101,212,35,20,149,69,12,221,236,110,74,60,191,96,116,0,246,112,93
],[
55,182,69,225,230,62,47,222,253,15,186,128,137,80,132,194,44,112,75,49
],[
202,13,74,243,134,21,198,9,237,43,228,209,112,76,189,207,24,178,180,172
],[
117,248,8,127,216,128,165,76,194,18,64,202,155,197,162,106,167,35,68,148
],[
55,136,29,52,28,203,184,117,97,32,137,204,58,61,129,57,55,188,224,202
]
]