aLevelData = [
[
4,2,5,5,2,2,2,2,2,2,2,2,2,2,105,156,254,218,107,185
],[
2,2,2,2,2,2,5,2,2,2,5,2,2,2,128,9,0,212,221,41
],[
62,129,233,10,199,162,142,67,229,45,122,25,218,47,21,162,113,17,182,42
],[
217,26,22,213,179,54,5,134,106,246,91,0,195,215,50,75,181,199,82,90
],[
122,229,237,234,230,137,141,173,248,132,74,168,175,169,64,217,30,140,64,30
],[
195,137,198,82,21,8,43,185,92,0,28,158,197,186,75,58,182,216,100,216
],[
95,149,67,55,146,78,100,48,212,66,155,152,180,150,5,104,91,156,62,27
],[
101,84,212,88,239,51,252,209,241,36,132,107,207,205,9,159,42,19,106,32
],[
252,224,124,190,228,35,0,138,190,25,210,59,119,204,99,208,31,217,104,119
],[
64,117,212,174,111,178,4,168,32,255,58,242,191,238,77,86,252,59,159,0
],[
102,9,78,223,59,110,175,78,126,50,248,244,75,212,60,232,104,206,157,25
],[
28,26,189,238,68,245,117,41,163,227,202,17,122,243,28,208,88,68,161,26
],[
52,200,18,15,185,72,164,99,225,169,58,188,197,109,217,91,180,125,92,255
],[
130,37,105,6,34,96,163,214,119,86,33,123,104,35,32,145,51,218,244,101
],[
3,201,69,87,196,255,119,131,54,12,106,160,64,8,100,39,136,215,75,184
],[
64,170,24,187,67,201,136,67,96,145,20,55,245,184,36,179,192,217,128,172
],[
243,44,7,211,134,148,163,188,209,224,124,64,90,74,108,32,236,68,180,234
],[
233,117,237,33,224,254,65,152,98,1,218,31,18,100,155,97,252,210,14,13
],[
40,3,158,52,110,62,7,243,139,28,10,81,117,142,101,106,236,33,2,206
],[
82,129,111,36,188,60,142,19,73,201,142,98,179,201,25,93,35,140,207,123
]
]