aLevelData = [
[
6,2,8,2,124,7,181,46,232,62,219,151,92,14,36,206,190,22,196,11
],[
2,2,2,2,242,250,220,183,77,7,148,46,77,26,106,196,135,189,202,6
],[
2,2,3,3,224,148,222,66,0,248,167,73,4,225,77,115,115,9,179,228
],[
2,2,3,2,116,78,79,14,62,88,57,119,207,125,129,188,225,225,198,215
],[
2,2,3,2,26,226,4,157,131,179,174,138,59,70,253,193,109,112,135,79
],[
2,2,3,2,127,72,19,176,140,208,172,148,21,215,244,227,243,29,187,254
],[
2,2,3,2,144,185,208,72,87,184,23,229,105,7,220,193,146,147,103,212
],[
2,2,3,5,123,174,209,165,33,181,22,13,133,239,106,62,166,185,209,3
],[
2,2,2,2,172,224,234,74,102,79,11,223,246,234,147,122,203,185,124,252
],[
2,3,2,2,208,73,48,246,227,79,158,107,137,143,140,215,224,252,47,111
],[
2,3,2,2,213,33,249,171,150,191,178,2,75,184,202,244,1,43,238,78
],[
2,3,2,3,230,225,217,170,188,232,109,53,136,125,2,181,138,48,254,202
],[
2,3,2,3,114,66,165,115,209,82,51,213,206,56,40,56,26,50,228,83
],[
2,3,2,3,38,62,115,201,147,198,170,243,234,130,115,224,141,155,101,154
],[
237,12,152,171,254,78,183,224,232,52,86,77,0,20,134,145,246,39,167,92
],[
79,50,126,46,22,102,136,97,207,133,141,105,173,71,119,91,5,252,101,172
],[
1,114,252,59,153,25,253,146,191,101,29,105,218,116,17,108,118,241,232,63
],[
58,56,157,190,26,187,237,137,206,164,102,192,130,188,193,11,207,139,113,222
],[
234,193,124,251,27,212,138,56,113,235,59,130,181,251,190,34,156,47,160,63
],[
64,142,225,164,209,216,77,196,136,176,9,251,221,0,109,23,250,154,17,23
]
]