aLevelData = [
[
4,2,2,2,2,18,135,30,33,175,113,93,178,83,196,230,202,51,239,68
],[
5,2,5,3,2,88,208,129,149,147,214,131,141,237,68,11,190,66,206,14
],[
2,5,5,3,3,22,86,128,118,169,126,163,116,176,157,228,24,210,82,179
],[
3,3,5,5,5,31,163,112,234,12,107,175,175,122,40,161,155,176,214,231
],[
2,3,5,5,5,28,118,237,164,23,39,44,50,210,8,149,20,18,216,185
],[
3,3,5,5,5,44,128,168,53,46,81,237,125,85,38,212,216,85,49,213
],[
3,5,5,5,5,172,144,154,139,252,140,33,195,47,165,4,211,19,255,35
],[
3,5,5,3,3,45,33,191,98,51,3,123,79,77,83,238,5,57,166,241
],[
3,5,5,3,2,80,163,201,167,17,246,74,247,228,113,58,63,1,125,50
],[
3,5,5,3,2,70,96,62,148,115,33,104,19,61,42,84,118,227,18,83
],[
3,5,5,3,2,152,93,62,66,180,146,73,94,223,203,169,90,214,104,144
],[
5,5,5,3,2,175,250,210,17,52,153,176,132,238,111,94,43,41,109,154
],[
5,5,5,3,2,22,199,185,129,67,217,245,187,10,108,196,242,184,165,138
],[
5,3,3,3,2,136,123,17,116,137,126,54,185,222,84,110,31,196,154,245
],[
5,3,2,2,2,192,125,216,64,14,69,169,144,21,136,28,200,0,82,89
],[
5,3,3,2,2,123,223,7,136,74,167,84,238,109,122,101,89,143,41,89
],[
5,5,3,3,2,191,223,248,243,34,100,161,146,182,144,155,99,70,25,155
],[
213,212,4,92,77,128,3,156,28,171,0,103,174,91,250,151,3,225,16,156
],[
99,186,219,121,78,180,1,15,179,81,7,158,98,112,103,137,194,42,227,89
],[
199,251,24,5,31,34,86,113,172,74,175,52,55,105,78,158,99,233,11,250
]
]