aLevelData = [
[
2,2,2,2,2,2,2,2,2,6,5,2,2,2,2,2,2,2,130,234
],[
2,3,5,3,5,5,5,3,5,3,5,2,5,3,5,3,5,5,109,34
],[
2,3,2,3,2,2,2,3,5,3,5,2,5,3,5,3,5,5,249,128
],[
2,2,2,2,2,2,2,2,2,2,2,2,5,5,5,5,5,5,243,242
],[
2,3,5,3,5,5,5,3,2,3,5,5,5,3,2,3,5,5,159,141
],[
2,3,5,3,5,5,5,3,2,3,5,5,5,3,2,3,5,5,18,2
],[
2,5,5,5,5,5,5,5,5,5,5,5,5,2,2,5,5,5,106,122
],[
2,3,5,3,5,5,5,3,5,3,5,5,5,3,5,3,5,5,160,158
],[
2,3,5,3,5,5,5,3,5,3,5,5,5,3,5,3,5,5,5,152
],[
2,5,5,5,5,5,5,5,5,5,5,5,5,5,5,5,5,5,183,71
],[
2,3,5,3,2,2,2,3,2,3,2,2,2,3,2,3,5,5,129,6
],[
5,3,5,3,2,2,2,3,2,3,2,2,2,3,2,3,5,5,11,178
],[
5,5,5,5,5,5,5,5,5,5,5,5,5,5,5,5,5,5,72,212
],[
5,3,5,3,5,5,5,3,5,3,5,5,2,3,2,3,5,5,122,20
],[
5,3,5,3,5,5,5,3,5,3,5,5,2,3,2,3,5,5,82,104
],[
1,5,5,5,5,5,5,5,5,5,5,5,5,5,5,5,5,5,229,157
],[
5,3,2,3,2,2,2,3,2,3,2,2,2,3,2,3,5,5,155,33
],[
63,66,212,59,227,192,88,243,43,222,99,235,62,242,126,207,41,166,62,57
],[
50,252,46,210,104,144,10,187,127,30,46,43,219,67,77,89,235,136,102,156
],[
184,156,244,208,190,225,102,253,250,42,206,51,68,196,221,184,223,179,15,102
]
]