aLevelData = [
[
2,2,2,2,2,2,2,2,2,2,2,2,2,2,23,211,248,243,113,151
],[
2,2,2,2,2,2,2,2,2,2,2,2,2,2,118,88,224,171,79,198
],[
2,2,2,2,2,2,2,2,2,2,2,2,2,2,236,204,99,108,146,79
],[
2,2,2,13,2,2,2,2,2,2,2,2,2,2,186,4,57,80,23,16
],[
2,2,2,2,2,2,2,2,2,2,2,2,2,2,232,11,208,99,181,138
],[
2,2,2,2,2,2,2,2,2,2,2,2,2,2,220,228,129,129,46,143
],[
2,2,2,2,2,2,2,2,2,2,2,2,2,2,226,118,65,188,97,36
],[
2,2,2,2,2,2,2,2,2,1,2,2,2,2,245,164,230,34,153,33
],[
2,2,11,2,2,2,2,2,2,2,2,2,2,2,112,192,73,181,9,50
],[
2,2,2,2,2,2,2,2,2,2,2,2,2,2,122,206,250,240,211,72
],[
59,92,63,52,45,165,64,216,139,236,134,246,158,166,192,82,177,66,178,110
],[
197,11,135,152,134,79,105,38,125,193,80,1,134,28,23,96,133,9,213,214
],[
85,67,106,143,1,249,88,215,55,116,213,219,249,249,30,180,150,241,13,161
],[
217,71,238,148,128,18,143,241,239,116,150,146,38,193,23,14,241,228,102,59
],[
94,255,42,241,116,82,179,17,34,94,142,198,118,74,86,11,16,133,204,110
],[
213,173,42,19,232,176,181,251,214,49,146,134,16,45,218,55,159,222,241,184
],[
19,223,19,30,188,146,47,109,29,191,249,95,158,125,59,97,129,86,107,223
],[
23,166,131,193,52,68,13,54,224,100,125,176,79,188,196,48,20,230,34,195
],[
145,6,60,76,178,172,110,133,219,252,98,65,30,12,226,244,178,141,234,116
],[
160,174,2,1,192,61,202,132,228,15,215,20,83,163,189,190,121,2,109,134
]
]