aLevelData = [
[
2,2,2,2,2,2,2,2,2,155,229,245,42,202,224,174,63,13,212,224
],[
2,2,2,2,2,2,2,2,2,199,95,95,252,125,98,43,86,117,164,31
],[
2,2,2,2,2,2,2,2,2,134,248,33,215,14,143,10,82,62,94,197
],[
2,2,2,3,3,3,3,3,3,235,85,179,53,139,233,223,59,28,137,69
],[
2,2,2,2,2,2,2,2,2,125,65,160,176,102,68,156,234,110,80,80
],[
2,2,2,2,2,2,2,2,2,138,155,224,151,13,71,119,59,40,37,146
],[
2,2,2,2,2,3,2,2,3,21,93,127,218,117,205,193,159,196,77,59
],[
2,2,2,3,3,3,3,3,3,130,103,187,35,113,231,147,217,217,79,189
],[
2,2,2,2,2,2,2,2,2,111,22,214,169,105,47,190,158,193,192,124
],[
2,2,2,2,2,2,2,2,2,79,47,55,25,176,167,67,216,7,34,138
],[
2,2,3,3,3,3,3,3,3,25,70,161,155,125,152,111,35,75,58,167
],[
2,2,2,2,2,2,2,2,2,99,19,140,247,225,145,104,163,94,211,178
],[
2,2,2,2,2,2,2,2,2,205,9,158,48,243,242,15,156,185,193,126
],[
2,2,3,3,3,3,3,3,3,248,233,168,167,34,184,150,12,168,75,174
],[
2,2,3,2,2,2,2,2,2,149,221,121,247,122,45,211,85,98,173,225
],[
184,205,246,175,147,175,52,136,144,93,122,2,130,173,89,59,154,89,176,97
],[
223,165,197,120,216,66,149,87,139,113,105,244,172,108,170,226,14,1,246,24
],[
93,128,115,244,15,215,100,128,152,252,250,243,221,139,108,123,236,177,74,57
],[
234,72,14,141,76,67,244,149,75,77,11,240,145,173,140,200,57,109,107,15
],[
246,187,45,8,146,143,249,10,155,142,241,129,89,47,195,53,2,28,122,207
]
]