aLevelData = [
[
4,2,2,2,2,2,2,2,2,2,8,2,2,2,2,3,2,2,83,191
],[
2,2,3,2,9,2,2,2,2,2,2,2,2,3,2,2,3,2,243,225
],[
2,3,2,2,2,2,3,2,2,3,2,3,2,2,3,2,2,3,170,4
],[
2,3,2,2,2,3,2,2,3,2,2,2,3,2,2,3,2,2,134,69
],[
2,3,2,2,3,2,2,3,2,2,2,2,2,3,2,2,3,2,102,83
],[
2,3,2,3,2,2,3,2,2,3,2,3,2,2,3,2,2,3,77,13
],[
2,2,3,2,2,3,2,2,3,2,2,2,3,2,2,3,2,2,245,51
],[
2,2,2,2,3,2,2,3,2,2,2,2,2,3,2,2,3,5,72,137
],[
2,2,2,3,2,2,3,2,2,3,2,3,2,2,3,5,2,3,117,24
],[
2,2,3,2,2,3,2,2,3,2,2,2,3,2,2,3,2,2,171,114
],[
2,2,5,2,3,2,2,3,2,2,2,2,2,3,5,2,3,2,201,41
],[
2,2,2,3,2,2,3,2,2,3,2,3,2,2,3,2,2,3,140,208
],[
2,2,3,2,5,3,2,2,3,2,2,2,3,5,2,3,2,2,237,70
],[
2,3,2,2,3,5,2,3,2,2,2,2,2,3,2,2,3,2,222,27
],[
2,2,2,3,2,2,3,2,2,3,2,3,2,2,3,2,2,3,134,74
],[
2,2,3,2,2,3,2,5,3,2,2,2,3,5,2,3,2,2,162,161
],[
2,3,2,2,3,2,2,3,5,2,2,2,2,3,2,2,3,2,190,141
],[
2,2,2,3,2,2,3,2,2,3,2,3,5,2,3,2,2,3,92,39
],[
2,2,3,2,2,3,2,2,3,2,1,2,3,2,2,3,2,2,78,174
],[
2,2,2,2,2,2,2,2,2,2,2,2,2,2,2,2,2,2,196,211
]
]