aLevelData = [
[
2,2,2,2,2,2,2,2,2,2,2,2,2,2,2,2,2,2,79,48
],[
2,2,13,5,5,2,2,12,5,5,2,3,2,5,5,2,2,2,98,125
],[
2,2,2,5,5,2,2,2,5,5,2,3,2,5,5,2,2,2,133,19
],[
2,2,2,2,2,2,2,2,2,2,2,3,2,2,2,2,2,2,106,148
],[
2,2,2,2,2,2,2,2,2,2,2,3,3,3,3,3,3,3,248,213
],[
2,2,2,2,2,2,2,2,2,2,2,2,2,2,6,2,2,2,21,253
],[
2,2,2,2,2,2,2,2,2,2,2,2,2,3,3,3,2,3,189,195
],[
2,2,2,2,2,2,2,2,2,2,2,2,2,2,2,2,2,2,205,139
],[
2,2,2,2,2,2,2,2,2,2,3,2,2,2,2,2,2,2,44,108
],[
2,2,2,2,2,2,2,2,2,3,3,2,3,2,2,2,2,2,54,103
],[
155,86,14,95,109,239,88,129,76,198,185,233,178,251,34,215,174,245,175,5
],[
229,82,207,55,215,36,166,19,99,90,175,51,141,124,166,121,128,156,165,162
],[
207,137,141,30,0,69,167,31,75,185,139,241,159,168,65,137,230,226,167,96
],[
138,186,18,130,56,185,56,225,228,148,78,240,13,92,109,109,66,245,58,126
],[
229,201,198,0,47,189,179,28,116,101,153,27,168,115,167,123,35,118,142,66
],[
161,193,154,146,141,168,34,126,127,243,35,28,3,140,40,219,156,123,109,23
],[
8,20,67,235,198,111,182,71,214,25,110,66,192,9,211,177,215,214,117,248
],[
191,39,170,32,45,106,121,42,238,201,182,163,43,89,111,121,235,149,135,13
],[
217,12,161,137,72,86,63,116,116,76,43,132,10,121,23,179,235,203,128,148
],[
45,142,216,232,99,155,227,109,31,205,98,246,181,181,239,192,65,143,40,4
]
]