aLevelData = [
[
4,2,2,2,2,2,60,183,160,7,219,246,207,249,209,246,107,141,23,89
],[
5,2,5,3,2,2,225,146,20,126,96,135,27,247,132,173,54,62,50,97
],[
34,163,195,169,154,137,100,13,217,210,188,168,90,152,208,126,226,30,36,16
],[
192,6,35,46,83,196,193,13,206,82,95,153,56,37,239,12,183,97,88,192
],[
13,73,28,65,99,249,56,167,70,87,76,35,239,71,251,215,199,30,149,235
],[
42,90,243,221,107,144,163,24,25,165,70,201,129,65,53,238,116,129,107,175
],[
75,236,159,242,39,169,176,42,126,239,70,111,211,188,183,212,196,202,39,245
],[
74,191,244,207,61,163,81,213,22,152,48,64,249,197,102,166,243,148,9,206
],[
128,29,29,195,80,226,112,39,74,188,195,202,210,21,42,123,71,88,182,30
],[
208,166,80,255,89,203,232,102,216,112,208,108,213,145,98,12,41,50,233,125
],[
6,78,191,191,55,17,178,117,169,71,172,242,43,19,148,150,114,228,111,91
],[
96,165,203,171,134,52,93,117,231,22,233,127,254,105,98,254,3,25,83,100
],[
107,87,125,121,174,71,193,173,76,249,65,172,18,155,195,52,153,237,86,35
],[
17,245,55,213,60,243,245,172,189,151,212,240,147,114,111,218,225,171,162,235
],[
240,243,167,130,118,186,127,174,25,163,148,65,47,54,156,38,200,214,192,244
],[
238,242,254,194,43,127,204,62,76,165,254,249,101,184,233,5,21,107,201,194
],[
11,64,96,245,201,67,224,26,168,248,11,252,29,146,153,130,58,101,218,204
],[
120,158,156,126,179,50,79,92,118,20,103,24,121,171,2,103,104,131,203,90
],[
230,67,30,236,210,223,109,216,201,14,226,173,236,255,69,35,227,71,33,176
],[
34,31,34,87,106,204,194,193,147,94,36,142,138,157,64,237,150,65,65,106
]
]