aLevelData = [
[
12,2,2,2,2,2,2,2,2,2,2,2,2,2,2,2,2,36,30,67
],[
2,2,2,2,2,2,2,2,2,2,2,2,13,2,2,2,2,11,185,137
],[
2,2,3,3,3,3,3,3,3,3,2,3,3,3,2,3,3,189,167,9
],[
11,2,3,2,2,2,2,2,2,3,2,3,2,3,2,3,2,120,155,80
],[
132,228,251,124,90,144,172,144,238,164,63,164,136,152,97,134,73,84,104,2
],[
101,150,43,97,140,147,23,48,169,225,127,67,207,148,52,249,112,168,86,192
],[
209,159,105,220,186,106,171,101,114,141,165,143,235,127,1,47,57,79,155,122
],[
72,141,219,15,207,104,65,56,128,20,65,108,130,111,82,25,32,227,66,161
],[
195,142,204,162,29,160,108,123,168,5,114,12,79,69,86,189,106,168,75,193
],[
240,157,22,156,232,92,33,226,33,203,203,66,35,158,3,196,101,195,21,79
],[
193,253,195,110,36,207,152,83,138,155,121,29,42,11,125,86,237,176,255,192
],[
37,233,241,81,124,7,114,124,42,174,163,178,108,126,183,41,49,243,74,220
],[
22,138,244,211,148,38,29,164,120,177,19,58,148,6,89,213,181,15,67,82
],[
213,42,191,173,145,210,118,196,221,123,20,93,246,189,227,107,152,181,159,141
],[
114,169,134,216,215,234,174,214,182,255,155,206,204,255,17,70,24,63,39,199
],[
143,45,157,224,18,124,111,109,157,130,170,26,193,222,127,34,84,93,150,93
],[
103,31,165,121,120,245,64,135,233,14,243,186,177,211,142,108,82,15,192,98
],[
11,83,231,81,78,153,39,161,116,39,185,112,176,182,134,218,65,212,245,120
],[
236,135,1,38,170,51,142,10,158,189,253,210,73,241,254,60,1,33,165,220
],[
159,15,193,26,121,14,105,122,144,99,215,32,10,241,122,147,226,22,70,193
]
]