aLevelData = [
[
4,2,2,2,2,2,2,2,2,2,8,2,2,2,2,133,211,117,218,253
],[
2,2,3,2,9,2,2,2,2,2,2,2,2,3,2,12,40,236,132,132
],[
225,158,25,5,210,169,157,198,234,144,157,235,76,59,109,76,255,225,118,119
],[
231,44,208,248,244,152,20,216,153,29,107,99,128,13,235,46,124,63,36,89
],[
191,109,245,18,77,219,165,90,176,57,46,12,237,203,220,27,184,199,23,27
],[
228,255,125,3,29,191,53,49,217,249,127,174,140,159,143,180,27,81,155,109
],[
148,56,51,254,28,50,209,196,41,47,177,221,241,219,226,235,34,125,158,20
],[
211,30,215,78,186,239,18,217,160,229,120,12,19,166,42,85,91,168,214,124
],[
175,151,136,39,168,248,194,163,245,13,206,225,81,248,83,191,178,34,39,137
],[
195,222,100,192,149,74,190,26,145,118,19,201,178,201,68,0,241,160,68,180
],[
0,55,110,160,58,205,28,139,219,3,117,205,108,134,134,16,130,237,149,84
],[
168,229,177,54,154,139,142,113,180,25,144,165,169,197,38,87,120,230,89,57
],[
156,89,165,172,131,35,7,132,66,87,87,11,135,59,216,72,207,166,14,129
],[
217,172,207,254,90,125,157,16,242,139,51,82,95,235,94,47,241,254,14,164
],[
61,80,173,71,22,192,175,137,185,226,107,56,72,161,41,72,122,41,124,210
],[
144,4,210,93,139,130,73,93,156,95,196,249,220,160,63,17,61,190,95,128
],[
192,6,77,158,233,64,197,9,113,143,106,166,58,152,93,226,136,230,13,62
],[
109,141,81,10,133,14,180,112,228,123,15,181,77,220,94,188,164,208,204,204
],[
166,120,16,146,216,144,252,106,189,223,83,218,76,210,220,95,161,100,180,109
],[
243,64,232,177,198,42,67,153,98,155,101,22,131,171,21,161,82,52,217,124
]
]