aLevelData = [
[
2,2,2,2,2,2,2,2,2,6,5,2,2,2,2,2,2,2,2,25
],[
2,3,5,3,5,5,5,3,5,3,5,2,5,3,5,3,5,5,2,106
],[
2,3,2,3,2,2,2,3,5,3,5,2,5,3,5,3,5,5,3,56
],[
2,2,2,2,2,2,2,2,2,2,2,2,5,5,5,5,5,5,3,124
],[
2,3,5,3,5,5,5,3,2,3,5,5,5,3,2,3,5,5,3,210
],[
2,3,5,3,5,5,5,3,2,3,5,5,5,3,2,3,5,5,3,218
],[
2,5,5,5,5,5,5,5,5,5,5,5,5,2,2,5,5,5,3,86
],[
25,90,103,131,89,133,99,87,197,204,52,49,144,160,87,41,193,255,165,70
],[
149,68,213,242,30,67,67,170,49,149,239,250,127,49,201,169,2,60,44,49
],[
155,35,168,113,249,230,4,166,188,183,131,152,218,195,103,17,66,80,180,147
],[
192,8,54,74,33,148,197,64,151,109,200,208,95,239,248,93,160,176,103,68
],[
151,15,192,14,241,16,208,235,120,103,69,92,242,210,182,47,70,172,228,176
],[
225,192,64,30,88,91,173,92,79,165,134,233,153,48,227,18,161,210,24,102
],[
8,176,127,107,143,156,120,143,56,161,173,97,168,219,155,1,208,140,78,213
],[
204,109,107,126,11,66,116,11,177,177,72,108,57,84,233,41,95,13,130,84
],[
61,154,169,188,180,105,225,99,13,173,99,50,224,177,30,236,53,108,252,97
],[
234,87,103,228,85,123,12,254,41,206,222,100,158,191,94,39,204,16,26,43
],[
88,228,116,218,83,25,165,25,95,215,2,123,20,105,125,181,162,76,110,83
],[
183,134,148,169,163,57,86,11,186,120,79,65,249,89,10,53,237,76,10,239
],[
209,171,14,195,247,146,147,201,105,240,153,142,207,222,170,9,147,48,25,209
]
]