aLevelData = [
[
6,2,8,2,9,2,10,2,11,3,2,2,5,2,2,2,5,2,2,4
],[
2,2,2,2,2,2,2,2,12,3,5,2,2,2,5,2,2,2,5,2
],[
2,2,3,3,3,3,3,3,3,3,2,2,3,3,3,3,3,3,2,2
],[
2,2,3,2,2,2,2,2,2,2,5,2,3,2,2,2,2,3,2,2
],[
2,2,3,2,2,2,2,2,2,2,2,2,3,2,2,2,2,3,2,2
],[
2,2,3,2,3,3,3,3,3,3,2,5,3,2,2,2,2,2,2,2
],[
2,2,3,2,2,2,2,5,5,3,2,2,3,2,2,2,2,2,2,2
],[
2,2,3,5,5,5,2,3,3,3,5,2,3,3,3,2,2,3,3,3
],[
2,2,2,2,2,2,2,2,2,2,2,2,5,2,2,2,2,5,2,2
],[
2,3,2,2,3,1,3,2,2,2,2,2,5,2,2,2,2,5,2,2
],[
2,3,2,2,3,2,3,2,2,2,2,5,5,2,2,2,2,5,2,2
],[
2,3,2,3,2,2,2,3,2,2,2,2,5,2,2,2,2,5,2,2
],[
2,3,2,3,2,2,2,3,3,3,2,2,3,3,3,2,2,3,3,3
],[
249,112,82,73,67,164,195,22,188,220,112,72,186,102,137,32,11,39,101,102
],[
231,203,25,174,34,31,74,218,166,186,63,224,33,227,58,205,251,175,9,10
],[
139,106,216,222,138,56,73,53,200,252,199,160,29,121,23,156,163,184,47,23
],[
34,169,76,48,204,12,63,63,43,146,7,21,87,64,165,133,108,21,44,35
],[
59,236,24,75,64,164,224,101,213,125,207,104,164,197,15,157,98,181,7,166
],[
187,150,231,190,136,39,128,66,72,67,90,113,206,191,0,112,55,146,159,144
],[
31,56,207,212,21,88,177,174,75,164,58,10,146,0,206,141,134,231,17,31
]
]