aLevelData = [
[
5,5,5,5,5,2,2,2,2,2,2,2,2,2,2,2,2,2,222,30
],[
5,2,2,2,2,2,2,2,2,2,2,2,2,2,2,2,2,2,57,197
],[
5,2,5,3,3,3,3,3,3,3,2,2,3,3,3,3,3,3,52,156
],[
2,2,5,2,3,2,2,2,2,2,2,2,3,2,2,2,2,3,122,21
],[
2,2,3,2,3,2,2,2,2,2,2,2,3,2,2,2,2,3,86,73
],[
2,2,3,2,3,3,3,3,3,3,2,2,3,5,5,5,5,5,121,65
],[
4,2,3,2,2,2,2,2,2,3,2,2,3,2,2,2,2,2,150,125
],[
2,2,3,2,2,3,3,3,3,3,2,2,3,3,3,2,2,3,66,246
],[
2,2,2,2,2,3,2,2,2,2,2,2,2,2,3,2,2,3,126,235
],[
2,3,2,2,2,3,2,2,2,3,2,2,3,3,3,2,2,3,202,42
],[
2,3,2,2,2,3,2,2,2,3,2,2,3,5,5,5,5,5,193,200
],[
2,3,2,3,3,2,2,3,2,3,2,2,3,2,2,2,2,2,128,91
],[
2,3,2,3,6,2,2,3,3,3,2,2,3,3,3,3,2,3,112,48
],[
2,3,2,3,8,2,2,3,2,2,2,2,2,2,3,2,2,3,38,24
],[
2,3,2,3,9,2,3,3,2,2,2,2,2,2,3,2,3,3,113,197
],[
2,3,2,3,10,2,3,3,3,2,2,2,2,2,3,2,2,3,223,195
],[
46,153,137,149,138,78,76,226,25,123,115,159,144,82,123,33,122,128,106,39
],[
45,85,99,27,253,37,118,149,175,238,188,33,49,58,164,66,136,71,136,183
],[
9,102,132,252,204,161,135,20,94,160,170,134,182,206,193,166,106,183,48,21
],[
35,180,1,139,79,203,51,212,21,209,84,25,142,209,82,97,50,178,142,87
]
]