aLevelData = [
[
4,2,2,2,2,2,2,2,2,2,13,140,155,187,161,138,177,133,95,69
],[
231,241,48,206,152,61,111,229,18,207,251,191,74,25,139,6,206,191,66,34
],[
250,252,132,183,111,66,7,110,193,32,45,249,112,105,145,81,26,147,223,66
],[
238,93,234,42,100,180,248,254,43,216,96,141,99,187,88,9,13,170,8,195
],[
192,46,227,54,157,53,54,71,133,109,1,203,137,241,7,74,161,39,33,2
],[
161,232,215,47,106,226,49,138,93,59,203,16,22,119,40,4,86,156,72,55
],[
64,148,125,135,201,210,122,166,106,57,173,29,23,57,207,144,117,59,185,67
],[
72,63,121,221,42,195,165,108,131,231,239,170,181,208,250,127,151,74,108,198
],[
37,177,69,84,118,17,111,54,238,140,149,59,180,252,57,179,102,218,1,117
],[
12,95,82,39,75,232,32,185,220,159,5,51,60,88,144,177,164,185,223,171
],[
59,158,112,122,139,187,52,24,49,132,229,40,217,73,154,54,106,166,153,63
],[
126,26,108,116,21,246,55,59,138,121,72,119,198,57,240,9,179,196,145,151
],[
243,136,249,139,211,240,238,95,122,208,10,25,103,3,202,17,26,83,225,250
],[
16,152,210,32,245,36,189,239,22,95,121,181,21,175,228,169,224,155,119,43
],[
227,47,30,77,125,162,70,147,177,54,55,247,31,96,164,48,50,41,128,52
],[
154,212,20,252,253,193,79,135,233,145,93,33,14,139,123,229,170,62,9,129
],[
68,104,224,57,157,23,231,47,228,14,225,225,41,106,137,243,20,134,225,47
],[
215,27,199,202,97,172,201,232,212,33,58,99,58,178,133,200,116,6,194,163
],[
114,156,135,253,170,107,1,34,194,197,67,168,144,129,221,172,69,89,177,95
],[
229,145,2,194,251,218,206,173,138,117,94,22,70,155,27,144,4,29,163,18
]
]