aLevelData = [
[
2,2,2,236,232,248,41,36,121,217,16,24,232,236,249,57,50,74,104,142
],[
2,2,2,145,86,6,168,161,79,234,215,193,33,24,158,188,129,71,101,169
],[
2,2,3,56,232,110,15,191,99,10,77,13,164,13,57,173,214,127,8,19
],[
2,3,2,110,148,110,48,108,222,5,68,221,194,243,244,165,41,200,156,123
],[
2,3,2,119,165,230,53,193,163,156,70,59,114,186,133,239,65,200,48,181
],[
2,2,2,222,102,48,95,31,41,158,52,128,165,135,160,13,203,236,41,131
],[
2,2,3,118,13,165,178,64,232,170,37,154,252,71,5,28,82,241,59,25
],[
2,2,3,190,192,213,119,99,220,171,189,117,50,66,110,67,107,240,150,116
],[
2,2,3,30,65,162,144,68,154,116,195,237,28,183,222,50,203,112,159,107
],[
4,2,3,240,214,50,162,188,100,247,71,45,44,134,36,54,110,241,148,26
],[
2,2,3,105,73,240,25,113,99,75,78,66,219,95,216,148,90,198,56,240
],[
2,2,3,21,110,250,193,150,71,152,174,191,62,155,39,12,111,3,62,24
],[
2,2,3,150,233,185,99,199,99,101,82,96,168,173,119,59,116,106,19,40
],[
2,2,3,174,253,217,154,73,156,245,160,104,233,77,23,197,201,7,31,83
],[
2,2,3,115,75,203,34,199,74,29,131,226,127,49,110,239,52,184,32,63
],[
73,168,8,157,49,50,228,219,61,245,40,177,29,113,159,200,164,190,84,17
],[
203,125,179,91,249,16,236,37,129,6,152,176,108,217,159,89,122,220,89,38
],[
99,111,243,159,98,117,21,223,244,8,193,234,222,107,127,65,109,63,183,180
],[
1,250,94,120,205,150,212,121,216,134,13,241,71,238,240,58,223,19,252,225
],[
198,17,49,251,137,204,46,188,99,40,151,69,189,125,185,190,241,69,113,165
]
]