aLevelData = [
[
2,2,2,5,2,2,2,5,2,2,2,5,2,2,2,5,2,2,206,222
],[
2,2,2,2,2,5,2,2,2,5,2,2,2,5,2,2,2,2,17,126
],[
2,2,3,3,3,3,3,3,3,3,3,3,3,3,3,3,2,2,150,229
],[
2,3,2,2,2,2,2,2,2,2,2,2,2,5,2,5,2,2,36,21
],[
2,3,2,2,2,2,2,2,2,2,8,2,2,2,2,2,2,2,165,122
],[
2,2,2,2,2,5,5,5,5,2,2,2,2,5,2,3,3,3,90,205
],[
2,2,3,3,3,3,2,3,2,3,2,2,2,3,2,3,2,2,171,35
],[
2,2,3,2,2,3,2,3,2,3,3,2,2,3,2,3,2,2,121,107
],[
2,2,3,2,2,3,2,3,2,3,2,3,2,3,2,3,2,2,40,233
],[
4,2,3,2,2,3,2,3,2,3,2,3,2,3,2,3,2,2,176,107
],[
2,2,3,3,3,2,2,3,2,3,2,3,2,3,2,3,2,3,118,80
],[
2,2,3,2,3,2,2,3,2,3,2,2,3,3,2,3,2,2,194,152
],[
2,2,3,2,3,2,2,3,2,3,2,2,3,3,2,3,2,2,9,141
],[
2,2,3,2,2,3,2,3,2,3,2,2,2,3,2,3,2,2,103,217
],[
2,2,3,2,2,3,2,3,2,3,2,2,2,3,2,3,1,2,246,244
],[
2,2,2,2,2,5,5,5,5,2,2,2,2,5,2,5,3,3,239,78
],[
2,3,2,2,2,2,2,2,2,2,9,2,2,2,2,2,2,2,178,176
],[
2,3,3,3,3,2,2,2,2,2,2,2,2,2,2,2,2,2,40,155
],[
2,2,2,2,2,3,3,3,3,3,3,3,3,3,3,3,3,3,28,182
],[
2,2,2,2,2,2,2,2,2,2,2,2,2,2,2,2,2,2,130,132
]
]