aLevelData = [
[
2,2,2,2,5,5,2,2,2,2,2,2,2,2,83,109,173,245,241,183
],[
2,2,2,4,2,2,2,2,2,2,2,5,2,2,168,189,180,93,38,46
],[
5,3,3,3,5,5,3,3,3,3,3,3,3,3,221,173,16,35,43,126
],[
2,3,2,2,2,2,2,2,2,3,2,2,2,2,178,65,252,192,7,46
],[
2,3,2,2,2,2,2,2,2,3,2,2,2,2,182,87,55,254,101,42
],[
2,3,2,2,3,2,2,2,2,3,2,2,2,2,94,238,166,118,143,85
],[
2,3,2,2,3,2,2,2,2,3,2,2,2,2,195,105,25,215,31,236
],[
8,220,213,192,239,64,156,204,229,77,238,181,206,230,105,176,220,4,117,148
],[
85,103,39,52,150,133,101,235,88,199,75,120,50,244,206,12,95,237,159,162
],[
194,156,82,143,39,39,192,90,204,105,170,205,32,162,159,76,202,109,31,102
],[
237,243,0,170,170,95,17,188,231,146,254,168,79,23,115,117,154,89,132,254
],[
15,19,77,253,71,9,213,105,51,246,57,2,97,197,6,42,122,3,230,246
],[
16,149,127,133,150,166,152,144,176,228,125,67,174,236,165,75,82,2,147,49
],[
218,6,250,230,58,163,36,159,170,202,148,226,96,95,235,225,159,50,8,8
],[
240,48,115,210,176,219,252,224,202,247,159,76,198,134,171,59,3,247,36,177
],[
64,155,101,170,97,88,9,102,112,161,12,4,227,165,46,82,29,199,152,228
],[
55,79,194,99,255,95,148,40,65,40,204,9,70,93,159,115,155,232,163,186
],[
19,221,236,172,15,172,117,108,253,154,194,126,31,114,196,30,142,119,253,214
],[
126,158,229,79,195,250,139,104,149,120,127,133,144,204,240,41,254,171,18,200
],[
89,59,194,214,12,200,109,36,122,184,46,108,65,193,54,43,192,89,113,174
]
]