aLevelData = [
[
6,2,8,2,9,2,10,2,11,3,2,2,5,2,2,2,5,2,2,4
],[
2,2,2,2,2,2,2,2,12,3,5,2,2,2,5,2,2,2,5,2
],[
2,2,3,3,3,3,3,3,3,3,2,2,3,3,3,3,3,3,2,2
],[
2,2,3,2,2,2,2,2,2,2,5,2,3,2,2,2,2,3,2,2
],[
236,28,163,188,144,40,217,78,135,132,67,209,244,150,66,122,79,198,41,151
],[
185,133,58,187,140,142,210,27,55,108,224,56,73,61,155,190,203,181,117,172
],[
211,102,74,182,86,62,222,232,62,81,134,139,188,216,37,76,224,122,90,155
],[
103,203,248,82,212,19,183,151,194,80,41,3,120,126,239,4,190,21,44,127
],[
239,212,58,186,80,189,156,122,160,97,52,104,240,93,182,185,181,37,93,14
],[
28,0,221,153,157,84,152,130,211,36,20,137,139,215,173,236,27,59,135,139
],[
245,201,199,74,123,43,3,183,21,251,246,237,129,206,121,184,107,113,175,249
],[
62,114,127,76,57,226,71,233,197,90,206,200,6,60,123,9,176,59,197,146
],[
28,30,235,250,155,192,229,166,10,92,154,49,166,7,83,17,34,126,112,120
],[
247,34,90,121,252,65,184,108,54,151,230,147,241,21,162,254,15,225,9,171
],[
161,157,195,242,180,236,122,32,109,50,144,99,89,156,17,230,254,97,230,60
],[
182,71,76,2,189,104,133,192,136,54,205,17,88,189,144,4,16,40,218,193
],[
67,135,15,112,146,207,220,86,53,34,109,65,215,81,225,39,167,160,251,10
],[
172,201,26,30,88,67,107,46,97,195,93,60,204,4,85,104,75,196,164,19
],[
200,15,182,67,66,191,139,73,216,68,107,162,35,161,214,28,201,183,187,57
],[
79,198,234,216,47,49,202,18,43,129,79,99,224,173,39,10,158,153,52,178
]
]