aLevelData = [
[
4,2,2,2,2,2,2,2,2,2,8,2,2,2,2,3,2,227,206,197
],[
2,2,3,2,9,2,2,2,2,2,2,2,2,3,2,2,3,170,205,96
],[
2,3,2,2,2,2,3,2,2,3,2,3,2,2,3,2,2,96,34,199
],[
2,3,2,2,2,3,2,2,3,2,2,2,3,2,2,3,2,140,212,33
],[
249,165,182,55,195,97,113,115,10,224,59,131,208,234,72,28,8,121,61,157
],[
168,119,231,239,255,200,45,175,73,139,67,143,129,157,33,249,118,95,52,246
],[
33,186,83,79,54,96,244,242,249,84,160,150,83,172,164,162,37,150,10,75
],[
220,153,199,253,70,29,54,253,164,46,197,76,0,125,239,206,192,167,106,171
],[
124,186,161,246,13,246,100,141,230,208,222,64,168,61,200,53,240,44,221,138
],[
115,84,142,61,78,49,246,73,151,73,16,18,56,180,40,3,253,219,143,118
],[
235,128,147,212,212,255,174,253,40,211,254,234,14,91,245,145,179,222,82,8
],[
226,206,80,238,214,73,29,7,76,229,141,38,220,173,16,80,136,103,226,30
],[
150,25,129,99,155,203,100,15,217,141,234,83,202,188,145,6,253,130,104,72
],[
33,156,199,101,96,96,61,252,238,254,202,96,225,6,78,62,67,42,66,128
],[
101,70,166,114,119,157,58,35,86,101,241,15,165,135,163,250,31,160,2,31
],[
43,75,207,138,177,162,78,195,45,2,247,172,2,15,110,172,16,248,181,13
],[
136,253,161,163,255,46,138,175,194,117,71,2,106,214,89,102,176,246,103,57
],[
130,218,235,91,86,242,42,75,190,86,105,140,60,79,94,78,88,25,229,74
],[
241,231,244,238,209,40,209,186,132,9,130,234,105,59,134,85,9,246,194,149
],[
168,62,190,104,26,101,17,86,216,209,26,148,83,255,241,41,136,200,157,79
]
]