aLevelData = [
[
4,2,2,2,2,2,2,2,2,2,2,2,2,2,2,2,2,2,2,2
],[
5,2,5,3,2,2,2,2,2,2,2,2,2,2,2,2,2,2,2,2
],[
2,5,5,3,3,3,3,3,3,3,3,3,3,3,3,3,3,3,2,2
],[
3,3,5,5,5,5,5,5,5,5,3,2,2,2,2,2,2,2,2,2
],[
2,3,5,5,5,5,5,5,5,5,3,6,2,2,2,2,2,2,2,2
],[
3,3,5,5,5,5,3,3,3,3,3,3,3,3,3,2,3,3,3,3
],[
3,5,5,5,5,5,3,2,2,2,2,2,2,2,2,2,2,2,2,2
],[
3,5,5,3,3,3,3,8,2,2,2,5,5,5,5,5,5,5,5,5
],[
3,5,5,3,2,2,3,3,3,3,2,5,3,3,3,5,3,3,3,3
],[
3,5,5,3,2,2,2,2,2,3,2,5,3,5,5,5,5,5,5,5
],[
25,60,220,146,157,35,15,127,129,184,211,241,57,172,226,69,248,121,158,231
],[
208,245,85,126,28,39,195,99,27,90,216,88,221,113,188,119,99,122,17,104
],[
2,134,120,215,8,183,86,37,162,154,216,94,253,183,52,108,172,103,50,138
],[
74,230,236,251,96,169,209,251,136,242,240,246,211,161,116,248,105,77,106,101
],[
111,147,203,234,46,174,182,179,113,72,253,222,46,144,227,48,105,141,36,7
],[
86,178,54,144,190,178,207,58,163,150,167,107,39,12,127,113,170,2,98,187
],[
51,115,43,73,17,129,71,97,194,197,188,132,19,227,106,160,137,97,145,135
],[
0,185,148,160,146,172,253,220,186,218,192,236,185,144,196,178,57,225,159,245
],[
49,248,162,88,8,172,21,141,253,85,195,198,198,222,186,108,119,28,76,20
],[
166,94,89,175,205,70,209,0,239,215,116,84,127,206,220,109,125,54,190,191
]
]