aLevelData = [
[
6,2,2,2,2,2,2,2,2,2,2,2,2,2,2,2,2,2,2,2
],[
2,2,2,2,2,2,2,2,2,2,2,2,2,2,2,2,2,2,2,2
],[
2,2,2,2,2,2,2,2,2,2,2,2,2,2,2,2,2,2,2,2
],[
3,3,3,3,3,3,3,3,3,3,3,3,3,3,3,3,3,3,2,2
],[
2,2,2,2,2,2,2,2,2,2,2,2,2,2,2,2,2,2,2,2
],[
2,2,2,2,2,2,2,2,2,2,2,2,2,2,2,2,2,2,2,2
],[
2,2,2,2,2,3,2,2,3,2,2,3,2,2,2,3,2,2,3,2
],[
2,2,3,3,3,3,3,3,3,3,3,3,3,3,3,3,3,3,3,3
],[
2,2,2,2,2,2,2,2,2,2,2,2,2,2,2,2,2,2,2,2
],[
2,2,2,2,2,2,2,2,2,4,2,2,2,2,2,2,2,2,2,2
],[
3,3,3,3,3,3,3,3,3,3,3,3,3,3,3,3,3,3,2,2
],[
70,202,112,154,184,191,247,20,100,177,131,146,193,75,220,77,123,156,171,221
],[
23,37,58,242,215,48,123,68,221,100,76,205,146,151,249,53,73,227,2,142
],[
32,252,31,65,39,192,130,72,197,16,92,158,87,223,162,244,25,136,17,166
],[
74,101,112,237,139,157,21,86,137,61,170,115,219,139,49,208,46,151,70,40
],[
159,18,164,217,104,99,235,150,191,248,161,92,251,218,118,167,249,133,204,229
],[
190,246,118,43,93,5,192,39,27,245,176,86,210,74,140,118,147,218,156,63
],[
143,39,49,78,56,236,231,98,163,246,38,202,49,53,239,30,110,19,213,46
],[
57,4,73,56,38,95,27,94,32,108,62,86,83,190,204,100,73,195,73,133
],[
82,153,44,237,42,35,155,180,214,93,119,205,207,236,152,55,98,250,90,119
]
]