aLevelData = [
[
12,2,2,2,2,2,2,2,2,2,2,34,79,229,61,153,76,20,135,124
],[
2,2,2,2,2,2,2,2,2,2,2,161,83,71,1,4,154,105,246,86
],[
2,2,3,3,3,3,3,3,3,3,2,77,146,248,19,13,170,230,237,212
],[
11,2,3,2,2,2,2,2,2,3,2,152,149,180,65,76,197,121,48,3
],[
2,2,3,2,2,2,2,2,2,3,2,84,243,142,198,178,34,108,52,149
],[
2,2,3,2,2,2,2,2,2,3,2,49,81,130,238,161,213,192,27,164
],[
10,2,3,2,2,2,2,2,2,2,2,107,94,94,199,127,238,142,212,193
],[
2,2,3,2,2,2,2,2,3,3,3,43,12,247,192,59,249,31,186,49
],[
2,2,3,2,2,2,2,3,2,2,2,166,167,178,214,76,54,196,169,254
],[
9,2,3,2,2,2,2,3,2,2,2,228,182,36,219,158,207,65,136,203
],[
2,2,3,2,2,2,3,2,2,2,2,236,61,222,47,208,156,223,16,188
],[
2,2,3,2,2,3,2,2,2,2,2,109,239,152,63,207,65,123,80,180
],[
8,2,3,2,2,3,2,2,2,2,2,143,218,154,229,14,102,23,71,161
],[
2,2,3,2,3,3,2,2,2,2,2,200,224,92,76,65,68,12,236,141
],[
2,2,3,2,3,2,2,2,2,2,2,23,166,38,14,76,34,158,38,199
],[
6,2,3,2,3,2,2,2,2,2,2,169,105,229,108,87,196,228,124,63
],[
6,112,33,175,211,235,71,182,147,112,174,228,34,182,61,81,201,55,154,224
],[
110,145,247,197,7,44,47,69,85,29,17,189,206,74,251,230,219,207,172,87
],[
67,161,83,76,231,113,235,165,177,212,203,50,199,160,121,45,4,153,192,8
],[
168,77,2,106,78,60,207,116,31,60,181,72,70,28,90,204,163,136,201,171
]
]