aLevelData = [
[
2,2,2,2,2,2,2,2,2,2,2,2,2,2,2,2,2,2,2,185
],[
2,2,2,2,2,2,2,2,2,2,2,2,2,2,2,2,2,2,2,247
],[
2,2,2,2,2,2,2,2,2,2,2,2,2,2,2,2,2,4,2,223
],[
2,2,2,13,2,2,2,2,2,2,2,2,2,2,2,2,2,2,2,244
],[
2,2,2,2,2,2,2,2,2,2,2,2,2,2,2,2,2,2,2,58
],[
2,2,2,2,2,2,2,2,2,2,2,2,2,2,2,2,2,2,2,5
],[
2,2,2,2,2,2,2,2,2,2,2,2,2,2,2,2,2,2,2,60
],[
132,214,145,184,236,73,118,149,244,141,212,63,238,253,169,137,233,186,166,58
],[
40,78,59,200,211,143,245,99,235,198,9,53,131,17,49,233,46,6,182,106
],[
180,153,206,237,9,64,41,49,127,85,199,5,58,187,12,12,228,196,22,189
],[
163,82,78,173,72,61,61,17,202,245,162,126,242,105,193,244,87,39,253,27
],[
141,196,169,204,154,126,28,211,169,32,3,244,3,38,252,44,58,34,96,56
],[
167,94,95,92,23,195,83,93,194,249,78,207,125,208,245,151,48,223,146,168
],[
137,107,100,16,242,138,58,56,193,135,64,103,175,137,24,137,140,112,44,47
],[
49,0,67,214,181,65,83,108,228,37,150,16,236,108,224,26,90,197,48,91
],[
69,54,133,166,201,189,243,142,184,56,245,114,139,130,5,183,159,223,106,85
],[
158,154,82,149,58,236,32,25,34,32,7,28,46,245,216,251,221,68,24,244
],[
2,226,86,46,186,200,187,250,161,113,227,89,70,132,235,190,220,179,204,21
],[
50,227,231,3,229,141,225,112,212,100,176,67,212,56,246,108,165,26,142,40
],[
37,193,101,128,196,44,140,19,56,137,139,22,114,86,247,153,208,198,71,12
]
]