aLevelData = [
[
4,2,2,2,2,2,2,2,2,120,31,184,241,39,22,5,181,33,154,100
],[
5,2,5,3,2,2,2,2,2,22,195,163,188,239,207,250,134,107,17,75
],[
2,5,5,3,3,3,3,3,3,137,189,67,123,232,18,47,59,95,196,19
],[
3,3,5,5,5,5,5,5,5,222,202,209,73,103,231,139,39,231,92,145
],[
2,3,5,5,5,5,5,5,5,37,6,252,253,61,223,70,223,152,17,46
],[
3,3,5,5,5,5,3,3,3,235,102,18,33,110,14,199,67,135,135,82
],[
3,5,5,5,5,5,3,2,2,251,147,5,44,177,233,217,115,214,200,146
],[
3,5,5,3,3,3,3,8,2,133,37,141,105,205,41,41,220,221,0,211
],[
3,5,5,3,2,2,3,3,3,152,189,94,250,156,131,213,126,156,36,83
],[
3,5,5,3,2,2,2,2,2,31,163,138,236,54,253,231,217,163,84,72
],[
3,5,5,3,2,2,3,2,2,193,6,25,109,56,50,38,216,134,222,161
],[
5,5,5,3,2,2,3,2,2,36,169,158,35,152,157,18,25,252,218,93
],[
5,5,5,3,2,2,3,2,2,107,171,31,217,92,234,110,10,178,120,87
],[
5,3,3,3,2,2,3,2,2,208,22,103,122,224,189,41,72,116,72,238
],[
5,3,2,2,2,2,3,2,2,9,66,233,46,35,171,200,129,153,54,165
],[
183,210,60,190,37,156,229,243,61,112,83,40,98,248,28,235,250,206,254,86
],[
196,135,206,55,107,240,178,111,92,151,144,152,213,141,198,235,63,107,28,96
],[
190,147,246,22,6,184,207,246,112,161,226,148,77,41,42,85,122,139,141,215
],[
53,220,85,141,46,217,223,170,225,227,151,65,36,72,36,170,252,196,223,39
],[
181,72,138,199,50,249,63,139,129,124,166,200,178,113,107,204,234,61,239,196
]
]