aLevelData = [
[
2,243,250,211,234,114,101,27,185,82,28,44,38,109,229,194,201,137,188,253
],[
2,27,207,118,109,55,127,164,107,221,225,186,176,188,127,113,32,241,145,105
],[
5,231,203,185,19,199,209,240,206,176,6,192,80,146,107,181,72,111,198,14
],[
2,65,180,162,183,202,201,151,124,212,231,203,119,91,42,185,202,73,231,49
],[
2,148,151,63,160,29,181,244,146,84,44,124,117,124,130,84,160,34,93,151
],[
2,148,82,236,207,129,10,131,11,12,239,133,50,79,63,135,150,33,7,178
],[
2,204,152,150,105,188,205,49,44,244,223,8,189,66,59,105,129,129,26,52
],[
2,40,179,75,143,145,80,50,218,231,222,17,230,17,194,134,97,73,86,85
],[
2,149,10,59,104,83,48,241,20,41,91,164,158,219,148,73,254,17,51,234
],[
2,226,78,255,62,246,33,152,125,99,159,18,114,149,16,227,210,66,233,255
],[
2,204,168,251,65,225,22,233,13,246,173,223,52,168,104,129,23,223,90,34
],[
2,16,166,55,55,13,58,22,11,126,96,117,180,114,252,126,69,252,224,137
],[
2,69,220,226,225,96,91,49,203,93,119,233,196,80,64,228,11,17,130,212
],[
2,95,236,164,142,10,154,208,169,30,112,85,72,255,215,73,52,33,252,114
],[
2,46,19,201,103,131,189,19,242,224,230,21,185,104,249,29,29,4,8,133
],[
6,99,250,17,229,17,194,128,135,155,21,246,27,63,70,73,172,46,213,204
],[
211,236,66,208,43,249,31,106,4,177,105,119,92,113,24,222,11,251,245,21
],[
61,28,172,231,37,140,34,116,240,21,8,121,248,247,177,209,59,140,32,60
],[
11,40,102,96,7,67,43,13,73,218,138,197,225,18,34,124,130,31,105,156
],[
124,100,68,76,234,219,213,242,45,184,148,246,153,73,162,202,109,33,90,39
]
]