aLevelData = [
[
5,224,28,110,213,61,28,108,40,156,55,178,204,143,8,134,192,162,56,247
],[
5,163,144,231,185,48,183,78,48,5,202,163,203,168,198,61,147,203,39,249
],[
5,4,207,91,220,27,136,119,250,176,64,41,150,6,254,237,138,161,8,132
],[
2,234,87,166,163,228,170,41,232,234,85,44,17,20,37,26,112,191,10,240
],[
2,154,123,110,68,96,36,197,135,0,78,102,135,156,230,153,55,234,23,241
],[
2,179,46,107,220,127,101,51,120,15,195,40,168,141,96,82,104,214,47,41
],[
4,93,198,47,251,176,181,229,141,29,65,9,5,71,78,128,7,79,76,138
],[
2,31,164,185,61,95,29,230,50,73,69,253,126,239,246,67,227,88,41,155
],[
2,72,38,12,76,103,118,85,3,198,8,214,28,232,160,82,29,196,171,144
],[
2,131,118,38,173,194,53,188,182,135,133,46,119,64,173,248,141,222,108,50
],[
2,195,217,232,180,155,117,231,125,42,69,65,86,41,237,150,178,74,43,60
],[
2,217,200,25,123,69,66,172,253,76,201,129,128,0,56,217,206,84,195,226
],[
2,239,128,211,56,157,166,18,171,248,181,193,67,123,142,82,129,47,101,51
],[
2,232,30,106,232,188,11,169,92,10,96,47,121,232,104,111,246,254,190,228
],[
2,112,69,6,247,189,15,218,34,125,72,7,86,241,251,250,154,17,23,117
],[
2,246,216,116,135,143,227,17,186,19,58,160,142,87,110,68,38,63,228,153
],[
2,66,223,112,245,109,223,37,237,120,36,108,27,38,172,84,31,41,186,41
],[
2,228,77,52,72,37,244,73,49,47,194,86,222,232,153,11,84,16,200,202
],[
2,119,199,127,79,34,79,135,150,119,20,47,249,116,233,138,154,199,149,215
],[
2,0,228,142,65,5,84,4,201,239,80,33,128,221,142,144,249,101,91,60
]
]