aLevelData = [
[
2,2,2,2,2,2,2,2,2,2,2,2,2,177,122,40,115,62,198,166
],[
2,2,2,2,2,2,2,2,2,2,2,2,2,10,130,29,115,111,50,180
],[
2,2,2,2,2,2,2,2,2,2,2,2,2,254,33,95,164,9,175,237
],[
146,183,123,70,143,230,190,79,61,190,204,156,51,138,154,224,163,199,125,167
],[
58,123,52,71,72,201,41,19,33,193,244,211,195,125,33,113,185,105,51,245
],[
63,226,232,179,166,3,191,195,250,187,184,178,227,35,91,119,201,15,251,169
],[
59,228,60,239,146,169,211,183,209,96,141,43,208,150,147,96,154,57,236,209
],[
19,170,67,13,222,19,235,172,125,251,32,135,186,23,144,41,70,99,26,128
],[
161,114,213,216,57,2,84,11,214,212,40,241,53,187,167,30,243,242,236,205
],[
174,178,31,23,102,4,247,105,41,213,124,52,239,72,18,230,195,80,179,26
],[
35,125,124,11,170,22,107,79,236,105,103,194,162,95,128,192,7,83,121,151
],[
129,36,131,59,132,137,76,60,179,165,56,246,73,220,238,8,184,228,23,7
],[
144,31,98,115,161,40,204,233,100,172,30,155,151,123,183,254,40,222,139,194
],[
84,44,108,7,16,152,137,206,168,77,52,173,166,189,232,200,245,53,138,252
],[
70,181,239,93,179,0,159,227,162,239,216,96,237,10,214,181,64,89,82,70
],[
194,120,73,171,247,234,254,169,229,175,66,96,117,25,243,197,29,219,195,83
],[
188,99,58,254,197,106,255,105,160,201,83,88,77,142,222,104,75,79,174,254
],[
184,190,125,125,185,126,50,188,28,53,171,183,60,227,186,132,37,114,109,137
],[
249,142,147,237,147,182,123,76,105,147,255,175,183,137,193,187,218,141,181,40
],[
249,54,224,117,235,22,95,218,85,74,170,127,19,80,26,235,218,25,169,191
]
]