aLevelData = [
[
5,5,5,67,35,189,235,92,73,56,250,245,108,68,185,81,212,217,211,187
],[
5,2,2,174,64,250,108,96,26,221,175,26,165,84,67,173,59,222,1,161
],[
5,2,5,27,78,190,129,108,193,115,122,127,211,156,37,85,19,221,160,97
],[
2,2,5,180,235,227,142,133,170,81,132,35,147,142,39,108,89,145,97,56
],[
2,2,3,204,250,34,68,253,165,165,111,163,127,244,41,189,152,174,40,121
],[
122,8,92,85,186,18,38,132,204,60,197,147,27,24,17,76,89,97,107,219
],[
20,61,244,47,139,191,253,163,191,176,191,222,205,143,76,247,122,214,198,221
],[
16,127,207,247,105,199,64,7,73,50,30,84,241,207,202,8,240,189,119,215
],[
61,238,225,225,131,43,61,218,188,88,107,104,1,250,115,204,160,246,47,197
],[
112,155,69,177,97,227,89,246,87,246,128,160,57,240,247,76,68,228,21,68
],[
166,33,126,235,72,180,154,92,235,46,69,78,118,167,200,59,142,2,8,193
],[
104,115,254,72,219,63,103,229,186,195,189,126,96,184,101,47,140,181,42,237
],[
112,245,234,105,4,91,143,55,160,179,65,48,202,59,219,21,77,98,155,117
],[
139,207,29,208,19,165,138,252,118,6,13,200,87,214,134,224,194,193,131,240
],[
191,127,108,12,38,86,253,80,180,225,249,195,95,17,29,129,231,113,83,26
],[
174,174,41,53,201,86,129,121,87,224,138,173,17,237,239,29,35,205,78,64
],[
59,69,235,153,223,143,166,219,3,163,42,80,219,181,104,123,238,255,68,253
],[
108,192,141,181,193,133,51,43,106,167,180,47,7,21,216,189,178,83,158,36
],[
144,195,118,103,165,36,176,228,237,88,53,51,168,106,117,81,245,207,160,254
],[
162,236,25,99,67,217,40,248,129,101,239,165,181,90,159,40,182,2,235,182
]
]