aLevelData = [
[
5,5,3,5,5,5,5,5,5,5,3,5,5,5,5,120,92,135,51,148
],[
4,2,3,5,5,5,5,5,5,5,3,5,5,5,5,114,73,35,97,112
],[
2,2,3,2,3,3,3,3,3,2,3,3,3,3,3,89,14,145,86,140
],[
5,2,2,2,3,2,2,2,2,2,5,5,5,5,5,5,59,231,106,1
],[
201,252,50,212,17,29,30,95,194,82,231,6,2,55,140,97,85,79,80,52
],[
193,154,1,162,48,106,128,157,21,114,126,161,82,32,132,162,90,45,54,67
],[
146,114,216,72,254,253,17,78,25,100,239,185,4,89,44,239,227,127,176,196
],[
133,124,86,52,67,80,243,88,42,229,149,147,92,230,8,13,179,213,159,98
],[
168,88,48,155,115,212,97,93,116,61,34,96,210,45,123,35,98,51,136,222
],[
202,109,194,185,230,89,127,59,106,232,189,5,201,212,27,192,86,52,40,84
],[
169,78,224,90,69,172,116,213,120,114,74,28,130,238,69,27,249,113,70,187
],[
107,93,243,159,70,128,183,17,245,160,9,60,76,87,242,155,38,34,201,177
],[
76,180,66,251,153,144,167,35,92,214,100,118,254,93,201,152,229,3,12,118
],[
151,65,141,125,35,3,94,10,189,182,3,33,168,162,118,97,89,122,111,55
],[
217,49,225,83,107,16,200,88,111,6,34,216,134,63,59,127,247,247,46,142
],[
81,145,169,139,82,227,240,55,8,213,37,193,54,42,198,57,249,157,119,71
],[
171,48,2,29,8,193,156,170,143,222,106,17,43,218,67,89,19,32,184,102
],[
239,200,81,40,60,104,26,18,241,45,94,206,99,42,179,47,102,239,54,103
],[
181,94,24,122,148,186,90,242,179,1,212,213,86,124,124,212,179,148,229,197
],[
155,231,6,83,93,155,61,244,232,242,148,28,47,31,66,177,210,89,117,190
]
]