aLevelData = [
[
2,2,2,2,192,150,230,42,176,91,20,108,202,176,107,168,148,20,62,117
],[
2,2,2,2,160,221,88,255,179,208,65,68,37,239,189,132,139,146,150,242
],[
2,2,3,2,148,185,155,176,49,161,233,250,249,149,105,162,203,7,154,188
],[
2,2,3,2,181,223,145,154,20,19,62,251,253,120,240,127,220,216,27,94
],[
2,2,3,2,91,68,90,90,134,171,176,242,44,172,19,217,136,169,43,166
],[
2,2,3,2,32,29,87,205,238,47,241,206,190,135,211,172,215,96,25,161
],[
2,2,3,2,221,222,41,16,246,162,241,187,44,157,112,54,19,33,120,156
],[
2,2,3,2,171,62,178,128,135,75,226,38,47,195,108,243,196,83,24,35
],[
2,2,3,2,226,48,18,186,202,174,53,189,193,15,136,161,179,152,9,4
],[
2,2,3,2,28,235,170,155,41,144,154,108,26,213,197,61,234,216,158,76
],[
2,2,3,3,50,226,28,64,75,246,2,96,178,170,100,3,177,54,103,71
],[
1,2,3,2,60,203,72,6,26,38,160,6,69,100,230,112,146,24,53,132
],[
2,2,3,5,148,155,79,138,190,163,227,12,201,23,11,66,85,34,25,206
],[
2,2,3,2,211,135,147,170,162,52,124,94,120,25,213,118,4,58,100,51
],[
6,5,3,3,210,3,180,129,110,220,93,41,204,254,133,72,231,133,167,0
],[
5,2,3,2,169,198,148,109,11,226,183,218,125,156,156,53,136,103,180,193
],[
5,3,2,2,178,195,82,11,162,202,250,31,132,6,219,251,175,134,154,68
],[
5,3,2,2,133,49,81,56,155,90,216,228,27,148,67,151,102,199,171,150
],[
253,131,50,17,161,149,65,86,185,216,20,69,245,78,121,4,49,111,212,244
],[
156,193,103,227,25,169,208,131,229,129,211,26,122,234,90,124,180,100,186,55
]
]