aLevelData = [
[
5,5,5,5,5,2,2,2,2,2,2,2,27,175,144,1,159,100,230,222
],[
5,2,2,2,2,2,2,2,2,2,2,2,174,133,223,34,149,246,93,119
],[
5,2,5,3,3,3,3,3,3,3,2,2,103,78,41,212,79,221,230,160
],[
2,2,5,2,3,2,2,2,2,2,2,2,36,238,67,26,62,73,117,248
],[
2,2,3,2,3,2,2,2,2,2,2,2,136,252,229,78,215,91,37,178
],[
2,2,3,2,3,3,3,3,3,3,2,2,122,70,41,158,19,170,180,22
],[
4,2,3,2,2,2,2,2,2,3,2,2,165,74,16,138,237,192,2,253
],[
2,2,3,2,2,3,3,3,3,3,2,2,246,190,253,103,232,154,150,88
],[
2,2,2,2,2,3,2,2,2,2,2,2,32,10,56,223,134,44,25,170
],[
2,3,2,2,2,3,2,2,2,3,2,2,27,201,108,110,210,218,217,138
],[
2,3,2,2,2,3,2,2,2,3,2,2,161,75,42,231,215,0,71,34
],[
2,3,2,3,3,2,2,3,2,3,2,2,176,22,100,237,39,107,121,178
],[
2,3,2,3,6,2,2,3,3,3,2,2,11,96,242,122,85,221,168,14
],[
2,3,2,3,8,2,2,3,2,2,2,2,185,150,17,91,123,141,179,27
],[
2,3,2,3,9,2,3,3,2,2,2,2,132,216,223,178,181,165,155,86
],[
2,3,2,3,10,2,3,3,3,2,2,2,123,123,224,115,164,195,6,78
],[
2,3,2,3,11,2,3,3,3,2,2,2,113,134,124,232,236,120,188,37
],[
123,54,126,45,182,204,44,19,118,122,151,181,46,184,232,227,127,119,217,195
],[
6,170,37,115,121,5,60,241,242,4,60,56,138,48,29,172,42,158,43,184
],[
158,184,186,182,235,63,21,15,227,145,183,163,246,40,190,107,75,100,156,92
]
]