aLevelData = [
[
2,2,2,2,2,2,2,2,2,2,2,2,238,7,59,84,88,17,137,107
],[
2,2,2,2,2,2,2,2,3,3,3,3,85,150,198,144,145,37,149,237
],[
2,2,3,2,3,2,2,2,2,3,2,2,92,88,121,9,245,8,58,153
],[
2,2,3,2,3,2,2,2,2,2,3,2,9,189,138,154,119,104,232,156
],[
2,2,3,2,3,2,2,2,2,2,2,3,86,85,197,97,57,91,229,166
],[
2,2,3,2,2,2,2,2,2,2,2,2,177,86,9,65,20,215,203,108
],[
2,2,3,2,3,3,3,3,3,3,3,3,125,25,201,97,20,55,5,39
],[
2,2,3,2,2,2,2,2,2,2,2,2,144,157,140,171,250,188,86,18
],[
2,2,3,2,3,3,3,3,3,3,3,3,179,3,110,78,184,10,82,239
],[
2,2,3,2,2,2,2,2,2,2,2,2,37,16,157,60,248,167,227,131
],[
2,2,3,3,3,3,3,3,3,3,3,3,24,174,221,173,150,128,198,21
],[
1,2,3,2,2,2,2,2,2,2,2,2,50,107,4,155,33,100,11,244
],[
13,248,127,68,94,134,152,238,184,172,203,170,196,255,167,217,52,255,253,22
],[
1,74,67,14,247,15,58,145,116,198,207,233,109,30,63,106,177,55,127,74
],[
114,18,219,179,1,70,221,23,217,244,112,196,223,252,69,184,232,113,118,182
],[
124,75,106,153,218,92,248,233,59,134,207,172,91,42,21,126,54,227,78,228
],[
15,117,128,222,183,0,148,187,12,122,0,49,192,91,163,173,92,154,240,232
],[
132,217,79,187,124,221,192,52,235,64,194,233,223,106,115,140,18,189,248,192
],[
108,16,31,43,200,95,67,205,251,192,113,144,18,153,200,32,220,17,38,252
],[
169,196,1,206,80,187,146,248,119,155,57,111,14,28,29,204,29,189,19,160
]
]