aLevelData = [
[
2,2,2,2,2,2,2,2,2,2,54,19,26,158,250,31,58,186,116,134
],[
2,2,2,2,2,2,2,2,2,2,194,38,99,96,127,77,22,13,97,44
],[
2,2,2,2,2,2,2,2,2,2,37,25,210,90,96,99,70,69,5,127
],[
2,2,2,13,2,2,2,2,2,2,19,190,54,88,132,184,169,26,40,76
],[
2,2,2,2,2,2,2,2,2,2,162,79,112,1,30,72,121,75,81,190
],[
2,2,2,2,2,2,2,2,2,2,39,81,83,185,115,243,23,177,6,12
],[
2,2,2,2,2,2,2,2,2,2,156,243,6,244,103,71,48,74,48,208
],[
2,2,2,2,2,2,2,2,2,1,39,240,220,51,11,86,171,252,78,252
],[
2,2,11,2,2,2,2,2,2,2,179,61,195,50,141,119,248,35,78,190
],[
2,2,2,2,2,2,2,2,2,2,198,17,184,25,38,226,178,40,70,220
],[
246,9,221,173,10,123,187,174,113,68,164,104,34,209,94,88,57,29,9,239
],[
237,212,175,221,194,183,28,143,255,66,240,246,99,140,242,139,20,112,167,144
],[
216,234,36,152,135,195,32,73,193,113,77,97,220,57,233,247,32,150,143,4
],[
55,222,84,33,223,35,15,146,226,87,248,132,72,180,117,147,203,91,48,143
],[
139,60,109,128,3,53,155,231,60,126,40,71,64,68,154,228,210,148,220,203
],[
92,123,213,18,41,108,63,97,212,225,183,178,1,69,16,84,74,18,237,54
],[
125,55,143,98,4,188,235,200,164,168,0,61,107,35,103,195,227,216,44,11
],[
140,157,220,56,137,86,223,230,154,22,8,107,74,136,107,92,106,142,111,84
],[
189,39,36,240,245,150,214,30,222,193,226,152,218,215,200,171,141,53,130,61
],[
217,139,20,14,13,58,101,62,89,1,77,16,134,217,239,237,227,29,73,172
]
]