aLevelData = [
[
2,2,2,2,2,2,2,2,2,2,144,129,194,177,1,41,21,22,245,36
],[
229,165,137,229,103,16,181,87,105,60,221,34,136,162,162,43,163,245,254,89
],[
144,4,144,159,13,227,52,55,249,69,215,43,196,45,138,26,36,198,212,57
],[
9,142,77,152,212,186,104,167,195,215,145,248,176,173,120,70,252,104,172,183
],[
198,250,107,94,96,187,185,4,3,82,175,40,193,217,22,68,188,60,52,82
],[
150,226,230,143,40,144,239,127,119,138,144,49,227,251,89,196,162,150,62,42
],[
109,126,237,44,121,99,95,174,169,238,173,53,2,96,38,166,95,118,158,81
],[
102,143,8,45,186,16,72,101,114,8,66,20,203,16,55,77,25,118,81,95
],[
4,154,124,87,240,151,120,198,189,38,44,196,177,192,62,52,178,3,224,74
],[
185,87,237,75,131,209,52,148,138,88,20,222,51,6,73,192,73,208,5,117
],[
170,106,66,224,64,101,87,205,51,155,202,122,93,204,102,86,255,137,141,8
],[
178,81,207,179,160,251,187,121,243,83,244,62,142,8,136,174,251,198,126,129
],[
165,159,174,253,72,175,214,189,165,0,233,178,122,171,170,103,177,64,122,137
],[
216,104,110,166,209,201,165,53,203,42,217,215,113,216,51,220,96,72,100,9
],[
223,253,241,152,202,172,206,129,208,159,47,248,223,87,155,55,219,117,66,125
],[
150,219,144,87,253,14,2,30,143,222,57,193,20,74,77,196,139,158,99,137
],[
100,222,130,207,239,103,162,120,21,212,6,143,70,31,204,137,178,8,195,203
],[
188,187,124,109,171,173,164,62,163,199,144,8,213,198,26,21,242,226,172,241
],[
229,173,154,114,193,63,181,246,248,144,29,236,207,37,86,150,14,239,158,12
],[
252,112,126,133,138,31,160,210,207,14,224,43,180,202,165,46,241,130,114,37
]
]