aLevelData = [
[
2,2,2,2,2,2,2,2,59,10,222,76,48,40,198,6,233,137,66,250
],[
2,2,13,5,5,2,2,12,21,44,32,78,147,138,197,99,142,41,112,7
],[
2,2,2,5,5,2,2,2,237,110,195,236,234,179,127,88,0,153,143,31
],[
2,2,2,2,2,2,2,2,11,159,72,207,171,244,239,42,233,138,123,217
],[
2,2,2,2,2,2,2,2,29,108,157,94,15,81,254,75,92,113,200,177
],[
2,2,2,2,2,2,2,2,27,151,103,220,193,120,145,61,66,67,131,168
],[
2,2,2,2,2,2,2,2,121,121,142,192,202,255,211,175,6,114,75,26
],[
2,2,2,2,2,2,2,2,142,186,10,83,188,226,196,209,126,38,144,222
],[
2,2,2,2,2,2,2,2,68,78,236,144,29,59,1,250,28,192,41,163
],[
2,2,2,2,2,2,2,2,1,179,175,56,21,67,214,125,86,139,28,137
],[
2,2,2,2,2,2,2,2,212,104,191,51,91,136,129,200,82,196,168,255
],[
2,2,2,2,2,2,2,2,227,176,74,46,93,112,199,189,214,205,151,219
],[
4,2,2,2,2,2,2,3,20,136,70,113,174,237,188,84,110,172,194,191
],[
2,2,2,2,2,3,3,2,250,229,194,0,179,130,206,113,222,201,228,170
],[
2,49,113,245,144,117,19,3,201,232,163,221,221,8,115,28,80,85,212,93
],[
162,100,220,240,47,47,102,208,84,175,89,216,211,173,46,51,121,213,172,21
],[
254,12,246,168,44,3,200,74,67,12,254,245,157,45,86,254,142,115,118,3
],[
142,137,49,31,154,137,6,95,215,18,233,122,121,155,71,188,227,7,68,68
],[
15,121,71,111,49,105,184,148,151,248,8,242,212,128,242,230,29,112,1,98
],[
243,87,83,154,3,62,156,0,74,59,109,115,124,67,183,179,167,64,139,25
]
]