aLevelData = [
[
2,2,2,2,2,2,2,2,2,2,2,234,210,221,166,251,157,201,64,88
],[
2,2,13,5,5,2,2,12,5,5,2,72,196,152,178,77,178,21,169,100
],[
2,2,2,5,5,2,2,2,5,5,2,187,76,72,248,242,25,207,215,52
],[
2,2,2,2,2,2,2,2,2,2,2,239,182,45,83,108,238,179,116,49
],[
106,36,182,240,222,241,21,198,199,53,141,204,171,235,130,233,162,95,95,234
],[
21,226,126,212,198,194,72,120,16,121,157,73,113,37,118,107,69,56,200,12
],[
212,113,172,247,143,11,190,102,151,52,194,24,127,192,142,164,83,31,36,13
],[
217,140,30,150,22,136,79,216,20,135,167,17,227,233,87,191,222,43,54,110
],[
47,95,99,206,150,217,44,8,102,44,47,82,208,85,191,194,99,53,138,95
],[
212,69,120,126,251,133,214,76,31,181,179,167,115,200,138,50,224,150,34,168
],[
5,209,179,112,125,58,74,114,96,20,110,42,12,217,4,250,37,45,112,197
],[
218,16,253,185,106,87,127,108,231,93,55,43,59,246,246,143,104,164,133,80
],[
20,14,69,94,68,173,19,46,104,201,110,82,152,164,220,77,29,245,137,165
],[
51,151,50,58,13,131,65,213,26,252,58,4,135,9,85,38,5,40,109,194
],[
204,65,24,29,223,217,24,11,146,136,242,5,74,173,220,124,133,96,220,109
],[
26,168,47,54,193,238,232,168,213,178,217,93,89,125,182,75,58,23,120,154
],[
211,249,0,179,182,5,253,154,170,117,15,125,240,18,45,141,203,166,68,12
],[
63,179,32,167,24,101,144,7,46,198,197,163,232,49,252,216,255,9,93,59
],[
132,170,34,46,37,160,251,177,172,24,177,123,200,147,10,74,16,226,238,119
],[
69,78,199,205,215,23,46,155,171,32,195,8,28,232,92,167,64,188,99,75
]
]