aLevelData = [
[
2,2,2,2,2,2,2,2,2,6,5,2,2,2,2,2,2,2,2,2
],[
2,3,5,3,5,5,5,3,5,3,5,2,5,3,5,3,5,5,2,2
],[
2,3,2,3,2,2,2,3,5,3,5,2,5,3,5,3,5,5,3,2
],[
202,206,120,15,119,226,39,122,15,212,105,177,179,79,7,233,20,77,229,5
],[
219,231,136,10,73,107,213,211,26,176,27,6,176,166,84,70,109,49,168,170
],[
97,56,51,110,37,249,8,233,6,159,118,191,102,22,138,88,96,30,212,145
],[
171,158,110,177,193,59,59,158,64,42,109,81,144,66,74,135,198,86,47,185
],[
200,193,213,79,178,66,211,17,121,11,100,222,207,20,107,160,70,181,180,127
],[
183,116,125,85,229,28,53,98,94,15,131,66,162,220,138,27,135,20,108,27
],[
220,90,12,34,77,186,25,187,134,60,72,81,156,184,224,160,168,235,124,105
],[
181,203,12,106,220,24,30,141,173,52,92,96,209,52,85,197,238,55,128,235
],[
203,246,125,124,181,157,159,24,33,218,168,3,146,51,211,26,189,156,24,12
],[
235,73,171,198,160,193,198,47,122,52,168,22,91,14,222,104,203,204,193,167
],[
151,14,64,151,190,238,223,59,142,145,0,255,11,251,97,55,144,40,231,200
],[
185,88,154,37,127,170,240,126,165,236,78,52,84,178,204,143,2,165,57,179
],[
152,30,95,208,211,244,135,154,234,146,64,249,114,76,93,1,127,243,61,36
],[
13,166,79,166,158,236,212,82,36,0,231,108,32,108,187,230,12,217,37,214
],[
247,38,90,40,111,183,249,144,163,16,76,195,201,162,203,231,190,228,225,72
],[
236,166,243,76,113,163,159,169,126,85,65,213,252,13,188,191,118,66,119,188
],[
51,41,165,196,162,135,202,222,252,196,122,217,36,64,100,61,210,234,144,129
]
]