aLevelData = [
[
6,2,8,2,9,2,222,226,57,0,120,25,206,213,122,205,191,23,178,106
],[
2,2,2,2,2,2,90,45,251,43,127,199,87,222,84,193,62,232,57,74
],[
2,2,3,3,3,3,54,136,255,69,164,96,84,239,226,49,130,195,145,230
],[
2,2,3,2,2,2,90,155,49,212,106,23,239,64,119,66,189,33,39,115
],[
2,2,3,2,2,2,168,40,253,114,102,254,138,220,47,205,226,201,207,1
],[
2,2,3,2,3,3,78,171,248,80,64,122,220,247,140,14,251,71,212,204
],[
2,2,3,2,2,2,58,97,68,132,54,62,128,154,215,242,219,100,40,49
],[
2,2,3,5,5,5,202,212,102,18,152,87,87,19,91,252,220,93,38,217
],[
2,2,2,2,2,2,202,74,128,171,246,37,21,188,143,49,172,10,177,236
],[
2,3,2,2,3,1,89,165,54,148,244,89,208,235,201,141,85,56,145,107
],[
2,3,2,2,3,2,89,142,162,65,2,80,98,39,24,245,1,227,92,9
],[
2,3,2,3,2,2,104,9,27,116,108,103,2,255,72,159,52,20,74,22
],[
2,3,2,3,2,2,154,197,204,13,122,17,102,14,76,98,98,138,201,89
],[
2,3,2,3,2,2,112,192,68,206,155,224,61,19,124,113,52,121,174,240
],[
187,22,130,186,207,197,243,44,104,109,220,8,79,135,104,26,48,218,202,28
],[
240,137,47,216,64,80,241,140,115,11,14,146,140,120,216,64,156,61,238,14
],[
75,45,106,246,180,199,92,33,118,255,120,191,7,66,11,55,76,180,52,128
],[
103,188,80,206,209,194,182,114,168,55,165,251,74,214,122,162,34,42,38,229
],[
194,81,224,113,50,255,23,69,136,198,171,21,185,148,92,236,175,125,131,22
],[
156,186,0,61,141,242,115,210,66,185,175,175,61,87,107,250,25,202,59,76
]
]