aLevelData = [
[
2,2,3,3,3,3,3,3,3,3,3,3,3,3,3,3,2,3,2,213
],[
2,2,2,2,2,2,2,2,2,2,2,2,2,2,2,2,2,2,3,160
],[
3,2,3,3,3,3,3,3,3,3,3,2,3,3,3,2,2,2,2,133
],[
2,2,2,2,2,2,2,2,2,2,2,2,2,2,3,2,2,2,2,56
],[
3,2,3,3,3,3,3,3,3,3,3,3,3,2,3,2,2,3,3,108
],[
2,2,3,2,2,2,2,2,2,2,2,2,3,2,3,2,3,2,3,152
],[
3,2,3,2,2,3,3,3,3,3,3,3,3,2,3,2,3,2,3,171
],[
2,2,3,2,2,3,2,2,2,2,2,3,3,2,3,2,3,2,2,216
],[
2,3,3,2,2,3,3,3,3,2,2,2,2,2,3,2,3,3,3,145
],[
2,2,2,2,2,2,2,2,2,3,2,3,2,2,3,2,2,2,3,87
],[
3,3,3,3,2,2,2,2,2,3,2,3,2,2,3,2,3,2,3,30
],[
8,2,6,3,2,3,3,3,3,3,2,3,2,2,3,2,3,2,3,176
],[
2,2,2,3,2,3,2,2,2,3,2,3,2,2,3,2,3,2,3,182
],[
30,108,36,130,134,21,195,22,185,239,28,148,225,201,211,226,225,79,244,171
],[
68,46,134,167,114,120,100,29,42,73,72,166,44,171,41,51,54,183,199,81
],[
50,253,132,172,174,38,117,210,140,216,185,58,251,218,9,133,166,121,145,3
],[
43,42,254,121,206,112,217,34,111,0,19,243,185,36,225,35,157,93,202,235
],[
254,76,253,139,174,210,233,141,154,119,8,77,65,8,251,185,107,132,220,86
],[
23,58,208,132,181,43,219,2,149,181,249,180,160,115,106,164,70,95,77,72
],[
183,57,112,3,86,45,103,237,106,176,219,215,23,171,37,138,142,219,27,80
]
]