aLevelData = [
[
2,2,3,3,3,3,3,3,3,3,3,3,3,3,3,198,40,175,6,109
],[
2,2,2,2,2,2,2,2,2,2,2,2,2,2,2,94,204,181,143,174
],[
3,2,3,3,3,3,3,3,3,3,3,2,3,3,3,253,248,130,224,127
],[
2,2,2,2,2,2,2,2,2,2,2,2,2,2,3,106,133,14,148,148
],[
3,2,3,3,3,3,3,3,3,3,3,3,3,2,3,13,168,120,17,89
],[
2,2,3,2,2,2,2,2,2,2,2,2,3,2,3,186,151,239,76,114
],[
3,2,3,2,2,3,3,3,3,3,3,3,3,2,3,253,89,124,221,14
],[
2,2,3,2,2,3,2,2,2,2,2,3,3,2,3,115,135,241,119,134
],[
2,3,3,2,2,3,3,3,3,2,2,2,2,2,3,166,208,100,93,132
],[
2,2,2,2,2,2,2,2,2,3,2,3,2,2,3,75,244,239,80,165
],[
3,3,3,3,2,2,2,2,2,3,2,3,2,2,3,233,62,16,154,165
],[
8,2,6,3,2,3,3,3,3,3,2,3,2,2,3,126,57,160,82,122
],[
125,109,96,52,229,185,52,203,31,69,30,162,25,28,140,191,207,25,126,113
],[
97,169,58,54,104,210,65,219,138,117,129,229,76,208,204,48,40,70,137,214
],[
224,99,170,82,17,27,222,230,11,82,7,58,224,162,238,69,187,88,53,112
],[
115,191,142,249,96,162,43,150,110,12,118,92,111,82,1,222,182,83,192,153
],[
225,255,118,144,246,22,109,51,178,50,106,133,29,8,224,126,98,235,100,174
],[
222,146,97,36,119,26,13,142,47,78,155,162,248,39,179,188,203,143,31,200
],[
244,106,199,98,176,215,223,60,249,179,95,192,161,96,179,247,158,196,180,170
],[
165,148,216,199,250,210,165,5,134,148,108,203,42,8,51,79,83,181,243,251
]
]