aLevelData = [
[
2,2,2,2,5,5,2,219,243,228,146,119,171,85,181,239,230,253,238,234
],[
2,2,2,4,2,2,2,60,104,172,240,164,251,209,45,47,215,6,114,246
],[
5,3,3,3,5,5,3,1,81,125,80,191,233,122,73,69,73,202,80,144
],[
2,3,2,2,2,2,2,131,2,48,147,215,55,66,145,132,121,224,202,222
],[
2,3,2,2,2,2,2,157,28,89,161,64,178,93,133,8,60,87,18,45
],[
2,3,2,2,3,2,2,165,211,182,56,224,75,21,11,218,72,160,34,173
],[
2,3,2,2,3,2,2,202,105,24,22,234,53,109,41,190,211,134,67,125
],[
2,3,2,2,3,5,5,173,245,65,227,157,251,239,215,2,75,195,76,18
],[
2,3,3,2,3,2,2,17,204,101,114,51,229,220,4,215,46,164,0,37
],[
2,2,3,2,3,2,2,189,205,70,78,144,169,242,205,198,45,49,237,15
],[
2,2,3,2,3,2,2,153,84,139,98,92,35,29,238,49,116,243,82,143
],[
2,2,3,2,3,2,2,252,189,16,64,100,78,63,79,159,159,129,40,124
],[
2,2,2,2,3,2,2,23,53,251,119,9,238,97,213,127,35,66,240,54
],[
40,246,207,233,92,170,249,210,165,6,139,111,25,13,137,130,254,68,114,91
],[
245,22,23,89,114,119,172,175,111,200,32,100,98,250,170,158,108,247,165,31
],[
211,61,157,16,178,204,170,253,239,67,252,34,110,70,184,229,132,34,3,163
],[
175,180,91,175,132,135,46,152,232,60,165,171,131,47,193,185,114,87,170,27
],[
60,110,68,242,8,82,2,179,13,172,255,228,73,207,75,32,118,227,130,97
],[
58,66,164,127,158,34,32,243,193,117,50,225,206,13,111,86,43,4,159,206
],[
243,91,202,249,167,225,150,190,32,86,208,129,200,209,72,161,10,95,226,69
]
]