aLevelData = [
[
2,2,2,2,2,2,2,2,2,2,102,218,213,12,98,31,152,77,64,228
],[
2,2,2,2,2,2,2,2,3,3,107,171,221,33,185,248,154,67,137,42
],[
2,2,3,2,3,2,2,2,2,3,96,33,164,246,225,49,250,160,32,252
],[
2,2,3,2,3,2,2,2,2,2,66,17,51,207,225,42,71,180,13,88
],[
2,2,3,2,3,2,2,2,2,2,230,160,50,104,117,238,148,157,1,12
],[
2,2,3,2,2,2,2,2,2,2,55,0,59,117,252,248,192,223,12,26
],[
2,2,3,2,3,3,3,3,3,3,158,181,121,66,20,199,35,227,154,65
],[
2,2,3,2,2,2,2,2,2,2,217,155,33,217,193,11,156,77,250,229
],[
2,2,3,2,3,3,3,3,3,3,191,13,127,70,7,52,79,71,250,189
],[
2,2,3,2,2,2,2,2,2,2,203,207,176,244,95,171,146,42,100,224
],[
2,2,3,3,3,3,3,3,3,3,98,173,69,63,124,248,225,59,91,38
],[
1,2,3,2,2,2,2,2,2,2,49,248,94,173,43,164,204,72,230,10
],[
23,53,254,100,93,161,58,113,52,97,108,200,167,226,153,108,124,99,90,160
],[
185,97,130,253,102,83,1,193,147,152,9,106,157,174,111,132,174,164,83,191
],[
131,210,3,68,114,199,29,73,171,131,244,227,190,231,53,28,93,105,203,70
],[
99,12,255,143,22,144,228,213,169,229,242,187,6,230,241,252,202,68,25,255
],[
144,192,119,172,114,158,146,127,205,86,79,218,69,140,18,160,9,66,38,255
],[
88,77,95,141,69,5,253,151,183,65,212,181,179,131,170,162,222,111,225,75
],[
61,130,86,38,64,0,136,197,255,46,253,171,195,194,225,94,200,152,241,190
],[
65,166,151,148,157,50,86,110,9,66,105,171,54,85,167,210,92,80,170,40
]
]