aLevelData = [
[
2,2,3,3,3,3,3,3,3,3,3,3,3,3,3,3,191,30,200,234
],[
2,2,2,2,2,2,2,2,2,2,2,2,2,2,2,2,215,8,185,67
],[
3,2,3,3,3,3,3,3,3,3,3,2,3,3,3,2,127,48,33,181
],[
2,2,2,2,2,2,2,2,2,2,2,2,2,2,3,2,115,181,172,2
],[
3,2,3,3,3,3,3,3,3,3,3,3,3,2,3,2,252,13,13,235
],[
2,2,3,2,2,2,2,2,2,2,2,2,3,2,3,2,101,166,4,245
],[
3,2,3,2,2,3,3,3,3,3,3,3,3,2,3,2,175,205,192,109
],[
2,2,3,2,2,3,2,2,2,2,2,3,3,2,3,2,134,208,104,170
],[
2,3,3,2,2,3,3,3,3,2,2,2,2,2,3,2,115,95,245,146
],[
2,2,2,2,2,2,2,2,2,3,2,3,2,2,3,2,82,56,66,96
],[
3,3,3,3,2,2,2,2,2,3,2,3,2,2,3,2,7,4,102,164
],[
8,2,6,3,2,3,3,3,3,3,2,3,2,2,3,2,109,123,65,138
],[
2,2,2,3,2,3,2,2,2,3,2,3,2,2,3,2,143,207,85,96
],[
2,2,2,2,2,3,2,2,2,3,2,3,3,3,3,2,27,72,215,83
],[
19,43,6,121,198,225,188,21,255,85,67,22,124,158,105,224,161,222,215,79
],[
110,106,158,249,175,43,19,180,114,68,221,89,190,244,76,199,130,190,237,42
],[
204,200,91,125,59,130,87,77,183,135,27,192,95,200,236,215,195,231,239,240
],[
84,225,61,143,25,240,57,93,163,176,34,113,66,128,228,207,121,43,52,46
],[
176,200,219,255,41,222,82,170,53,204,144,27,168,104,32,125,138,231,118,69
],[
15,253,131,115,201,68,135,20,29,226,39,12,244,103,191,18,178,244,249,252
]
]