aLevelData = [
[
4,2,2,2,2,2,2,2,2,2,2,2,2,2,2,2,2,2,2,240
],[
5,2,5,3,2,2,2,2,2,2,2,2,2,2,2,2,2,2,2,51
],[
2,5,5,3,3,3,3,3,3,3,3,3,3,3,3,3,3,3,2,219
],[
3,3,5,5,5,5,5,5,5,5,3,2,2,2,2,2,2,2,2,1
],[
2,3,5,5,5,5,5,5,5,5,3,6,2,2,2,2,2,2,2,224
],[
3,3,5,5,5,5,3,3,3,3,3,3,3,3,3,2,3,3,3,59
],[
3,5,5,5,5,5,3,2,2,2,2,2,2,2,2,2,2,2,2,120
],[
3,5,5,3,3,3,3,8,2,2,2,5,5,5,5,5,5,5,5,73
],[
3,5,5,3,2,2,3,3,3,3,2,5,3,3,3,5,3,3,3,236
],[
175,141,240,124,171,216,145,88,36,139,100,95,203,158,76,123,52,105,24,212
],[
56,114,2,68,152,132,124,12,226,1,45,197,153,120,54,153,144,122,185,178
],[
151,170,156,243,89,20,138,230,133,192,59,246,44,134,246,223,107,35,84,98
],[
73,141,70,61,226,132,89,90,198,106,57,71,156,84,116,230,11,97,129,102
],[
218,75,1,113,85,59,68,167,243,226,15,76,55,197,157,61,212,216,227,41
],[
20,79,25,253,122,177,117,160,167,46,58,225,122,50,241,174,123,58,246,134
],[
122,231,55,48,115,80,57,174,181,157,92,109,67,210,95,190,123,232,38,138
],[
245,34,187,64,174,158,148,19,102,43,20,99,70,90,83,120,198,216,34,118
],[
206,250,74,141,27,154,21,113,229,34,16,10,191,230,14,108,190,183,112,9
],[
221,180,164,37,160,100,236,139,248,2,97,127,103,24,55,243,100,80,66,254
],[
1,134,185,137,203,33,59,76,242,164,15,249,170,128,176,182,208,45,137,209
]
]