aLevelData = [
[
2,2,2,2,2,103,23,188,99,154,165,225,199,53,181,72,7,81,17,103
],[
2,2,13,5,5,86,159,181,20,193,75,41,141,29,39,13,187,61,5,245
],[
2,2,2,5,5,184,104,100,120,142,9,80,132,66,169,131,244,17,27,208
],[
2,2,2,2,2,101,249,246,194,69,123,73,128,44,160,137,243,112,58,206
],[
2,2,2,2,2,43,244,108,63,255,64,108,203,244,215,136,27,97,196,103
],[
2,2,2,2,2,196,208,119,146,192,166,207,50,31,7,120,28,250,244,119
],[
2,2,2,2,2,10,169,182,3,43,53,128,151,223,16,80,69,187,4,22
],[
2,2,2,2,2,77,212,106,24,238,58,156,149,124,194,173,168,179,9,87
],[
2,2,2,2,2,112,75,181,52,110,204,254,49,46,164,110,65,42,119,228
],[
2,2,2,2,2,78,235,182,223,117,113,115,249,114,213,116,178,89,45,134
],[
2,2,2,2,2,111,136,176,19,195,217,27,247,236,28,83,144,161,196,75
],[
2,2,2,2,2,20,11,224,40,40,17,77,163,174,216,42,175,222,138,141
],[
4,2,2,2,2,92,152,87,116,252,248,186,255,132,44,254,220,53,130,0
],[
2,2,2,2,2,2,123,197,54,162,21,202,240,90,118,70,222,173,107,226
],[
211,176,255,146,200,5,156,34,36,13,114,18,59,90,28,163,20,99,129,50
],[
111,124,249,197,6,5,178,228,20,225,81,170,20,42,220,27,203,34,215,184
],[
136,109,173,81,171,126,82,27,100,80,39,2,189,86,30,64,219,180,30,47
],[
128,175,169,91,213,98,188,220,103,179,246,227,111,134,253,146,86,49,30,17
],[
120,47,51,222,41,24,202,100,245,208,131,208,44,255,186,32,159,194,102,124
],[
164,161,65,202,96,192,42,125,69,89,199,173,217,105,110,109,185,170,70,89
]
]