aLevelData = [
[
10,2,2,8,2,2,2,2,2,2,2,2,2,2,2,2,2,128,183,105
],[
2,2,2,2,2,2,2,2,2,2,2,2,2,2,2,2,2,194,26,219
],[
2,2,2,2,2,2,3,3,3,3,2,2,2,2,2,3,3,110,160,243
],[
9,2,2,2,2,2,2,2,2,3,2,2,2,2,2,3,2,47,16,34
],[
3,3,3,3,3,3,3,2,2,3,2,2,2,2,2,2,2,120,195,46
],[
2,2,2,2,2,2,2,2,2,3,2,2,2,2,2,3,2,122,160,253
],[
2,2,2,2,2,2,2,2,2,3,3,2,2,2,2,3,2,166,217,103
],[
2,2,2,2,2,2,2,2,2,2,3,2,2,2,2,3,2,60,110,52
],[
2,2,2,2,2,2,2,2,2,2,3,2,2,2,2,3,2,126,188,225
],[
2,2,2,2,3,3,3,3,2,2,3,2,2,2,2,3,2,72,65,186
],[
2,2,2,2,3,2,2,3,2,2,3,2,2,2,2,3,2,86,220,233
],[
2,2,2,2,3,2,2,3,2,2,3,3,3,5,2,3,2,216,247,70
],[
2,2,2,2,3,2,2,3,2,2,2,2,3,2,2,3,2,3,194,209
],[
2,2,2,2,3,2,2,3,2,2,2,2,3,2,2,3,2,48,33,18
],[
2,2,2,2,3,2,2,3,2,2,2,2,3,2,2,3,2,39,156,207
],[
2,2,2,2,3,2,2,3,2,2,2,2,3,2,2,3,2,113,12,38
],[
2,2,2,2,3,2,2,3,2,2,2,2,3,2,2,3,2,200,255,49
],[
137,106,246,251,101,104,138,216,64,191,19,212,202,235,109,103,101,90,159,145
],[
228,33,188,41,147,238,7,115,120,61,90,240,217,207,201,122,255,88,130,144
],[
57,121,247,238,35,237,64,96,39,7,186,217,69,92,245,191,16,189,205,138
]
]