aLevelData = [
[
2,2,2,2,2,2,2,2,2,230,121,223,131,133,100,8,134,60,56,215
],[
2,2,13,5,5,2,2,12,5,117,153,229,206,219,203,99,79,157,241,236
],[
2,2,2,5,5,2,2,2,5,4,210,152,105,126,212,126,42,28,151,156
],[
2,2,2,2,2,2,2,2,2,217,47,58,100,177,91,220,72,235,65,177
],[
2,2,2,2,2,2,2,2,2,123,121,90,85,251,247,38,96,207,223,135
],[
2,2,2,2,2,2,2,2,2,58,141,252,103,49,32,33,161,200,200,26
],[
2,2,2,2,2,2,2,2,2,31,82,98,227,64,192,234,24,124,184,62
],[
2,2,2,2,2,2,2,2,2,173,74,231,37,223,65,151,143,106,126,132
],[
2,2,2,2,2,2,2,2,2,31,253,71,235,230,235,237,229,114,35,247
],[
2,2,2,2,2,2,2,2,2,243,7,98,124,218,44,167,209,177,105,232
],[
2,2,2,2,2,2,2,2,3,101,56,80,3,232,107,186,247,179,87,83
],[
2,2,2,2,2,2,2,2,3,84,100,45,89,240,200,149,160,220,255,68
],[
4,2,2,2,2,2,2,3,2,218,150,218,209,21,128,136,196,133,145,114
],[
2,2,2,2,2,3,3,2,2,241,132,75,99,4,215,237,236,92,51,233
],[
2,2,2,3,2,2,11,2,2,7,29,255,152,250,128,92,45,126,110,99
],[
2,2,2,3,2,3,2,2,2,232,33,78,173,140,233,27,25,18,58,185
],[
2,2,2,5,2,3,2,2,2,201,159,249,137,110,180,242,59,198,164,119
],[
3,3,3,3,2,3,2,2,2,227,99,76,74,79,173,254,190,152,42,190
],[
2,1,2,2,2,3,2,2,2,24,248,253,177,59,219,173,210,133,57,40
],[
2,2,2,2,2,3,2,2,10,231,244,34,8,180,141,155,20,110,254,168
]
]