aLevelData = [
[
4,2,2,2,220,125,238,137,33,144,76,238,185,181,89,148,154,216,225,109
],[
2,2,3,2,254,25,19,57,185,207,121,167,202,205,46,189,48,229,75,121
],[
2,3,2,2,255,171,162,185,178,123,175,88,195,190,203,154,121,104,163,202
],[
2,3,2,2,2,197,233,33,193,118,73,234,233,183,159,228,75,227,103,232
],[
2,3,2,2,108,57,116,203,219,224,230,134,193,41,86,148,186,21,83,156
],[
2,3,2,3,227,23,18,80,53,26,97,149,17,198,221,228,27,255,101,240
],[
2,2,3,2,76,175,206,137,67,198,216,192,220,127,97,76,4,228,217,44
],[
2,2,2,2,204,148,246,142,188,196,169,240,105,132,80,133,73,67,45,218
],[
2,2,2,3,199,150,23,185,147,53,111,78,60,70,86,136,0,223,29,194
],[
2,2,3,2,227,198,253,163,254,123,9,66,26,120,96,142,125,183,167,238
],[
2,2,5,2,4,117,183,36,114,54,146,119,8,9,156,17,86,13,8,166
],[
2,2,2,3,80,52,144,86,164,71,105,213,75,42,118,201,94,98,188,115
],[
44,212,22,146,137,207,41,132,105,77,155,175,173,118,128,31,60,102,21,112
],[
86,48,177,239,37,35,248,252,149,76,82,179,102,59,156,203,128,10,29,189
],[
134,156,187,41,173,35,110,118,207,229,246,186,187,63,201,217,208,234,80,240
],[
202,125,82,244,219,51,177,150,254,239,84,106,136,125,100,73,255,27,187,244
],[
48,56,153,249,124,123,153,219,115,7,228,109,164,254,165,127,178,67,189,188
],[
171,133,183,211,150,121,254,213,75,102,77,222,136,231,104,248,64,237,10,60
],[
54,3,30,59,203,214,49,156,20,244,40,6,48,212,46,64,217,23,241,150
],[
56,13,14,127,254,123,201,126,176,155,2,70,66,101,101,33,232,13,224,146
]
]