aLevelData = [
[
4,2,2,2,2,2,2,2,2,2,8,2,2,2,2,3,2,2,244,86
],[
2,2,3,2,9,2,2,2,2,2,2,2,2,3,2,2,3,2,190,200
],[
2,3,2,2,2,2,3,2,2,3,2,3,2,2,3,2,2,3,22,90
],[
2,3,2,2,2,3,2,2,3,2,2,2,3,2,2,3,2,2,180,35
],[
2,3,2,2,3,2,2,3,2,2,2,2,2,3,2,2,3,2,144,145
],[
2,3,2,3,2,2,3,2,2,3,2,3,2,2,3,2,2,3,101,77
],[
2,2,3,2,2,3,2,2,3,2,2,2,3,2,2,3,2,2,150,41
],[
2,2,2,2,3,2,2,3,2,2,2,2,2,3,2,2,3,5,217,128
],[
2,2,2,3,2,2,3,2,2,3,2,3,2,2,3,5,2,3,145,190
],[
2,2,3,2,2,3,2,2,3,2,2,2,3,2,2,3,2,2,202,221
],[
2,2,5,2,3,2,2,3,2,2,2,2,2,3,5,2,3,2,42,32
],[
2,2,2,3,2,2,3,2,2,3,2,3,2,2,3,2,2,3,88,84
],[
165,87,255,195,113,228,197,98,253,74,184,94,205,205,151,196,204,122,208,161
],[
228,103,170,104,204,60,196,147,33,242,190,141,185,219,54,208,52,227,246,74
],[
211,21,107,6,142,97,90,8,96,156,206,121,230,200,85,4,40,150,107,127
],[
183,41,55,206,248,29,117,4,191,200,180,204,31,191,193,8,129,156,99,183
],[
244,255,72,28,196,211,64,29,78,211,169,233,18,76,42,221,10,36,165,169
],[
59,27,102,174,137,81,161,171,207,9,27,153,47,172,39,211,167,17,212,122
],[
229,251,101,24,93,227,1,131,152,248,172,5,207,101,118,185,184,210,242,56
],[
160,45,234,117,186,170,81,230,183,8,121,229,150,23,135,85,190,119,35,136
]
]