aLevelData = [
[
6,2,2,2,2,2,2,2,2,2,2,2,2,2,2,2,2,2,2,123
],[
2,2,2,2,2,2,2,2,2,2,2,2,2,2,2,2,2,2,2,220
],[
38,181,180,223,88,175,83,157,145,235,46,161,2,99,163,229,139,7,56,232
],[
129,106,127,0,175,188,61,242,154,248,202,192,10,94,187,194,197,36,191,248
],[
158,105,199,159,174,106,106,2,226,248,135,147,182,42,44,58,63,79,182,237
],[
111,38,58,129,149,82,36,192,35,8,30,187,180,11,52,98,77,218,53,81
],[
227,39,92,237,30,140,47,176,93,122,168,193,250,114,147,200,207,119,55,0
],[
249,195,56,142,219,185,188,17,102,27,205,122,152,125,255,30,67,249,82,9
],[
16,37,89,149,195,66,156,60,193,182,60,171,207,189,213,23,28,91,168,212
],[
130,149,250,36,9,224,183,77,173,218,91,238,97,56,18,146,83,255,30,134
],[
114,248,122,232,46,93,189,1,126,217,64,213,40,176,131,247,61,57,205,162
],[
226,149,19,6,86,155,27,224,49,18,226,77,234,35,58,224,156,13,183,242
],[
10,27,204,57,224,212,50,157,60,113,137,70,108,148,66,250,250,54,188,166
],[
229,225,173,58,50,32,196,186,163,53,141,146,199,9,148,43,51,105,205,187
],[
14,110,51,97,211,61,176,113,82,241,61,13,248,214,74,245,81,216,96,159
],[
203,59,5,139,189,140,224,209,167,215,29,252,188,26,19,26,157,250,36,20
],[
104,181,229,60,241,88,127,37,79,50,86,183,155,136,232,130,244,138,247,83
],[
198,134,234,5,76,92,113,154,84,50,104,139,67,104,254,91,88,206,22,114
],[
53,21,237,41,155,132,253,34,117,236,34,218,24,222,252,129,201,27,148,9
],[
127,76,66,125,235,244,206,148,182,162,213,134,10,107,110,30,83,151,14,16
]
]