aLevelData = [
[
2,2,2,2,2,11,2,2,2,2,2,2,2,2,9,2,2,2,2,210
],[
2,2,2,2,2,2,2,2,2,2,2,2,2,2,2,2,2,2,2,83
],[
5,2,5,2,5,5,5,2,5,5,5,2,5,5,5,2,5,2,5,161
],[
5,2,5,2,5,2,5,2,5,2,5,2,5,2,5,2,2,5,2,183
],[
5,5,5,2,5,5,5,2,5,5,5,2,5,5,5,2,2,5,2,35
],[
5,2,5,2,5,2,5,2,5,2,2,2,5,2,2,2,2,5,2,195
],[
5,2,5,2,5,2,5,2,5,2,2,2,5,2,2,2,5,5,5,104
],[
2,2,2,12,2,2,2,2,2,2,2,2,2,10,2,2,2,2,2,92
],[
2,2,7,2,2,2,2,2,8,2,2,2,2,2,2,2,7,2,2,137
],[
2,2,7,2,5,5,5,2,5,5,5,2,5,5,2,2,7,2,2,215
],[
2,2,7,2,5,2,2,2,2,5,2,2,5,2,5,2,7,2,2,161
],[
146,128,102,213,145,240,10,72,93,96,129,206,72,103,83,224,184,100,181,239
],[
42,111,174,248,119,144,120,89,86,46,41,227,35,202,147,48,223,237,104,55
],[
119,94,162,29,73,153,33,79,228,125,150,205,15,69,161,201,14,185,54,112
],[
32,165,69,8,76,139,154,59,93,149,2,178,44,205,175,230,29,144,221,51
],[
236,64,182,47,170,58,115,57,2,8,197,85,193,215,115,55,150,43,68,157
],[
21,209,31,226,2,22,113,208,205,54,207,183,89,23,221,187,1,55,110,114
],[
221,227,236,175,65,171,251,152,135,18,89,255,15,138,8,239,131,159,176,132
],[
96,114,63,0,178,105,210,28,31,37,216,156,38,180,116,38,169,8,36,84
],[
169,168,161,8,82,166,6,0,55,209,51,170,222,43,116,57,127,158,94,248
]
]