aLevelData = [
[
2,2,2,5,2,2,2,5,2,2,2,5,2,2,242,75,243,82,221,53
],[
2,2,2,2,2,5,2,2,2,5,2,2,2,5,115,95,89,31,220,231
],[
2,2,3,3,3,3,3,3,3,3,3,3,3,3,182,103,44,193,4,43
],[
2,3,2,2,2,2,2,2,2,2,2,2,2,5,20,176,134,245,4,45
],[
2,3,2,2,2,2,2,2,2,2,8,2,2,2,99,158,137,103,159,108
],[
2,2,2,2,2,5,5,5,5,2,2,2,2,5,216,137,74,126,171,59
],[
2,2,3,3,3,3,2,3,2,3,2,2,2,3,247,106,75,107,112,36
],[
2,2,3,2,2,3,2,3,2,3,3,2,2,3,238,77,168,34,68,160
],[
2,2,3,2,2,3,2,3,2,3,2,3,2,3,241,189,77,52,111,219
],[
4,2,3,2,2,3,2,3,2,3,2,3,2,3,109,169,205,203,194,121
],[
2,2,3,3,3,2,2,3,2,3,2,3,2,3,46,112,181,57,103,162
],[
2,2,3,2,3,2,2,3,2,3,2,2,3,3,207,27,107,209,207,184
],[
2,2,3,2,3,2,2,3,2,3,2,2,3,3,6,235,249,12,207,128
],[
2,2,3,2,2,3,2,3,2,3,2,2,2,3,176,194,88,37,71,178
],[
2,2,3,2,2,3,2,3,2,3,2,2,2,3,167,22,21,169,234,31
],[
199,104,102,188,250,239,177,127,10,251,33,178,36,205,132,62,163,45,17,203
],[
153,175,159,41,171,53,21,238,35,181,34,97,64,60,46,151,208,51,144,220
],[
1,226,1,85,117,50,80,227,148,183,88,73,38,237,48,146,33,194,161,173
],[
191,85,221,91,212,254,109,75,95,142,108,130,95,216,243,1,232,112,212,162
],[
117,178,139,68,128,6,113,39,80,99,51,153,19,18,131,211,44,181,13,30
]
]