aLevelData = [
[
5,5,5,5,5,2,2,2,157,227,37,146,93,182,178,20,155,240,105,0
],[
5,2,2,2,2,2,2,2,224,68,63,74,225,231,164,113,175,244,87,4
],[
5,2,5,3,3,3,3,3,46,16,126,101,200,74,246,205,98,68,232,144
],[
2,2,5,2,3,2,2,2,143,152,157,163,4,117,147,91,77,137,208,119
],[
190,36,118,97,171,154,152,177,220,233,76,243,59,155,1,170,208,238,19,149
],[
239,51,157,48,176,116,143,126,160,89,0,6,182,76,197,27,137,220,66,97
],[
191,95,128,141,201,220,128,108,206,40,207,39,228,78,91,197,134,52,133,241
],[
67,124,119,254,179,169,184,40,175,131,253,29,193,188,67,188,218,211,26,28
],[
67,57,68,208,214,179,126,105,110,255,158,61,156,186,222,103,156,129,120,15
],[
135,87,115,236,201,70,188,6,214,73,120,193,25,106,153,23,45,40,175,37
],[
80,27,1,233,21,219,221,74,89,29,44,88,119,31,73,214,192,71,20,246
],[
37,7,66,99,55,3,247,132,82,118,150,0,20,209,216,125,20,166,27,174
],[
209,197,253,140,233,165,42,227,140,5,114,17,47,210,31,10,133,76,133,160
],[
171,101,218,2,163,105,72,130,3,228,65,155,238,193,19,50,68,175,188,28
],[
22,201,255,225,93,117,183,191,235,140,108,242,161,188,36,51,227,43,123,127
],[
73,93,246,25,151,88,149,210,240,6,167,136,70,218,226,237,21,182,179,137
],[
81,13,211,3,157,69,27,156,189,95,153,252,78,217,227,49,180,211,171,245
],[
85,114,148,47,5,130,68,189,192,95,187,113,159,21,227,89,5,198,104,68
],[
25,76,201,129,122,32,176,234,46,122,127,34,219,186,43,26,57,7,77,218
],[
199,54,118,126,189,237,195,126,66,8,178,51,224,59,52,151,53,249,4,77
]
]