aLevelData = [
[
5,5,3,5,5,5,79,241,120,75,142,189,186,220,26,161,184,28,233,198
],[
4,2,3,5,5,5,208,132,223,149,145,246,170,18,194,172,235,107,166,111
],[
2,2,3,2,3,3,150,208,127,9,155,134,81,252,198,55,232,116,227,141
],[
5,2,2,2,3,2,28,123,39,255,84,108,203,234,73,170,250,227,13,145
],[
2,2,2,3,2,2,237,76,75,173,85,37,208,42,249,37,74,140,160,9
],[
2,2,2,3,2,2,80,161,49,45,163,179,25,89,180,1,237,221,102,113
],[
2,2,2,2,2,2,80,224,20,127,24,245,214,121,172,239,0,238,176,247
],[
5,2,2,2,2,2,236,100,229,219,250,73,74,169,212,44,136,125,247,45
],[
2,2,5,5,3,2,140,151,111,178,118,176,225,92,178,142,207,58,100,215
],[
2,2,5,5,3,2,24,60,10,35,190,234,93,84,236,85,119,42,56,78
],[
59,18,37,215,242,63,236,215,50,252,124,18,4,65,191,87,69,132,31,251
],[
77,209,73,135,207,29,48,174,0,216,85,130,252,193,71,231,101,254,101,71
],[
77,108,235,135,86,52,45,58,23,159,29,21,194,43,19,163,4,222,206,58
],[
45,218,182,46,145,50,99,68,46,252,99,106,143,167,56,165,240,143,161,74
],[
162,207,27,113,177,86,166,167,197,62,204,227,70,89,224,188,195,12,132,216
],[
149,96,109,168,191,86,107,82,25,123,163,239,174,189,31,247,98,125,138,249
],[
216,229,52,144,146,124,93,146,90,247,175,138,225,83,12,105,167,32,138,120
],[
26,32,188,145,2,16,52,143,28,198,69,3,5,124,14,41,90,108,179,26
],[
30,157,238,66,92,252,199,21,13,174,159,254,59,165,115,152,103,113,95,33
],[
41,89,97,44,22,171,96,149,230,80,109,186,215,163,72,232,76,132,38,20
]
]