aLevelData = [
[
5,5,5,5,5,2,2,2,2,2,2,149,210,11,1,235,184,226,35,211
],[
5,2,2,2,2,2,2,2,2,2,2,90,50,211,37,126,184,170,168,32
],[
5,2,5,3,3,3,3,3,3,3,2,145,31,133,21,80,77,251,238,78
],[
2,2,5,2,3,2,2,2,2,2,2,247,85,31,65,201,25,97,16,224
],[
2,2,3,2,3,2,2,2,2,2,2,131,84,230,141,49,105,134,86,32
],[
2,2,3,2,3,3,3,3,3,3,2,255,222,62,215,204,222,71,226,127
],[
4,2,3,2,2,2,2,2,2,3,2,138,52,130,163,78,147,163,199,146
],[
2,2,3,2,2,3,3,3,3,3,2,251,14,220,143,147,224,222,97,211
],[
2,2,2,2,2,3,2,2,2,2,2,59,183,93,143,59,96,164,49,44
],[
2,3,2,2,2,3,2,2,2,3,2,73,248,70,250,251,207,60,232,252
],[
2,3,2,2,2,3,2,2,2,3,2,166,105,133,242,152,80,221,12,47
],[
2,3,2,3,3,2,2,3,2,3,2,32,236,158,122,126,88,11,96,132
],[
95,232,51,10,13,94,137,36,179,208,71,235,150,190,254,129,228,234,123,79
],[
236,185,153,145,141,219,90,21,239,46,54,63,114,224,179,81,228,213,54,233
],[
247,72,25,204,242,180,253,225,166,245,98,129,164,170,117,238,173,223,40,32
],[
106,233,136,200,93,144,76,143,24,116,169,158,173,169,110,100,101,165,76,147
],[
181,92,117,108,109,169,106,61,51,240,13,40,48,2,254,37,9,64,36,74
],[
17,4,138,75,189,60,109,61,88,88,147,159,247,103,222,154,176,124,32,136
],[
7,87,49,180,169,65,63,96,93,56,102,13,55,76,128,246,14,73,63,222
],[
49,150,121,11,86,93,194,147,211,236,64,214,17,92,187,76,61,112,244,129
]
]