aLevelData = [
[
2,2,170,238,5,8,92,185,71,155,212,247,211,97,130,49,163,191,69,145
],[
196,214,201,233,82,170,19,246,164,132,90,231,196,149,25,25,34,219,98,37
],[
137,73,117,28,81,34,145,17,215,166,10,216,42,240,156,14,7,31,255,89
],[
8,180,187,241,24,59,62,96,42,46,44,134,43,22,246,223,52,243,174,9
],[
5,222,26,128,175,237,7,173,144,87,223,31,132,216,126,24,90,87,66,75
],[
133,199,97,228,20,75,128,201,229,157,129,31,21,176,156,17,186,148,177,204
],[
213,155,220,206,130,186,75,97,114,49,76,98,155,110,170,71,46,47,58,97
],[
202,232,177,93,239,100,184,17,181,174,67,118,190,50,30,240,105,32,200,214
],[
72,17,133,46,213,237,175,184,96,12,77,47,76,155,231,203,123,66,152,10
],[
7,3,100,176,51,102,204,12,161,211,160,126,197,63,21,54,153,11,23,62
],[
146,40,224,187,211,128,202,112,162,145,97,131,24,91,189,132,28,125,15,171
],[
146,155,121,97,207,2,35,2,80,143,139,226,172,205,28,142,200,93,3,84
],[
74,155,62,5,80,126,245,249,97,192,14,84,164,63,252,136,79,164,215,27
],[
99,66,178,171,151,65,41,47,145,251,57,127,92,166,85,23,23,52,181,23
],[
234,119,242,143,63,137,208,250,46,107,90,8,56,236,53,161,57,204,46,38
],[
152,34,21,250,193,251,206,65,213,68,165,231,159,234,226,228,203,63,157,191
],[
82,160,212,81,57,85,187,204,123,184,83,252,68,153,62,204,95,226,210,11
],[
242,119,108,112,105,96,7,220,176,42,13,224,165,138,108,127,205,68,237,53
],[
69,75,194,56,252,42,93,253,32,162,137,254,214,149,179,187,46,35,136,254
],[
86,18,198,100,14,115,75,25,91,130,115,227,128,207,160,98,42,155,26,150
]
]