aLevelData = [
[
2,2,2,2,2,2,177,248,170,115,47,164,116,231,148,108,120,10,228,148
],[
2,2,13,5,5,2,249,221,170,205,245,56,233,88,181,17,85,110,162,251
],[
2,2,2,5,5,2,195,224,90,237,223,251,3,69,29,174,224,12,242,239
],[
2,2,2,2,2,2,33,124,67,90,0,191,30,27,9,250,168,15,185,138
],[
2,2,2,2,2,2,86,38,75,142,96,12,207,165,115,8,124,249,167,36
],[
2,2,2,2,2,2,71,124,176,142,181,113,88,62,237,47,45,217,17,33
],[
2,2,2,2,2,2,118,213,206,18,108,223,50,167,167,121,190,45,215,232
],[
2,2,2,2,2,2,189,149,180,77,212,189,56,18,217,242,11,135,232,178
],[
2,2,2,2,2,2,63,205,180,182,61,244,28,48,255,96,255,81,128,113
],[
2,2,2,2,2,2,80,14,113,99,109,36,46,114,172,89,240,66,55,5
],[
2,2,2,2,2,2,68,127,27,210,188,192,155,192,228,178,202,108,119,114
],[
2,2,2,2,2,2,89,145,211,58,173,207,171,64,52,171,252,219,250,216
],[
4,2,2,2,2,2,66,232,119,181,235,108,172,22,12,123,110,71,83,88
],[
2,2,2,2,2,3,1,78,61,221,232,113,136,29,252,248,236,73,188,52
],[
2,2,2,3,2,2,6,208,228,192,149,202,65,7,232,151,195,6,151,195
],[
2,2,2,3,2,3,212,84,114,45,232,95,183,105,85,248,136,98,102,18
],[
2,2,2,5,2,3,155,68,170,198,52,153,146,155,80,178,59,5,35,72
],[
137,43,197,99,117,237,41,123,168,38,78,221,72,46,185,81,18,164,34,250
],[
169,106,110,125,45,240,221,102,16,182,133,199,37,12,255,33,250,29,96,136
],[
104,43,106,3,104,28,4,50,40,54,232,51,95,39,156,197,221,72,163,174
]
]