aLevelData = [
[
10,2,2,8,2,2,2,2,2,2,2,2,204,56,218,56,124,2,42,116
],[
2,2,2,2,2,2,2,2,2,2,2,2,132,254,61,106,86,165,53,1
],[
85,158,168,198,231,135,84,212,203,241,14,247,173,172,252,17,247,70,4,188
],[
235,206,132,48,239,221,68,104,39,216,169,128,73,111,43,98,173,105,8,161
],[
164,164,58,165,11,87,167,9,32,155,153,65,148,42,109,128,225,102,143,216
],[
221,157,166,164,143,139,11,35,66,32,128,101,217,132,31,107,98,89,144,138
],[
238,64,127,16,159,158,77,42,2,160,6,5,159,124,148,52,207,250,50,82
],[
206,52,35,232,17,153,163,144,218,56,30,91,9,60,160,113,53,178,141,247
],[
251,147,146,54,150,254,219,249,176,197,134,54,120,43,88,241,245,236,175,94
],[
154,126,184,70,26,151,226,171,126,239,147,175,116,71,25,178,234,170,227,187
],[
219,243,241,25,105,143,137,74,45,132,44,27,203,178,200,17,201,89,47,8
],[
161,220,200,26,20,197,132,194,194,8,20,65,248,140,90,65,201,231,29,185
],[
96,106,0,16,148,93,181,133,189,139,110,206,198,2,148,255,132,20,188,174
],[
70,161,215,85,174,153,168,247,191,188,124,7,54,164,21,133,30,6,231,106
],[
159,53,135,70,23,231,96,40,108,60,168,190,160,252,146,189,165,32,197,131
],[
115,149,14,252,89,60,81,194,144,53,198,136,22,93,97,184,185,21,146,91
],[
114,70,47,58,245,162,175,66,134,44,152,45,14,250,58,95,110,57,158,14
],[
19,115,186,166,203,13,230,108,215,20,148,97,65,57,59,105,112,25,148,172
],[
249,194,9,61,184,115,107,250,32,164,227,179,207,70,43,142,101,76,253,169
],[
151,106,204,2,127,29,179,148,54,235,171,195,165,236,0,250,152,137,6,147
]
]