aLevelData = [
[
4,2,2,2,42,58,36,134,170,84,68,25,93,55,231,137,62,65,5,196
],[
2,2,3,2,19,112,174,100,160,201,231,48,26,250,180,230,222,62,118,56
],[
2,3,2,2,99,129,119,20,109,197,196,40,132,196,59,166,165,214,228,68
],[
2,3,2,2,55,22,133,136,64,192,112,66,217,222,160,90,224,36,4,203
],[
2,3,2,2,236,24,27,240,134,118,193,255,150,210,73,211,27,127,203,238
],[
2,3,2,3,31,176,191,190,235,221,203,31,119,104,218,34,36,129,110,12
],[
2,2,3,2,173,71,55,162,91,47,228,164,121,170,57,152,8,2,98,200
],[
2,2,2,2,180,133,135,142,6,230,160,207,218,224,139,198,20,28,91,3
],[
2,2,2,3,143,85,244,179,86,186,213,33,23,148,52,125,212,40,80,221
],[
2,2,3,2,220,223,3,129,250,164,150,91,236,142,218,206,22,191,116,183
],[
2,2,5,2,120,140,121,170,222,222,59,126,86,215,98,11,231,185,62,50
],[
2,2,2,3,128,4,91,30,47,223,86,202,147,185,240,195,148,48,97,48
],[
2,2,3,2,81,50,239,15,90,98,190,193,32,189,234,201,170,125,211,209
],[
2,3,2,2,137,61,184,237,13,95,136,36,185,171,244,45,245,56,201,118
],[
2,2,2,3,3,144,125,107,52,15,7,244,92,140,244,63,131,60,184,193
],[
2,2,3,2,221,210,66,119,253,235,211,114,69,170,15,146,161,159,85,146
],[
2,3,2,2,117,238,76,68,211,173,190,30,242,141,170,246,219,189,148,10
],[
102,11,32,67,101,77,223,187,31,255,105,124,0,45,172,139,142,148,131,37
],[
159,4,139,72,201,8,50,117,27,201,16,181,10,48,123,218,174,75,85,7
],[
47,242,41,114,122,170,118,105,56,201,75,147,0,219,20,121,203,69,180,68
]
]