aLevelData = [
[
2,2,2,5,2,2,2,5,2,2,2,5,117,62,182,5,103,2,225,101
],[
2,2,2,2,2,5,2,2,2,5,2,2,226,254,225,196,234,186,116,246
],[
2,2,3,3,3,3,3,3,3,3,3,3,209,205,34,116,253,150,32,175
],[
2,3,2,2,2,2,2,2,2,2,2,2,235,45,117,164,116,153,91,177
],[
2,3,2,2,2,2,2,2,2,2,8,2,79,68,232,167,216,172,237,32
],[
2,2,2,2,2,5,5,5,5,2,2,2,15,90,31,19,228,24,116,165
],[
2,2,3,3,3,3,2,3,2,3,2,2,178,95,208,66,9,15,225,237
],[
2,2,3,2,2,3,2,3,2,3,3,2,176,98,71,212,234,35,249,40
],[
2,2,3,2,2,3,2,3,2,3,2,3,249,27,228,43,225,205,213,139
],[
4,2,3,2,2,3,2,3,2,3,2,3,110,99,152,238,120,231,98,206
],[
2,2,3,3,3,2,2,3,2,3,2,3,102,182,108,135,241,50,225,174
],[
43,184,250,165,191,210,103,108,122,173,242,186,10,205,95,77,6,255,150,126
],[
47,143,4,24,246,188,62,106,62,105,231,155,98,21,213,62,122,13,111,38
],[
218,224,89,124,220,20,84,14,224,23,95,234,144,120,34,44,105,87,141,20
],[
119,27,189,92,95,99,31,200,163,62,215,254,34,158,99,152,222,10,123,120
],[
2,148,60,91,36,11,134,177,199,113,163,173,36,175,41,152,42,136,33,106
],[
195,204,104,155,89,206,86,55,153,23,158,49,118,92,117,249,113,174,247,80
],[
24,241,198,92,205,143,244,247,201,110,35,77,97,31,234,166,135,88,123,128
],[
147,164,131,225,68,89,82,235,1,202,60,177,101,191,63,73,251,34,230,35
],[
70,251,108,152,5,159,37,198,180,35,26,156,86,23,243,49,114,113,27,90
]
]