aLevelData = [
[
6,2,2,2,2,2,2,2,2,2,2,2,2,2,2,2,2,2,2,176
],[
2,2,2,2,2,2,2,2,2,2,2,2,2,2,2,2,2,2,2,174
],[
2,2,2,2,2,2,2,2,2,2,2,2,2,2,2,2,2,2,2,225
],[
3,3,3,3,3,3,3,3,3,3,3,3,3,3,3,3,3,3,2,117
],[
2,2,2,2,2,2,2,2,2,2,2,2,2,2,2,2,2,2,2,33
],[
2,2,2,2,2,2,2,2,2,2,2,2,2,2,2,2,2,2,2,19
],[
2,2,2,2,2,3,2,2,3,2,2,3,2,2,2,3,2,2,3,205
],[
2,2,3,3,3,3,3,3,3,3,3,3,3,3,3,3,3,3,3,157
],[
2,2,2,2,2,2,2,2,2,2,2,2,2,2,2,2,2,2,2,41
],[
2,2,2,2,2,2,2,2,2,4,2,2,2,2,2,2,2,2,2,190
],[
3,3,3,3,3,3,3,3,3,3,3,3,3,3,3,3,3,3,2,196
],[
2,2,2,2,2,2,2,2,2,2,2,2,2,2,2,2,2,3,2,24
],[
2,2,2,2,2,2,2,2,2,2,2,2,2,2,2,2,2,3,2,216
],[
2,2,3,3,3,3,3,3,3,3,2,3,3,3,3,3,3,3,2,147
],[
2,2,3,2,2,2,2,2,2,2,2,3,2,2,2,2,2,3,2,226
],[
2,2,3,2,2,2,2,2,2,2,2,3,2,2,2,2,2,3,2,35
],[
199,211,58,21,67,168,26,146,174,254,145,2,35,149,47,65,89,84,12,152
],[
202,225,11,237,20,110,96,54,159,214,80,52,128,232,56,93,157,2,209,26
],[
18,227,178,50,212,186,23,134,148,130,224,0,231,146,221,198,163,112,72,179
],[
140,231,147,7,48,89,101,93,15,86,223,222,255,108,35,181,207,65,23,194
]
]