aLevelData = [
[
2,2,225,161,55,164,195,101,239,178,54,114,213,26,235,198,190,239,252,36
],[
2,2,50,41,208,103,112,154,62,23,177,36,245,58,177,40,27,108,108,65
],[
3,2,52,50,37,51,70,140,173,30,58,201,226,248,134,159,118,57,9,123
],[
2,2,242,216,54,22,250,119,117,73,210,219,198,34,33,158,168,55,245,40
],[
3,2,57,58,8,219,158,206,66,142,165,153,126,61,169,155,145,254,183,190
],[
2,2,136,55,238,174,50,15,44,234,223,34,231,28,102,121,88,166,109,185
],[
3,2,223,125,228,154,163,58,211,155,121,110,86,245,7,54,229,205,41,16
],[
2,2,217,173,147,237,44,53,184,136,129,14,235,245,100,32,196,125,210,5
],[
2,3,198,169,252,189,62,157,72,163,110,167,153,159,235,24,208,158,68,83
],[
2,2,147,63,228,35,77,207,58,82,117,120,23,119,20,181,87,15,129,9
],[
3,3,195,207,111,241,54,57,42,23,255,110,30,200,135,67,153,168,52,150
],[
8,2,210,165,140,227,41,41,158,18,176,148,157,147,235,233,207,173,212,199
],[
2,2,165,19,34,156,44,185,203,21,164,229,200,217,109,137,24,118,43,208
],[
2,2,7,155,34,247,176,137,226,94,193,196,41,223,126,14,5,94,9,149
],[
2,2,57,161,224,108,226,98,167,56,90,163,40,44,93,66,152,55,106,205
],[
9,2,27,123,108,151,139,2,154,12,117,172,156,65,101,108,239,208,100,180
],[
2,2,138,226,190,46,194,141,9,173,107,97,98,99,64,61,250,84,133,103
],[
210,10,234,220,194,139,179,229,192,136,22,235,95,215,228,140,150,36,108,239
],[
195,227,157,84,239,136,106,239,84,251,115,246,28,70,225,249,108,145,145,114
],[
161,81,118,157,218,188,56,137,182,128,33,111,95,180,58,68,199,15,177,138
]
]