aLevelData = [
[
2,2,2,2,2,2,2,2,2,6,5,2,97,148,227,111,211,60,46,7
],[
2,3,5,3,5,5,5,3,5,3,5,2,229,186,215,223,32,4,80,183
],[
2,3,2,3,2,2,2,3,5,3,5,2,19,248,72,139,155,149,24,104
],[
2,2,2,2,2,2,2,2,2,2,2,2,97,107,94,127,163,80,231,120
],[
2,3,5,3,5,5,5,3,2,3,5,5,56,85,211,8,206,249,243,198
],[
2,3,5,3,5,5,5,3,2,3,5,5,119,156,118,58,100,54,197,55
],[
2,5,5,5,5,5,5,5,5,5,5,5,239,72,171,107,223,19,185,53
],[
2,3,5,3,5,5,5,3,5,3,5,5,232,9,233,182,114,129,129,43
],[
2,3,5,3,5,5,5,3,5,3,5,5,156,174,58,122,127,210,162,10
],[
2,5,5,5,5,5,5,5,5,5,5,5,183,175,191,216,32,62,245,200
],[
2,3,5,3,2,2,2,3,2,3,2,2,221,164,41,57,159,98,39,219
],[
5,3,5,3,2,2,2,3,2,3,2,2,35,204,65,197,253,188,57,194
],[
5,5,5,5,5,5,5,5,5,5,5,5,149,135,98,236,111,48,1,125
],[
5,3,5,3,5,5,5,3,5,3,5,5,175,220,249,225,220,134,168,16
],[
228,244,12,26,96,234,42,3,26,157,176,210,204,106,217,229,43,200,145,135
],[
36,124,218,197,102,12,110,125,32,117,165,183,12,32,154,56,172,19,137,85
],[
212,101,124,6,104,244,39,59,103,90,16,115,40,28,243,138,228,37,100,210
],[
117,115,182,102,93,17,28,187,10,69,14,120,89,10,238,136,88,192,236,109
],[
80,35,39,215,3,122,20,117,50,16,36,11,98,232,161,197,224,173,217,203
],[
3,232,127,21,177,118,78,129,36,56,239,34,238,12,29,219,59,252,7,45
]
]