aLevelData = [
[
2,2,2,2,2,2,2,2,2,2,59,185,100,36,17,114,199,142,88,76
],[
2,2,13,5,5,2,2,12,5,5,104,90,32,167,119,12,177,63,18,83
],[
2,2,2,5,5,2,2,2,5,5,205,91,177,222,53,71,194,113,111,3
],[
2,2,2,2,2,2,2,2,2,2,144,56,197,61,105,91,145,125,0,210
],[
2,2,2,2,2,2,2,2,2,2,184,160,16,123,117,135,66,106,88,16
],[
2,2,2,2,2,2,2,2,2,2,81,128,142,69,108,63,98,212,220,220
],[
2,2,2,2,2,2,2,2,2,2,4,192,230,150,137,85,243,71,52,97
],[
2,2,2,2,2,2,2,2,2,2,238,57,244,161,238,58,45,122,21,243
],[
2,2,2,2,2,2,2,2,2,2,187,233,184,117,53,189,191,21,110,4
],[
2,2,2,2,2,2,2,2,2,3,79,122,66,195,167,244,143,234,72,15
],[
2,2,2,2,2,2,2,2,3,3,129,134,89,105,19,57,73,192,210,231
],[
2,2,2,2,2,2,2,2,3,2,182,79,228,179,142,91,74,42,116,9
],[
4,2,2,2,2,2,2,3,2,2,98,189,101,114,176,117,155,249,221,226
],[
2,2,2,2,2,3,3,2,2,2,177,221,0,85,9,10,29,79,107,53
],[
2,2,2,3,2,2,11,2,2,2,235,56,238,39,219,84,28,89,85,244
],[
2,2,2,3,2,3,2,2,2,3,81,194,69,233,100,237,214,62,137,78
],[
2,2,2,5,2,3,2,2,2,3,125,39,118,214,58,52,197,197,27,202
],[
3,3,3,3,2,3,2,2,2,3,154,192,1,212,133,35,166,182,170,152
],[
223,130,31,233,31,111,149,18,61,135,59,155,119,159,223,36,182,140,86,66
],[
20,148,31,137,155,35,67,234,79,191,127,64,111,62,165,37,249,55,64,10
]
]