aLevelData = [
[
2,2,2,2,2,2,2,2,2,6,5,2,2,2,2,247,235,242,232,213
],[
2,3,5,3,5,5,5,3,5,3,5,2,5,3,5,210,1,173,236,153
],[
2,3,2,3,2,2,2,3,5,3,5,2,5,3,5,202,59,204,160,251
],[
2,2,2,2,2,2,2,2,2,2,2,2,5,5,5,22,51,193,216,0
],[
2,3,5,3,5,5,5,3,2,3,5,5,5,3,2,47,224,131,39,131
],[
2,3,5,3,5,5,5,3,2,3,5,5,5,3,2,195,122,158,76,36
],[
2,5,5,5,5,5,5,5,5,5,5,5,5,2,2,97,10,228,5,2
],[
2,3,5,3,5,5,5,3,5,3,5,5,5,3,5,158,7,68,146,73
],[
2,3,5,3,5,5,5,3,5,3,5,5,5,3,5,52,111,53,45,86
],[
2,5,5,5,5,5,5,5,5,5,5,5,5,5,5,217,197,84,164,238
],[
2,3,5,3,2,2,2,3,2,3,2,2,2,3,2,207,158,198,195,223
],[
5,3,5,3,2,2,2,3,2,3,2,2,2,3,2,254,57,242,254,230
],[
5,5,5,5,5,5,5,5,5,5,5,5,5,5,5,244,164,120,0,76
],[
5,3,5,3,5,5,5,3,5,3,5,5,2,3,2,239,227,31,21,99
],[
5,3,5,3,5,5,5,3,5,3,5,5,2,3,2,92,117,10,223,20
],[
1,5,5,5,5,5,5,5,5,5,5,5,5,5,5,6,111,169,12,92
],[
5,3,2,3,2,2,2,3,2,3,2,2,2,3,2,244,190,28,125,221
],[
2,3,2,3,2,2,2,3,2,3,2,2,2,3,2,103,58,26,96,13
],[
249,9,78,78,80,246,246,81,157,85,71,86,233,154,52,145,110,173,93,56
],[
86,152,235,219,198,131,187,244,27,227,192,191,116,238,162,75,112,82,171,209
]
]