aLevelData = [
[
2,2,2,2,2,2,2,2,2,6,5,2,2,2,2,132,240,53,59,93
],[
73,188,49,25,124,48,231,248,21,3,221,16,38,8,99,250,48,205,164,203
],[
71,43,226,69,114,27,3,79,81,203,77,163,2,242,110,199,68,96,191,62
],[
221,217,201,255,58,35,9,38,86,94,240,234,221,148,46,207,144,145,48,28
],[
235,245,231,144,5,135,204,81,185,204,33,37,3,217,121,228,172,101,122,46
],[
42,34,226,89,194,78,200,173,239,132,37,212,7,217,146,140,28,36,83,159
],[
32,157,149,21,77,170,244,168,196,245,64,120,117,194,129,0,62,128,56,73
],[
87,157,232,93,237,159,213,255,13,113,12,153,196,250,163,118,133,244,66,49
],[
202,252,227,110,254,229,213,199,155,82,7,10,144,132,131,161,229,112,57,81
],[
161,21,254,40,236,12,212,176,113,97,108,105,6,161,233,118,143,52,231,151
],[
31,237,188,87,97,224,253,135,55,116,69,234,160,185,49,50,223,251,175,43
],[
218,151,121,55,192,13,220,250,238,87,190,86,20,121,223,154,147,90,95,246
],[
42,210,129,51,210,4,174,160,230,238,189,80,135,62,113,130,63,103,67,97
],[
228,245,98,238,192,29,249,58,238,153,176,216,7,179,117,146,255,159,124,91
],[
73,13,132,133,66,255,93,52,204,216,167,19,57,182,220,69,108,2,145,159
],[
58,70,248,20,22,62,170,112,238,49,163,74,80,129,142,51,209,130,68,52
],[
175,136,143,120,181,68,51,69,95,80,47,49,63,8,64,146,159,156,167,54
],[
104,99,44,84,67,114,99,195,253,110,46,106,48,158,131,248,32,68,111,213
],[
227,46,91,88,197,136,143,58,234,244,244,74,53,221,30,99,105,7,137,155
],[
142,107,35,190,151,67,11,251,65,97,153,220,62,196,158,124,147,109,237,244
]
]