aLevelData = [
[
6,2,2,2,2,2,2,2,2,2,2,2,2,2,102,155,222,95,52,27
],[
2,2,2,2,2,2,2,2,2,2,2,2,2,2,228,255,119,35,149,209
],[
2,2,2,2,2,2,2,2,2,2,2,2,2,2,148,88,148,57,107,233
],[
3,3,3,3,3,3,3,3,3,3,3,3,3,3,228,130,43,21,87,128
],[
2,2,2,2,2,2,2,2,2,2,2,2,2,2,106,238,73,115,117,93
],[
2,2,2,2,2,2,2,2,2,2,2,2,2,2,141,47,228,103,168,122
],[
2,2,2,2,2,3,2,2,3,2,2,3,2,2,114,174,61,182,12,59
],[
2,2,3,3,3,3,3,3,3,3,3,3,3,3,201,192,40,122,145,23
],[
2,2,2,2,2,2,2,2,2,2,2,2,2,2,88,134,216,65,31,167
],[
84,106,3,26,227,79,227,16,123,90,139,248,95,14,134,1,153,166,51,219
],[
164,249,28,190,105,161,130,174,109,92,61,253,72,178,195,17,89,217,134,104
],[
184,213,131,216,108,227,23,28,222,24,21,140,142,70,23,44,5,31,17,232
],[
11,157,44,30,25,161,209,93,17,218,3,109,45,232,243,143,53,193,206,5
],[
246,84,218,213,239,109,193,203,77,217,45,189,26,202,148,18,177,125,86,133
],[
117,25,5,39,194,219,3,163,36,112,83,198,199,162,169,63,47,55,195,163
],[
41,22,252,180,2,172,31,226,246,142,121,18,235,96,50,159,96,245,221,158
],[
160,183,77,103,59,74,170,81,182,108,197,188,130,32,169,85,43,11,115,149
],[
210,30,99,139,221,117,50,220,237,127,166,8,16,96,101,238,57,147,7,147
],[
237,212,110,31,62,61,90,40,253,175,56,51,44,115,59,120,178,33,174,230
],[
82,193,137,103,222,49,66,101,168,199,229,141,58,54,103,211,71,182,56,182
]
]