aLevelData = [
[
5,5,5,5,5,2,2,71,31,140,151,235,66,53,166,232,16,191,107,170
],[
5,2,2,2,2,2,2,209,160,155,231,250,204,101,221,92,30,74,219,154
],[
5,2,5,3,3,3,3,250,47,2,224,49,177,77,210,36,184,207,195,45
],[
2,2,5,2,3,2,2,79,60,40,58,179,171,76,187,169,154,69,191,21
],[
2,2,3,2,3,2,2,51,38,89,201,206,118,73,155,182,225,216,186,48
],[
2,2,3,2,3,3,3,46,4,66,185,113,221,13,144,130,47,205,116,173
],[
4,2,3,2,2,2,2,97,87,175,171,157,66,83,209,50,177,196,136,54
],[
2,2,3,2,2,3,3,109,118,253,111,55,248,26,116,92,50,180,15,137
],[
2,2,2,2,2,3,2,235,6,230,225,142,94,90,77,45,22,176,19,198
],[
2,3,2,2,2,3,2,198,110,171,197,184,8,206,203,156,188,207,174,125
],[
2,3,2,2,2,3,2,187,46,193,244,137,107,85,156,166,24,127,197,110
],[
2,3,2,3,3,2,2,50,28,109,62,177,19,108,216,94,218,238,9,229
],[
2,3,2,3,6,2,2,60,38,137,43,89,65,34,225,238,153,20,90,214
],[
44,185,153,209,76,101,175,133,152,144,68,194,42,55,115,10,18,127,219,81
],[
3,156,242,1,77,241,157,65,11,120,254,119,158,101,141,11,90,6,107,111
],[
126,238,243,92,106,82,145,94,12,179,215,146,156,189,205,174,137,112,137,67
],[
179,125,0,63,218,243,28,182,86,26,15,226,9,159,230,104,147,242,97,220
],[
196,237,2,136,87,182,100,105,221,230,206,123,247,235,8,55,200,171,109,89
],[
170,105,66,230,32,237,70,110,13,223,138,142,35,117,131,186,157,78,94,57
],[
49,157,147,113,64,137,189,101,81,212,169,124,189,187,173,132,171,30,59,246
]
]