aLevelData = [
[
2,2,3,3,3,3,93,20,199,87,32,6,132,169,204,96,154,64,192,153
],[
2,2,2,2,2,2,242,109,220,159,20,167,135,202,74,36,247,14,2,166
],[
3,2,3,3,3,3,173,118,117,152,62,205,134,89,89,158,237,216,6,96
],[
2,2,2,2,2,2,148,97,44,234,65,182,86,45,118,98,182,33,150,74
],[
3,2,3,3,3,3,107,0,72,133,255,179,32,109,52,137,125,246,0,47
],[
2,2,3,2,2,2,173,63,214,221,88,103,39,205,27,162,41,241,115,140
],[
3,2,3,2,2,3,215,229,221,189,57,35,59,157,229,118,122,121,198,177
],[
2,2,3,2,2,3,114,215,28,160,13,7,196,63,172,251,186,42,198,89
],[
2,3,3,2,2,3,220,85,210,205,240,253,104,164,233,222,163,151,102,167
],[
2,2,2,2,2,2,201,228,124,171,46,164,181,217,85,88,88,238,89,197
],[
3,3,3,3,2,2,235,233,139,2,247,191,93,207,11,81,127,40,3,155
],[
8,2,6,3,2,3,71,26,138,46,86,214,222,224,121,4,212,194,205,89
],[
2,2,2,3,2,3,27,82,39,108,196,242,178,197,2,153,218,55,47,201
],[
2,2,2,2,2,3,105,113,16,193,240,207,90,243,105,118,117,184,26,159
],[
2,2,2,2,2,3,127,67,189,51,148,211,221,153,77,45,131,203,134,74
],[
9,2,12,3,2,2,18,176,101,77,112,166,152,184,102,93,221,222,74,236
],[
2,2,2,3,2,3,200,156,219,30,193,68,108,13,76,218,69,243,141,131
],[
70,60,11,58,205,224,180,197,218,239,33,231,113,110,28,216,64,97,95,242
],[
130,41,159,173,35,16,201,205,37,35,140,218,66,64,23,209,211,111,36,25
],[
240,117,53,184,217,167,29,199,148,253,195,35,216,103,35,102,42,100,149,22
]
]