aLevelData = [
[
10,2,2,8,2,2,2,2,2,28,115,133,122,199,79,158,106,137,149,103
],[
2,2,2,2,2,2,2,2,2,132,33,92,169,58,202,64,159,173,178,8
],[
2,2,2,2,2,2,3,3,3,8,112,173,134,123,143,43,191,251,208,104
],[
9,2,2,2,2,2,2,2,2,76,203,56,226,0,131,209,16,203,100,171
],[
3,3,3,3,3,3,3,2,2,81,222,233,33,35,16,158,93,149,129,53
],[
31,255,125,215,185,240,163,184,95,104,70,238,157,71,19,131,41,6,244,201
],[
219,165,53,237,250,228,230,207,185,182,128,17,1,243,203,111,113,77,254,78
],[
164,133,40,151,178,223,208,197,249,211,216,61,29,5,168,222,77,119,136,218
],[
200,253,76,196,160,242,55,234,190,42,26,228,39,39,188,109,126,144,126,114
],[
201,222,63,105,120,89,126,228,163,67,190,102,147,83,47,117,132,101,138,240
],[
169,111,61,163,113,183,200,25,9,67,103,177,34,145,241,244,244,137,0,38
],[
130,176,82,27,32,158,111,77,51,178,140,43,57,4,176,179,9,155,21,66
],[
91,225,209,171,138,83,181,135,153,125,118,205,117,38,10,163,121,200,85,115
],[
55,67,5,64,118,209,187,59,119,61,107,145,125,80,5,136,139,141,85,202
],[
112,30,40,0,1,13,176,163,166,183,41,15,24,126,189,218,104,191,165,99
],[
68,4,146,174,118,122,75,111,173,165,151,100,128,82,93,232,176,205,10,198
],[
173,85,51,75,92,205,124,159,24,180,184,85,247,87,81,64,78,69,234,136
],[
119,4,68,254,209,2,94,173,9,206,225,177,152,136,186,77,141,151,9,55
],[
141,153,58,54,24,160,113,239,13,155,44,252,113,18,36,63,108,23,116,118
],[
148,121,252,15,111,58,8,61,50,67,45,75,207,87,116,49,47,70,187,101
]
]