aLevelData = [
[
2,2,2,5,2,2,88,134,70,92,140,81,243,106,94,39,208,247,142,86
],[
2,2,2,2,2,5,67,224,81,211,189,221,81,44,229,17,246,189,243,223
],[
2,2,3,3,3,3,228,39,89,0,197,254,169,210,72,194,179,243,105,17
],[
2,3,2,2,2,2,237,15,244,26,25,246,68,85,33,242,81,114,70,87
],[
2,3,2,2,2,2,234,143,121,91,62,173,9,40,161,101,127,48,141,215
],[
2,2,2,2,2,5,199,193,231,228,144,217,132,157,244,59,236,250,92,194
],[
2,2,3,3,3,3,94,208,158,246,20,253,105,221,199,229,227,20,118,35
],[
2,2,3,2,2,3,144,29,100,120,118,251,96,7,127,252,72,197,30,215
],[
208,43,53,246,128,46,55,21,252,112,138,12,136,184,47,233,203,160,164,66
],[
211,141,9,202,90,228,131,33,72,123,222,241,121,78,118,54,191,116,87,221
],[
43,81,163,145,136,12,52,210,41,67,131,71,229,254,200,85,95,226,99,240
],[
139,168,123,177,109,205,229,41,36,138,71,118,40,6,125,19,208,203,59,245
],[
23,118,244,211,159,179,251,197,246,105,233,16,25,50,62,64,54,14,75,120
],[
182,88,79,7,123,249,224,59,102,219,140,122,29,161,193,142,11,149,234,65
],[
168,225,219,42,250,3,111,198,92,123,111,203,126,198,182,184,173,144,147,177
],[
84,38,111,138,195,42,176,34,48,138,221,242,251,178,2,229,55,1,86,106
],[
101,122,27,200,130,189,198,179,69,53,96,28,162,146,44,77,146,122,138,52
],[
22,123,27,255,121,69,38,234,214,22,58,85,219,117,21,26,204,35,197,29
],[
203,79,13,37,86,9,10,234,17,249,22,111,198,81,237,145,170,0,15,224
],[
226,41,101,175,69,211,38,103,100,226,252,33,199,70,99,115,122,114,82,137
]
]