aLevelData = [
[
5,5,5,5,5,2,2,2,2,2,2,2,2,2,2,2,2,76,162,31
],[
5,2,2,2,2,2,2,2,2,2,2,2,2,2,2,2,2,32,227,179
],[
5,2,5,3,3,3,3,3,3,3,2,2,3,3,3,3,3,163,164,99
],[
2,2,5,2,3,2,2,2,2,2,2,2,3,2,2,2,2,85,159,85
],[
2,2,3,2,3,2,2,2,2,2,2,2,3,2,2,2,2,167,195,231
],[
2,2,3,2,3,3,3,3,3,3,2,2,3,5,5,5,5,255,94,192
],[
4,2,3,2,2,2,2,2,2,3,2,2,3,2,2,2,2,203,9,97
],[
146,1,157,68,79,223,9,42,87,205,101,222,34,251,118,32,60,79,211,61
],[
141,162,70,227,222,43,117,50,153,59,194,22,208,43,111,213,129,147,6,228
],[
25,189,248,255,54,90,132,120,177,115,218,208,220,162,129,132,8,129,246,41
],[
75,99,150,187,128,66,189,51,142,249,48,87,238,179,184,214,103,164,16,148
],[
28,247,1,67,201,7,204,51,74,209,200,107,93,170,76,248,168,45,207,133
],[
254,120,78,44,222,152,239,140,60,65,227,28,132,194,144,190,221,57,240,152
],[
171,3,52,31,87,119,174,116,82,212,237,244,87,119,42,11,241,82,227,72
],[
62,153,197,183,242,190,207,107,158,160,181,90,51,0,130,110,194,52,130,216
],[
133,31,95,168,35,96,138,154,48,202,220,51,243,20,126,13,109,210,6,112
],[
150,164,226,33,234,174,250,127,36,72,145,203,74,246,108,200,233,154,55,132
],[
162,232,36,117,229,27,213,199,253,230,124,245,77,174,65,151,217,246,228,123
],[
8,27,163,246,168,65,94,124,50,141,249,111,79,149,2,53,156,20,147,141
],[
170,227,122,35,74,36,152,98,7,192,135,137,243,21,128,1,167,232,123,238
]
]