aLevelData = [
[
6,2,246,44,254,216,72,46,77,41,222,16,249,120,60,89,54,183,217,179
],[
2,2,216,253,196,252,22,51,141,155,142,17,99,16,138,73,122,207,130,1
],[
2,2,176,79,226,135,111,94,12,64,213,183,161,226,18,214,253,227,18,11
],[
2,2,0,50,93,206,20,36,59,82,107,177,27,93,137,224,53,86,3,128
],[
2,2,111,160,134,25,125,38,26,34,77,55,168,116,162,149,186,255,255,200
],[
2,2,131,188,198,184,31,226,161,123,28,93,33,108,56,124,165,125,108,234
],[
2,2,126,206,42,223,80,126,228,151,187,193,205,4,59,50,227,192,77,107
],[
2,2,45,69,212,211,65,96,186,184,10,227,218,158,200,155,30,214,88,129
],[
2,2,228,82,182,52,167,183,192,167,219,180,61,23,24,147,29,65,123,13
],[
2,3,2,209,74,99,0,29,214,170,161,19,166,102,45,112,209,91,40,52
],[
2,3,172,160,27,82,165,245,152,171,111,86,120,61,96,209,103,152,23,148
],[
163,146,97,74,0,60,94,168,48,21,223,66,65,125,19,164,103,108,99,158
],[
252,99,154,223,197,163,73,197,119,158,106,116,121,171,67,38,236,253,141,194
],[
233,214,214,175,9,248,36,234,43,93,219,86,113,39,224,84,140,218,255,148
],[
58,201,138,43,12,206,67,229,109,62,124,220,224,28,125,73,137,141,38,155
],[
239,140,214,198,0,223,139,222,86,74,74,228,184,2,193,224,228,100,43,47
],[
139,231,116,31,158,80,157,185,200,37,99,222,60,99,27,150,176,115,225,164
],[
169,91,241,94,250,50,85,187,135,214,193,174,79,225,187,178,170,216,254,166
],[
206,166,33,220,152,73,116,109,138,204,43,207,16,117,190,169,7,63,143,229
],[
127,138,206,7,192,18,153,190,140,30,104,185,164,250,169,188,142,166,167,243
]
]