aLevelData = [
[
5,5,5,5,5,2,2,2,2,2,2,2,2,2,2,2,2,2,2,247
],[
5,2,2,2,2,2,2,2,2,2,2,2,2,2,2,2,2,2,2,57
],[
5,2,5,3,3,3,3,3,3,3,2,2,3,3,3,3,3,3,2,164
],[
2,2,5,2,3,2,2,2,2,2,2,2,3,2,2,2,2,3,2,128
],[
2,2,3,2,3,2,2,2,2,2,2,2,3,2,2,2,2,3,3,134
],[
2,2,3,2,3,3,3,3,3,3,2,2,3,5,5,5,5,5,5,212
],[
4,2,3,2,2,2,2,2,2,3,2,2,3,2,2,2,2,2,2,56
],[
2,2,3,2,2,3,3,3,3,3,2,2,3,3,3,2,2,3,3,207
],[
2,2,2,2,2,3,2,2,2,2,2,2,2,2,3,2,2,3,2,176
],[
2,3,2,2,2,3,2,2,2,3,2,2,3,3,3,2,2,3,3,75
],[
2,3,2,2,2,3,2,2,2,3,2,2,3,5,5,5,5,5,2,50
],[
2,3,2,3,3,2,2,3,2,3,2,2,3,2,2,2,2,2,2,4
],[
2,3,2,3,6,2,2,3,3,3,2,2,3,3,3,3,2,3,3,235
],[
2,3,2,3,8,2,2,3,2,2,2,2,2,2,3,2,2,3,2,76
],[
2,3,2,3,9,2,3,3,2,2,2,2,2,2,3,2,3,3,2,89
],[
2,3,2,3,10,2,3,3,3,2,2,2,2,2,3,2,2,3,2,85
],[
2,3,2,3,11,2,3,3,3,2,2,2,2,2,3,3,2,3,2,228
],[
2,3,3,3,12,2,2,2,3,3,2,2,3,3,3,2,2,3,2,227
],[
2,2,2,2,5,2,5,2,2,3,2,2,2,2,2,2,3,3,3,86
],[
91,30,146,115,198,219,163,162,78,63,189,193,237,179,182,28,75,136,168,52
]
]