aLevelData = [
[
2,2,2,2,2,2,2,149,163,53,122,43,71,92,18,123,80,145,191,212
],[
2,2,2,2,2,2,2,102,52,110,67,237,96,220,88,197,207,244,45,52
],[
2,2,2,2,2,2,2,247,88,165,32,121,62,242,130,188,125,90,23,213
],[
2,2,2,13,2,2,2,231,58,89,171,218,75,173,88,18,36,222,210,193
],[
2,2,2,2,2,2,2,0,202,202,226,194,91,212,202,54,185,201,0,154
],[
2,2,2,2,2,2,2,190,105,78,93,171,69,24,38,25,221,237,24,50
],[
2,2,2,2,2,2,2,5,92,85,32,141,9,192,198,32,0,8,174,109
],[
72,226,67,133,188,149,65,132,22,188,105,116,77,71,121,110,33,196,91,2
],[
243,221,157,218,219,33,33,153,245,7,22,9,251,47,38,118,25,236,241,85
],[
252,0,187,42,45,166,97,168,157,214,146,25,129,196,59,0,95,170,67,253
],[
105,199,121,242,11,167,203,100,192,166,184,36,41,176,8,46,96,74,186,209
],[
138,214,62,16,171,18,228,73,191,227,149,20,6,81,193,110,159,210,152,23
],[
88,203,125,56,197,84,183,73,143,60,106,50,15,76,198,176,27,208,127,251
],[
32,84,125,166,113,172,212,198,223,55,246,86,138,100,40,218,247,116,50,67
],[
98,130,91,19,85,193,148,193,121,6,244,95,173,134,100,122,85,224,156,66
],[
244,94,78,234,254,119,160,82,231,153,224,228,128,38,115,188,131,189,15,11
],[
108,186,43,189,139,0,179,89,88,246,255,41,6,207,6,156,91,15,207,232
],[
190,74,41,243,146,47,156,116,194,198,159,85,157,246,11,93,229,74,208,11
],[
34,245,231,197,60,19,136,50,73,49,156,228,164,16,117,58,63,166,189,132
],[
58,102,172,105,180,193,126,134,225,237,37,88,92,229,59,92,191,177,58,116
]
]