aLevelData = [
[
4,2,2,2,2,2,2,2,2,2,2,2,2,2,2,2,2,2,2,2
],[
5,2,5,3,2,2,2,2,2,2,2,2,2,2,2,2,2,2,2,2
],[
2,5,5,3,3,3,3,3,3,3,3,3,3,3,3,3,3,3,2,2
],[
3,3,5,5,5,5,5,5,5,5,3,2,2,2,2,2,2,2,2,2
],[
2,3,5,5,5,5,5,5,5,5,3,6,2,2,2,2,2,2,2,2
],[
3,3,5,5,5,5,3,3,3,3,3,3,3,3,3,2,3,3,3,3
],[
3,5,5,5,5,5,3,2,2,2,2,2,2,2,2,2,2,2,2,2
],[
3,5,5,3,3,3,3,8,2,2,2,5,5,5,5,5,5,5,5,5
],[
3,5,5,3,2,2,3,3,3,3,2,5,3,3,3,5,3,3,3,3
],[
3,5,5,3,2,2,2,2,2,3,2,5,3,5,5,5,5,5,5,5
],[
3,5,5,3,2,2,3,2,2,3,2,5,3,5,5,5,5,5,5,1
],[
5,5,5,3,2,2,3,2,2,3,2,5,3,5,5,5,5,5,5,5
],[
5,5,5,3,2,2,3,2,2,3,2,5,3,3,3,5,5,5,5,5
],[
42,129,228,52,199,183,97,166,249,201,113,226,62,80,26,105,99,242,61,41
],[
237,52,24,244,184,144,14,49,222,200,171,210,218,121,227,134,238,243,154,47
],[
194,72,106,150,77,163,160,93,248,219,135,54,1,72,234,83,30,214,212,30
],[
100,87,154,41,102,30,27,104,161,201,71,158,24,94,222,21,59,154,122,146
],[
13,133,208,136,134,74,51,140,54,70,90,9,44,95,98,53,22,151,22,67
],[
170,224,111,219,68,51,87,199,208,220,178,239,234,24,159,135,68,225,251,135
],[
72,9,40,91,255,134,12,220,50,13,92,128,207,226,26,205,141,238,92,20
]
]