aLevelData = [
[
6,2,8,2,9,2,10,2,11,3,2,2,5,2,2,2,5,2,152,3
],[
2,2,2,2,2,2,2,2,12,3,5,2,2,2,5,2,2,2,184,108
],[
2,2,3,3,3,3,3,3,3,3,2,2,3,3,3,3,3,3,200,118
],[
2,2,3,2,2,2,2,2,2,2,5,2,3,2,2,2,2,3,152,98
],[
2,2,3,2,2,2,2,2,2,2,2,2,3,2,2,2,2,3,100,116
],[
2,2,3,2,3,3,3,3,3,3,2,5,3,2,2,2,2,2,110,171
],[
2,2,3,2,2,2,2,5,5,3,2,2,3,2,2,2,2,2,98,36
],[
2,2,3,5,5,5,2,3,3,3,5,2,3,3,3,2,2,3,153,189
],[
2,2,2,2,2,2,2,2,2,2,2,2,5,2,2,2,2,5,187,179
],[
2,3,2,2,3,1,3,2,2,2,2,2,5,2,2,2,2,5,94,83
],[
2,3,2,2,3,2,3,2,2,2,2,5,5,2,2,2,2,5,133,237
],[
2,3,2,3,2,2,2,3,2,2,2,2,5,2,2,2,2,5,47,171
],[
2,3,2,3,2,2,2,3,3,3,2,2,3,3,3,2,2,3,92,10
],[
2,3,2,3,2,2,2,3,2,2,5,2,5,2,2,2,2,5,45,242
],[
2,3,2,3,2,2,3,3,2,2,2,2,5,2,2,2,2,5,7,202
],[
2,3,2,3,2,2,3,3,2,2,2,5,5,2,2,2,2,5,235,253
],[
2,3,2,3,2,2,3,3,2,2,2,2,5,2,2,2,2,5,89,196
],[
5,3,3,3,2,2,3,3,3,3,2,2,3,3,3,2,2,3,117,57
],[
2,2,2,5,2,2,2,5,2,2,2,5,2,2,2,2,2,5,84,250
],[
145,229,149,178,68,126,236,129,152,123,74,169,157,59,224,165,174,60,133,1
]
]