aLevelData = [
[
2,2,2,2,2,2,2,2,2,2,248,80,228,192,21,77,46,94,9,71
],[
2,2,2,2,2,2,2,2,2,2,0,236,146,83,39,213,255,210,147,22
],[
2,2,2,2,2,2,2,2,2,2,232,80,174,69,29,172,236,210,220,121
],[
2,2,2,13,2,2,2,2,2,2,163,142,71,165,30,105,20,88,237,128
],[
2,2,2,2,2,2,2,2,2,2,135,31,126,87,157,74,242,98,139,147
],[
2,2,2,2,2,2,2,2,2,2,41,203,102,0,31,111,36,10,124,42
],[
2,2,2,2,2,2,2,2,2,2,195,254,102,84,200,164,154,139,235,31
],[
2,2,2,2,2,2,2,2,2,1,187,179,17,20,233,60,122,14,150,163
],[
2,2,11,2,2,2,2,2,2,2,60,33,149,60,240,206,116,46,171,39
],[
2,2,2,2,2,2,2,2,2,2,12,191,48,51,86,210,99,148,129,173
],[
2,2,2,2,2,2,2,2,2,2,1,103,65,0,143,108,105,35,144,103
],[
2,2,2,2,2,2,2,2,2,2,188,160,251,198,0,241,236,131,85,139
],[
2,2,2,2,2,2,2,2,2,2,154,76,197,27,137,226,28,15,1,191
],[
2,2,2,2,2,2,2,2,2,2,250,88,190,251,38,110,233,112,37,149
],[
2,9,2,2,2,2,2,2,2,2,71,29,12,96,177,200,146,115,196,231
],[
2,2,2,2,2,2,2,2,2,2,105,140,217,193,207,197,55,209,96,19
],[
2,2,2,2,2,2,2,2,2,2,136,107,46,19,138,162,19,6,7,104
],[
2,2,2,6,2,2,2,2,2,2,70,25,7,247,45,235,68,112,114,73
],[
222,194,89,60,80,206,81,69,163,201,201,231,226,225,68,102,205,35,176,207
],[
209,156,243,56,56,190,200,73,158,6,201,251,164,220,204,160,232,187,115,36
]
]