aLevelData = [
[
2,2,2,2,2,2,2,2,2,2,2,2,2,2,124,246,23,119,187,181
],[
2,2,13,5,5,2,2,12,5,5,2,3,2,5,166,167,222,121,20,111
],[
2,2,2,5,5,2,2,2,5,5,2,3,2,5,139,160,84,202,101,144
],[
2,2,2,2,2,2,2,2,2,2,2,3,2,2,73,224,131,85,218,205
],[
2,2,2,2,2,2,2,2,2,2,2,3,3,3,34,139,69,164,150,127
],[
2,2,2,2,2,2,2,2,2,2,2,2,2,2,181,179,135,145,22,9
],[
2,2,2,2,2,2,2,2,2,2,2,2,2,3,89,221,40,54,236,26
],[
2,2,2,2,2,2,2,2,2,2,2,2,2,2,210,82,134,193,186,65
],[
2,2,2,2,2,2,2,2,2,2,3,2,2,2,13,114,18,52,122,149
],[
2,2,2,2,2,2,2,2,2,3,3,2,3,2,181,115,138,61,114,91
],[
2,2,2,2,2,2,2,2,3,3,2,9,3,3,182,81,167,162,102,237
],[
2,2,2,2,2,2,2,2,3,2,2,2,3,3,18,227,98,6,229,86
],[
4,2,2,2,2,2,2,3,2,2,2,2,3,2,137,77,24,222,197,86
],[
2,2,2,2,2,3,3,2,2,2,2,3,3,2,3,74,62,250,44,212
],[
2,2,2,3,2,2,11,2,2,2,3,3,2,2,206,250,94,238,182,228
],[
251,63,143,59,146,232,131,210,180,11,188,121,4,142,29,219,142,28,48,167
],[
90,109,96,238,64,200,105,205,253,198,12,75,135,88,7,132,158,11,68,8
],[
164,139,81,126,174,102,16,141,219,19,176,252,229,51,219,23,245,22,49,85
],[
188,129,246,57,191,175,7,118,242,149,19,86,137,107,7,92,11,103,202,41
],[
168,204,43,156,204,35,24,61,244,200,16,220,193,169,218,117,74,75,120,87
]
]