aLevelData = [
[
6,2,2,2,2,2,2,2,2,2,2,2,2,2,2,2,2,2,2,165
],[
2,2,2,2,2,2,2,2,2,2,2,2,2,2,2,2,2,2,2,38
],[
2,2,2,2,2,2,2,2,2,2,2,2,2,2,2,2,2,2,2,166
],[
3,3,3,3,3,3,3,3,3,3,3,3,3,3,3,3,3,3,2,11
],[
2,2,2,2,2,2,2,2,2,2,2,2,2,2,2,2,2,2,2,92
],[
2,2,2,2,2,2,2,2,2,2,2,2,2,2,2,2,2,2,2,91
],[
2,2,2,2,2,3,2,2,3,2,2,3,2,2,2,3,2,2,3,57
],[
255,185,215,76,117,143,243,98,49,159,56,114,161,176,34,152,191,226,37,11
],[
57,63,238,79,207,147,235,172,253,125,13,222,219,199,205,14,65,243,109,1
],[
46,22,128,144,107,234,172,88,107,30,175,178,118,240,160,230,7,254,119,155
],[
114,89,208,146,201,220,236,148,1,188,249,169,81,95,147,139,219,114,138,90
],[
142,54,230,145,75,26,40,57,70,143,211,93,176,24,43,189,147,160,61,198
],[
253,17,31,194,96,34,121,77,57,113,68,8,240,209,210,145,255,229,15,178
],[
87,238,6,216,255,225,167,199,255,189,199,141,124,27,104,180,36,6,59,188
],[
205,14,99,201,88,152,124,152,220,120,220,183,1,194,24,246,169,220,202,25
],[
214,216,146,207,200,1,91,232,101,180,224,194,222,114,110,4,144,50,235,143
],[
40,252,23,178,11,179,18,157,245,51,31,25,223,156,167,118,39,236,129,196
],[
235,212,112,70,181,196,237,35,94,73,39,95,44,152,73,10,62,107,251,183
],[
42,11,43,48,228,174,13,104,226,4,96,177,125,13,244,47,155,45,105,141
],[
139,130,57,238,48,117,249,39,98,143,219,43,145,143,120,198,171,185,204,143
]
]