aLevelData = [
[
2,2,2,2,2,2,2,2,2,2,2,2,2,2,2,2,2,225,217,27
],[
2,2,2,2,2,2,2,2,2,2,2,2,2,2,2,2,2,196,169,202
],[
172,36,142,77,204,11,76,255,53,149,155,134,129,70,3,26,158,170,242,69
],[
124,56,12,230,8,124,194,124,94,118,38,161,58,61,253,213,176,231,22,125
],[
30,173,219,43,94,75,38,32,64,166,86,16,55,177,161,37,82,145,172,70
],[
110,0,88,152,171,239,223,69,28,111,33,125,195,209,56,187,188,12,82,74
],[
184,96,192,7,173,57,74,104,204,86,198,189,180,42,233,182,229,131,92,38
],[
119,105,18,6,12,73,218,189,3,83,48,159,238,32,89,179,70,152,175,185
],[
94,19,57,107,150,190,126,4,209,65,155,255,41,158,148,33,225,92,232,185
],[
154,230,104,39,202,46,72,155,107,149,119,31,240,15,44,216,125,130,194,136
],[
87,112,197,88,154,214,77,213,42,84,138,56,235,141,161,234,53,209,182,71
],[
130,250,74,163,106,147,200,138,210,64,90,76,96,89,1,185,50,217,229,42
],[
207,119,234,193,93,18,131,241,21,82,203,64,245,141,210,75,180,231,52,11
],[
251,190,241,88,210,69,120,171,89,110,5,40,184,14,45,220,88,60,184,67
],[
84,249,174,13,42,23,180,33,183,83,153,227,98,197,45,178,151,122,82,181
],[
119,95,85,216,205,96,126,17,68,210,229,232,216,14,136,54,139,95,155,45
],[
89,31,31,152,109,28,182,100,149,65,182,96,244,114,124,65,247,183,3,233
],[
138,157,181,233,139,217,128,68,126,47,45,118,131,146,237,180,134,141,53,118
],[
182,225,204,51,56,112,35,107,28,89,228,235,144,101,205,77,83,162,191,190
],[
109,77,18,4,30,245,44,191,20,222,82,238,224,164,189,182,171,32,241,95
]
]