aLevelData = [
[
2,2,2,2,5,5,2,2,2,2,2,40,9,151,202,71,128,245,163,39
],[
2,2,2,4,2,2,2,2,2,2,2,230,247,73,115,134,197,19,182,20
],[
5,3,3,3,5,5,3,3,3,3,3,87,233,204,75,139,5,151,212,117
],[
2,3,2,2,2,2,2,2,2,3,2,247,243,106,246,236,235,60,144,47
],[
2,3,2,2,2,2,2,2,2,3,2,45,146,120,240,187,180,237,69,228
],[
2,3,2,2,3,2,2,2,2,3,2,8,201,110,115,122,86,93,38,32
],[
2,3,2,2,3,2,2,2,2,3,2,98,118,97,30,150,147,36,200,3
],[
2,3,2,2,3,5,5,3,3,3,3,75,59,7,254,116,180,254,46,230
],[
2,3,3,2,3,2,2,3,2,2,2,150,237,227,130,208,85,169,115,112
],[
2,2,3,2,3,2,2,3,2,1,2,93,30,180,21,116,0,210,167,56
],[
2,2,3,2,3,2,2,3,2,2,2,138,244,69,150,1,24,127,51,138
],[
2,2,3,2,3,2,2,3,2,2,2,159,198,11,62,12,32,89,128,9
],[
2,2,2,2,3,2,2,3,2,2,2,33,182,142,171,22,132,87,246,131
],[
2,2,2,2,3,2,2,3,2,2,2,141,141,164,208,232,250,34,63,29
],[
2,2,2,2,3,2,2,3,2,2,2,23,220,33,136,219,186,74,3,209
],[
6,2,2,2,3,2,2,3,5,5,5,234,194,191,109,225,189,115,160,156
],[
205,185,170,44,87,180,48,113,68,247,142,38,248,162,110,29,136,206,154,204
],[
39,44,14,9,226,232,82,18,142,212,6,208,254,194,190,93,121,49,17,195
],[
106,45,237,7,90,112,45,102,28,205,110,222,71,207,30,240,234,157,213,165
],[
122,32,233,207,15,104,61,145,208,76,89,33,172,81,192,205,76,206,125,60
]
]