aLevelData = [
[
2,2,2,2,2,11,2,2,2,2,2,2,2,2,9,2,2,2,99,50
],[
45,247,153,36,217,170,155,12,155,60,158,26,109,13,142,88,197,17,166,235
],[
196,47,61,150,176,230,227,127,164,54,172,54,134,190,204,243,58,34,100,31
],[
21,175,156,22,149,66,242,44,79,101,210,238,40,188,102,170,200,160,175,49
],[
76,9,213,219,59,177,187,204,188,118,215,118,6,0,65,95,23,165,9,36
],[
169,137,206,191,98,10,140,5,75,91,182,114,131,110,133,41,53,24,143,55
],[
199,112,155,24,84,120,180,124,93,255,124,75,187,197,195,230,216,225,88,176
],[
31,96,31,205,177,47,100,41,90,59,111,188,195,214,89,13,233,93,30,245
],[
205,23,242,166,110,97,217,235,244,8,114,178,46,247,19,199,62,18,27,226
],[
147,97,132,228,24,113,184,94,171,247,166,83,209,183,20,63,168,164,55,87
],[
29,73,129,19,94,103,186,234,147,224,82,92,201,211,246,54,46,9,97,18
],[
132,144,117,29,208,165,138,29,82,216,6,178,186,106,45,219,153,250,59,189
],[
22,96,176,160,226,218,236,59,110,102,251,49,91,110,178,219,50,170,251,72
],[
85,67,109,130,53,52,32,19,198,246,191,200,48,92,222,181,200,188,142,121
],[
62,79,47,196,23,218,134,22,94,142,16,201,151,45,149,81,245,111,255,195
],[
205,164,109,148,73,154,132,163,97,193,5,122,7,141,165,209,162,28,25,84
],[
190,25,112,167,2,224,165,166,98,227,117,241,150,76,110,168,202,228,73,115
],[
151,51,121,198,50,233,4,99,227,124,146,32,185,19,195,234,125,163,198,10
],[
228,87,40,167,8,54,233,140,25,0,213,44,80,88,17,227,37,40,245,127
],[
194,66,25,255,183,67,179,155,239,189,32,4,227,149,192,236,13,169,7,201
]
]