aLevelData = [
[
2,2,2,2,2,2,2,64,153,39,29,4,230,175,119,100,195,99,181,217
],[
2,2,2,2,2,2,2,15,185,71,171,73,67,69,28,244,132,248,226,64
],[
2,2,2,2,2,2,2,2,156,219,230,156,100,253,84,30,191,140,10,19
],[
2,2,2,3,3,3,3,218,143,68,219,102,132,217,253,155,83,99,190,125
],[
2,2,2,2,2,2,2,129,160,242,94,166,24,18,164,33,0,143,204,10
],[
2,2,2,2,2,2,2,95,102,175,104,111,245,4,164,70,12,39,62,181
],[
2,2,2,2,2,3,2,72,25,191,113,156,199,239,112,49,143,71,150,112
],[
2,2,2,3,3,3,3,0,169,145,93,225,79,2,38,117,2,221,251,254
],[
2,2,2,2,2,2,2,140,18,33,128,111,109,66,199,215,186,8,171,206
],[
2,2,2,2,2,2,2,46,234,147,175,2,69,56,221,97,174,172,180,132
],[
2,2,3,3,3,3,3,135,154,192,28,208,207,45,240,64,249,127,199,148
],[
2,2,2,2,2,2,2,175,132,136,40,178,134,160,196,115,196,164,184,213
],[
2,2,2,2,2,2,2,36,55,43,51,34,47,176,165,12,243,26,127,113
],[
2,2,3,3,3,3,3,39,146,27,215,140,230,217,172,33,36,99,127,143
],[
2,2,3,2,2,2,2,104,54,112,195,242,94,229,221,123,128,127,73,201
],[
30,77,43,130,23,63,1,62,109,221,132,223,75,56,206,37,71,33,194,125
],[
228,154,169,26,91,138,25,71,155,181,27,252,142,234,140,175,158,126,196,108
],[
120,250,118,40,15,17,215,83,228,213,3,172,134,42,156,89,84,122,180,55
],[
138,170,237,111,124,77,222,74,28,24,185,70,194,150,43,105,45,29,132,213
],[
197,1,24,157,34,7,229,215,210,29,118,242,87,72,7,74,112,221,233,250
]
]