aLevelData = [
[
10,2,2,8,2,2,2,2,2,2,2,2,2,2,2,2,2,251,60,250
],[
174,120,88,42,208,58,217,153,239,219,60,223,18,213,100,100,208,245,59,118
],[
17,13,156,152,25,234,113,29,194,133,24,246,8,125,12,201,203,197,193,67
],[
209,154,207,174,11,185,83,198,25,206,146,200,15,47,224,205,122,202,193,86
],[
158,93,77,40,2,229,217,90,47,88,211,172,180,150,238,26,109,157,127,177
],[
5,253,39,162,186,141,179,149,96,91,64,63,169,233,163,55,163,150,8,5
],[
130,90,216,124,160,182,225,75,194,235,177,206,157,107,66,42,153,141,221,152
],[
212,132,56,1,106,146,226,204,244,121,224,244,78,51,153,93,158,226,239,104
],[
145,10,175,197,232,254,43,136,52,152,37,127,221,45,239,195,105,192,209,142
],[
251,118,171,76,26,74,219,245,180,2,97,153,99,98,65,61,238,159,41,229
],[
19,23,84,242,132,62,174,174,47,220,57,38,194,118,175,56,111,9,105,236
],[
237,255,127,8,191,91,49,222,184,55,134,105,191,112,50,152,208,160,189,234
],[
67,76,226,59,81,95,54,222,212,215,10,235,78,191,145,218,45,93,70,81
],[
77,172,136,59,191,13,135,26,201,57,100,158,45,122,148,118,174,27,134,102
],[
209,28,133,154,225,43,223,58,53,208,71,62,182,232,120,132,155,84,27,31
],[
119,242,235,243,118,204,23,127,227,144,231,249,238,65,163,160,173,43,177,78
],[
96,28,253,76,249,209,158,107,220,175,182,80,227,180,153,16,165,172,50,253
],[
248,168,163,191,180,172,44,166,186,168,78,62,53,169,48,36,32,81,65,25
],[
9,133,31,85,20,101,184,29,66,129,175,152,243,73,1,223,170,198,232,83
],[
17,136,255,51,61,224,167,110,50,79,170,181,170,61,31,213,18,238,142,68
]
]