aLevelData = [
[
12,2,2,2,2,2,2,2,2,2,2,2,2,2,2,2,2,144,105,180
],[
2,2,2,2,2,2,2,2,2,2,2,2,13,2,2,2,2,192,127,140
],[
2,2,3,3,3,3,3,3,3,3,2,3,3,3,2,3,3,187,154,102
],[
11,2,3,2,2,2,2,2,2,3,2,3,2,3,2,3,2,183,214,176
],[
2,2,3,2,2,2,2,2,2,3,2,3,2,3,2,3,2,48,123,101
],[
2,2,3,2,2,2,2,2,2,3,2,3,2,3,2,3,2,179,86,189
],[
10,2,3,2,2,2,2,2,2,2,2,2,2,2,2,2,2,200,85,82
],[
2,2,3,2,2,2,2,2,3,3,3,3,3,2,2,2,2,91,113,12
],[
2,2,3,2,2,2,2,3,2,2,2,2,1,3,2,2,2,87,19,61
],[
9,2,3,2,2,2,2,3,2,2,2,2,2,2,3,2,2,19,63,160
],[
2,2,3,2,2,2,3,2,2,2,2,2,2,2,2,3,3,4,179,197
],[
2,2,3,2,2,3,2,2,2,2,2,2,2,2,2,2,3,37,111,192
],[
8,2,3,2,2,3,2,2,2,2,2,2,2,2,2,2,3,244,207,9
],[
2,2,3,2,3,3,2,2,2,2,2,2,2,2,2,2,3,102,223,182
],[
2,2,3,2,3,2,2,2,2,2,2,2,2,2,2,2,3,153,38,147
],[
6,2,3,2,3,2,2,2,2,2,2,2,2,2,3,3,2,5,176,27
],[
2,2,3,3,3,2,2,2,2,2,2,3,3,3,2,2,2,74,91,126
],[
2,2,2,2,2,2,2,3,3,3,3,2,2,2,2,2,2,130,225,113
],[
2,2,2,2,2,3,3,3,2,2,2,2,2,2,3,3,3,233,121,140
],[
2,2,2,2,2,2,2,2,2,2,2,2,2,2,2,2,2,252,225,7
]
]