aLevelData = [
[
2,2,2,5,197,81,18,84,239,37,226,64,83,201,203,74,42,158,121,248
],[
2,2,2,2,58,104,111,83,178,166,6,224,85,31,178,209,218,190,136,125
],[
2,2,3,3,147,159,253,14,78,106,241,121,121,224,236,180,137,179,167,35
],[
2,3,2,2,156,155,206,83,92,166,4,234,39,208,40,222,110,211,214,230
],[
2,3,2,2,91,64,49,46,183,207,224,79,10,243,87,126,4,178,88,3
],[
2,2,2,2,27,180,185,238,118,154,103,5,10,145,171,0,3,38,172,249
],[
101,92,54,30,243,251,185,169,80,44,149,18,100,67,148,130,1,220,184,140
],[
198,41,56,24,68,138,197,159,96,94,17,158,248,26,146,68,202,152,132,110
],[
145,177,45,214,112,13,100,135,148,58,84,149,22,252,126,10,30,228,253,35
],[
78,36,14,189,94,162,207,10,3,75,71,136,22,170,167,52,242,185,207,251
],[
30,247,20,113,44,186,65,197,224,199,219,245,149,32,170,62,221,29,116,215
],[
104,190,12,222,39,64,140,147,176,238,222,196,229,58,129,136,208,12,137,48
],[
210,90,232,123,253,249,237,9,190,179,10,18,191,153,218,88,11,154,98,90
],[
116,85,152,203,50,44,33,66,204,154,95,51,60,198,171,30,78,88,223,6
],[
73,139,24,37,209,131,186,222,12,226,180,243,4,150,5,248,76,244,127,8
],[
231,11,202,182,101,50,173,70,79,228,137,30,197,206,38,119,102,37,178,88
],[
112,61,7,197,40,88,45,52,125,188,32,64,232,8,211,161,150,199,116,92
],[
201,70,242,55,124,163,189,112,70,39,205,174,128,213,229,56,170,67,25,101
],[
11,169,142,84,152,56,129,220,23,173,138,198,132,37,34,58,180,51,100,120
],[
56,48,16,201,132,210,213,180,81,0,208,116,63,229,80,170,191,68,220,80
]
]