aLevelData = [
[
2,2,2,2,2,2,2,2,2,2,2,2,158,229,201,96,133,70,167,12
],[
2,2,2,2,2,2,2,2,2,2,2,2,246,218,118,59,209,81,56,188
],[
2,2,2,2,2,2,2,2,2,2,2,2,60,138,101,243,151,176,131,34
],[
2,2,2,13,2,2,2,2,2,2,2,2,179,170,247,231,62,178,27,6
],[
2,2,2,2,2,2,2,2,2,2,2,2,130,67,144,105,80,57,214,101
],[
2,2,2,2,2,2,2,2,2,2,2,2,54,52,25,63,248,61,78,239
],[
2,2,2,2,2,2,2,2,2,2,2,2,62,172,127,35,139,72,99,135
],[
110,177,50,68,252,251,183,198,125,156,167,195,102,136,49,121,136,154,214,55
],[
134,54,123,30,140,45,189,41,62,224,132,107,239,169,219,152,20,118,255,199
],[
248,183,181,118,177,123,225,207,82,213,85,42,98,133,231,210,141,212,198,12
],[
154,192,14,85,157,89,153,236,110,107,25,144,89,93,99,139,23,89,14,239
],[
253,174,61,32,116,114,185,146,169,107,67,212,134,48,40,206,224,139,21,71
],[
242,34,45,170,10,86,89,9,130,108,223,98,242,234,55,33,164,68,26,231
],[
72,184,219,138,233,119,250,93,32,5,247,177,136,226,100,155,113,106,62,248
],[
217,250,125,175,152,84,234,54,218,69,49,88,210,133,55,53,173,222,173,138
],[
197,144,230,50,24,245,229,237,248,97,187,97,4,76,16,94,86,179,255,102
],[
254,187,39,109,175,152,254,221,185,173,105,221,55,244,138,211,138,161,217,39
],[
6,2,119,75,234,170,191,248,150,206,29,186,248,239,35,174,72,185,217,138
],[
245,44,85,223,223,249,140,155,198,47,104,210,2,22,27,190,117,91,178,4
],[
191,110,237,56,176,41,78,164,3,178,112,69,73,162,154,23,35,103,148,147
]
]