aLevelData = [
[
5,5,5,5,5,2,2,2,2,2,2,2,2,2,2,2,2,2,198,145
],[
5,2,2,2,2,2,2,2,2,2,2,2,2,2,2,2,2,2,37,190
],[
5,2,5,3,3,3,3,3,3,3,2,2,3,3,3,3,3,3,106,178
],[
2,2,5,2,3,2,2,2,2,2,2,2,3,2,2,2,2,3,228,90
],[
2,2,3,2,3,2,2,2,2,2,2,2,3,2,2,2,2,3,70,75
],[
2,2,3,2,3,3,3,3,3,3,2,2,3,5,5,5,5,5,206,197
],[
4,2,3,2,2,2,2,2,2,3,2,2,3,2,2,2,2,2,207,150
],[
2,2,3,2,2,3,3,3,3,3,2,2,3,3,3,2,2,3,128,50
],[
2,2,2,2,2,3,2,2,2,2,2,2,2,2,3,2,2,3,55,133
],[
2,3,2,2,2,3,2,2,2,3,2,2,3,3,3,2,2,3,119,63
],[
2,3,2,2,2,3,2,2,2,3,2,2,3,5,5,5,5,5,124,180
],[
2,3,2,3,3,2,2,3,2,3,2,2,3,2,2,2,2,2,48,131
],[
2,3,2,3,6,2,2,3,3,3,2,2,3,3,3,3,2,3,165,157
],[
141,102,73,11,123,54,80,209,210,119,253,187,125,122,45,197,218,49,217,139
],[
99,65,226,1,143,89,14,100,243,194,77,112,173,56,66,212,2,249,254,227
],[
70,27,15,140,252,34,185,140,63,210,131,226,97,66,246,131,209,50,161,80
],[
66,158,96,69,9,148,222,243,199,66,89,48,73,83,165,13,172,124,116,8
],[
197,81,212,131,192,94,249,117,6,115,61,96,101,63,101,131,107,32,38,80
],[
18,58,232,32,163,199,201,38,212,173,229,161,51,86,213,86,200,188,117,62
],[
246,195,234,124,163,204,228,145,153,135,33,211,43,8,51,28,27,30,130,191
]
]