aLevelData = [
[
2,2,2,2,2,2,2,2,2,6,5,2,2,2,2,2,2,74,51,89
],[
2,3,5,3,5,5,5,3,5,3,5,2,5,3,5,3,5,243,244,179
],[
2,3,2,3,2,2,2,3,5,3,5,2,5,3,5,3,5,157,25,232
],[
2,2,2,2,2,2,2,2,2,2,2,2,5,5,5,5,5,227,43,87
],[
2,3,5,3,5,5,5,3,2,3,5,5,5,3,2,3,5,182,35,177
],[
2,3,5,3,5,5,5,3,2,3,5,5,5,3,2,3,5,52,26,77
],[
2,5,5,5,5,5,5,5,5,5,5,5,5,2,2,5,5,115,111,34
],[
2,3,5,3,5,5,5,3,5,3,5,5,5,3,5,3,5,69,147,55
],[
2,3,5,3,5,5,5,3,5,3,5,5,5,3,5,3,5,147,210,143
],[
2,5,5,5,5,5,5,5,5,5,5,5,5,5,5,5,5,158,138,172
],[
2,3,5,3,2,2,2,3,2,3,2,2,2,3,2,3,5,11,76,95
],[
5,3,5,3,2,2,2,3,2,3,2,2,2,3,2,3,5,214,209,112
],[
206,45,22,253,89,66,255,18,232,101,99,185,179,2,211,213,97,49,215,86
],[
113,136,123,175,218,51,10,138,238,71,26,186,132,84,200,113,86,58,69,179
],[
168,61,146,10,43,91,135,124,32,220,26,186,192,44,222,154,220,230,202,199
],[
193,49,60,183,94,79,61,222,169,115,7,34,62,211,197,142,73,255,153,74
],[
167,113,227,203,72,101,193,71,216,235,210,108,158,58,64,81,164,71,253,173
],[
24,150,76,71,242,80,132,173,215,151,16,41,61,22,187,241,209,220,43,158
],[
21,106,170,223,78,10,45,111,157,99,142,68,108,75,29,10,11,220,87,207
],[
155,202,245,0,44,243,41,148,34,56,36,135,221,140,219,138,153,74,11,249
]
]