aLevelData = [
[
2,2,2,2,2,2,2,2,2,6,5,2,121,60,126,203,154,57,170,26
],[
2,3,5,3,5,5,5,3,5,3,5,2,117,146,29,135,20,62,190,243
],[
2,3,2,3,2,2,2,3,5,3,5,2,43,48,137,244,64,227,214,19
],[
2,2,2,2,2,2,2,2,2,2,2,2,14,55,222,56,44,123,123,98
],[
2,3,5,3,5,5,5,3,2,3,5,5,234,203,47,155,124,156,104,44
],[
2,3,5,3,5,5,5,3,2,3,5,5,90,149,2,13,230,161,14,159
],[
2,5,5,5,5,5,5,5,5,5,5,5,79,66,210,157,182,40,16,80
],[
2,3,5,3,5,5,5,3,5,3,5,5,144,2,140,3,76,148,200,183
],[
2,3,5,3,5,5,5,3,5,3,5,5,53,9,18,24,153,139,192,175
],[
2,5,5,5,5,5,5,5,5,5,5,5,43,18,187,88,166,121,58,247
],[
2,3,5,3,2,2,2,3,2,3,2,2,179,215,208,103,13,12,169,179
],[
227,154,17,137,126,183,53,235,35,160,46,40,59,47,59,11,177,176,78,82
],[
156,241,203,97,30,152,140,56,139,185,40,163,206,168,117,176,9,12,75,102
],[
124,53,139,180,168,176,96,168,180,24,197,226,15,46,72,71,87,44,13,250
],[
122,87,21,136,27,212,192,98,55,188,145,145,8,115,50,165,41,53,184,238
],[
252,241,39,239,73,91,57,16,39,61,91,147,32,13,249,201,144,197,251,134
],[
78,239,144,210,142,255,42,225,6,230,202,70,80,228,125,99,144,158,38,36
],[
86,112,127,237,198,4,91,208,246,36,46,4,151,204,206,146,216,132,123,82
],[
135,236,30,22,121,153,206,37,45,31,152,235,172,111,128,238,179,100,195,4
],[
20,152,95,196,90,124,213,58,172,168,46,223,244,111,60,199,64,183,34,29
]
]