aLevelData = [
[
12,2,2,2,2,2,2,2,2,2,2,2,2,2,2,2,2,2,70,199
],[
2,2,2,2,2,2,2,2,2,2,2,2,13,2,2,2,2,2,166,16
],[
2,2,3,3,3,3,3,3,3,3,2,3,3,3,2,3,3,3,48,109
],[
11,2,3,2,2,2,2,2,2,3,2,3,2,3,2,3,2,3,203,159
],[
2,2,3,2,2,2,2,2,2,3,2,3,2,3,2,3,2,3,208,229
],[
155,198,208,193,177,202,50,141,182,189,146,5,202,80,171,133,38,232,29,192
],[
0,244,110,181,175,125,78,223,16,254,31,172,40,119,180,49,11,189,89,28
],[
252,20,20,234,213,255,43,90,170,87,230,33,169,155,150,223,68,135,214,82
],[
147,232,17,201,243,174,69,220,244,67,6,91,114,27,197,132,1,141,82,121
],[
143,225,160,241,68,170,201,45,173,86,81,46,26,3,175,37,68,148,9,43
],[
51,4,64,50,95,251,44,59,22,159,41,202,29,173,210,151,154,200,12,135
],[
49,17,71,218,110,247,0,166,99,81,138,132,146,170,15,137,13,219,210,120
],[
219,224,182,53,158,228,4,125,115,158,105,213,26,224,62,192,87,109,12,53
],[
151,12,80,80,215,218,123,72,194,228,61,161,25,245,3,163,88,173,191,10
],[
151,211,231,255,174,236,192,71,156,13,220,187,42,237,225,248,203,62,141,87
],[
199,62,247,32,152,137,24,250,148,49,137,166,205,16,142,237,54,93,84,215
],[
7,126,119,30,98,29,199,226,54,126,76,158,100,16,136,91,32,66,251,36
],[
154,151,237,185,222,253,103,136,249,91,131,216,94,105,229,72,136,196,138,120
],[
224,66,193,6,224,130,118,188,121,200,182,7,178,8,112,171,147,65,121,182
],[
65,13,211,178,106,117,47,31,227,9,176,33,144,49,242,117,133,190,75,169
]
]