aLevelData = [
[
5,5,5,5,5,2,2,2,2,2,2,2,2,2,2,2,60,116,233,162
],[
5,2,2,2,2,2,2,2,2,2,2,2,2,2,2,2,219,239,169,11
],[
5,2,5,3,3,3,3,3,3,3,2,2,3,3,3,3,233,50,225,163
],[
2,2,5,2,3,2,2,2,2,2,2,2,3,2,2,2,157,224,180,213
],[
2,2,3,2,3,2,2,2,2,2,2,2,3,2,2,2,72,91,11,179
],[
2,2,3,2,3,3,3,3,3,3,2,2,3,5,5,5,67,231,44,59
],[
4,2,3,2,2,2,2,2,2,3,2,2,3,2,2,2,38,13,143,217
],[
2,2,3,2,2,3,3,3,3,3,2,2,3,3,3,2,59,62,236,46
],[
2,2,2,2,2,3,2,2,2,2,2,2,2,2,3,2,51,185,153,16
],[
23,175,19,210,129,164,219,197,11,24,131,254,8,103,8,90,114,238,98,192
],[
36,111,90,166,73,182,156,215,21,125,13,115,179,142,94,55,126,39,226,254
],[
115,162,156,136,230,85,157,123,117,184,141,167,59,197,135,142,70,165,42,36
],[
74,136,236,211,150,213,178,194,72,131,158,87,189,198,40,251,76,239,113,29
],[
52,141,211,121,210,217,189,154,24,81,190,157,58,162,223,57,170,203,54,252
],[
71,128,184,215,210,204,79,221,161,251,45,72,151,183,95,189,83,113,165,209
],[
168,3,129,203,77,147,142,171,214,186,19,108,227,229,216,135,152,252,56,184
],[
77,66,120,4,134,125,87,251,37,86,230,59,222,2,154,53,236,34,160,52
],[
2,232,112,155,133,124,165,109,248,158,12,19,184,140,251,90,233,38,228,188
],[
176,80,41,224,162,152,50,100,125,25,190,217,22,158,118,15,147,11,200,147
],[
218,249,242,119,74,161,93,81,168,251,45,134,92,39,22,201,221,11,113,222
]
]