aLevelData = [
[
2,2,2,2,2,11,2,196,110,26,7,156,57,0,198,88,100,171,129,41
],[
2,2,2,2,2,2,2,38,4,216,70,173,21,244,62,26,6,179,141,206
],[
5,2,5,2,5,5,5,76,5,110,228,29,150,241,254,39,173,77,69,129
],[
5,2,5,2,5,2,5,84,119,171,226,185,244,116,17,212,235,244,156,74
],[
5,5,5,2,5,5,5,126,154,205,145,90,45,218,85,141,86,92,27,153
],[
5,2,5,2,5,2,5,95,2,37,198,58,135,149,188,197,225,213,80,76
],[
5,2,5,2,5,2,5,188,53,159,79,38,214,89,134,140,200,96,35,229
],[
111,146,87,45,43,226,23,21,55,174,32,249,210,77,57,18,157,231,184,237
],[
69,137,71,27,97,120,232,43,158,198,55,213,25,36,239,120,12,247,176,199
],[
173,174,0,190,83,82,143,220,219,94,191,140,74,210,99,228,179,131,199,145
],[
92,181,242,18,28,235,39,37,7,254,178,127,78,109,225,192,96,244,80,166
],[
85,96,105,129,141,161,44,231,148,33,44,168,73,84,218,4,64,145,6,28
],[
100,32,163,167,225,148,203,230,65,90,3,218,212,147,191,180,86,31,41,141
],[
204,250,30,87,175,204,121,20,76,187,149,70,107,132,13,166,47,202,198,24
],[
61,174,48,223,32,159,200,13,237,115,226,62,34,183,165,134,212,68,87,168
],[
10,19,219,137,100,83,119,228,0,184,219,62,157,21,95,29,1,45,141,117
],[
153,199,223,99,96,0,201,29,1,229,250,42,64,65,224,206,150,180,106,201
],[
27,5,17,65,170,185,25,252,63,229,20,210,163,64,169,98,76,124,147,5
],[
126,215,236,0,183,237,172,254,74,208,109,189,74,90,113,7,169,194,229,228
],[
161,110,103,14,83,8,199,165,175,212,10,36,147,65,181,148,55,190,72,255
]
]