aLevelData = [
[
5,5,5,5,5,30,187,161,169,148,60,186,203,44,190,150,84,121,91,118
],[
209,233,152,91,146,154,233,118,80,111,120,224,20,100,34,139,83,30,194,121
],[
94,199,179,43,250,24,144,93,74,183,62,240,246,196,45,40,134,174,218,23
],[
15,76,153,89,18,41,145,2,161,31,8,213,195,39,225,183,26,111,98,99
],[
195,173,59,94,126,180,196,46,15,68,135,199,228,39,254,70,247,121,158,225
],[
246,72,20,30,162,93,206,68,117,88,189,15,135,3,89,168,178,224,230,212
],[
244,4,246,108,22,40,48,13,139,254,79,16,155,193,110,189,193,16,130,187
],[
81,252,40,203,93,96,161,183,218,113,26,132,255,149,49,239,238,121,182,24
],[
150,93,174,120,216,179,158,24,232,233,6,5,247,131,43,255,15,108,25,113
],[
62,142,233,166,246,160,64,57,180,63,24,205,224,65,195,255,244,70,44,153
],[
225,143,97,8,175,20,78,17,99,208,203,191,37,96,218,160,162,204,41,49
],[
176,165,223,150,48,80,149,142,57,161,161,167,115,172,155,174,192,215,26,106
],[
34,52,191,138,217,14,117,219,203,194,246,190,41,208,146,218,80,50,44,14
],[
237,237,133,169,101,229,189,222,116,245,22,114,20,63,252,184,160,193,66,191
],[
57,42,175,202,105,235,185,0,6,144,144,101,89,81,94,9,128,228,205,128
],[
17,150,203,145,0,154,138,50,195,161,202,181,179,171,90,60,182,28,220,114
],[
27,18,202,125,197,246,182,46,140,81,214,123,224,225,191,48,175,237,113,225
],[
137,213,148,35,3,237,1,252,89,139,132,151,87,95,224,60,121,3,20,128
],[
81,211,221,185,41,255,124,181,234,223,185,172,60,134,40,114,239,153,171,241
],[
154,98,56,215,129,32,221,140,188,161,1,103,150,19,236,33,52,24,138,138
]
]