aLevelData = [
[
2,2,2,2,2,2,2,2,2,2,2,2,2,2,2,2,2,2,91,33
],[
2,2,2,2,2,2,2,2,2,2,2,2,2,2,2,2,2,2,251,87
],[
2,2,2,2,2,2,2,2,2,2,2,2,2,2,2,2,2,4,56,170
],[
2,2,2,13,2,2,2,2,2,2,2,2,2,2,2,2,2,2,70,12
],[
2,2,2,2,2,2,2,2,2,2,2,2,2,2,2,2,2,2,153,70
],[
2,2,2,2,2,2,2,2,2,2,2,2,2,2,2,2,2,2,113,202
],[
2,2,2,2,2,2,2,2,2,2,2,2,2,2,2,2,2,2,227,26
],[
2,2,2,2,2,2,2,2,2,1,2,2,2,2,2,2,2,2,34,110
],[
2,2,11,2,2,2,2,2,2,2,2,2,2,2,2,2,2,2,19,122
],[
2,2,2,2,2,2,2,2,2,2,2,2,2,2,2,2,2,2,109,140
],[
2,2,2,2,2,2,2,2,2,2,2,2,2,2,2,2,2,2,248,79
],[
2,2,2,2,2,2,2,2,2,2,2,2,2,2,2,2,2,2,166,250
],[
2,2,2,2,2,2,2,2,2,2,2,2,2,2,2,2,2,10,160,188
],[
2,2,2,2,2,2,2,2,2,2,2,2,2,2,2,2,2,2,116,147
],[
2,9,2,2,2,2,2,2,2,2,2,2,2,2,2,2,2,2,16,1
],[
2,2,2,2,2,2,2,2,2,2,2,2,2,2,2,12,2,2,39,53
],[
2,2,2,2,2,2,2,2,2,2,2,2,2,2,2,2,2,2,55,159
],[
2,2,2,6,2,2,2,2,2,2,2,2,2,2,2,2,2,2,76,12
],[
37,189,126,19,121,202,127,215,24,100,135,127,37,120,219,9,45,171,162,214
],[
161,249,244,105,138,156,53,108,120,48,161,243,187,20,39,5,214,19,123,89
]
]