aLevelData = [
[
2,2,2,5,2,2,2,5,2,2,2,114,191,127,184,76,199,225,96,46
],[
2,2,2,2,2,5,2,2,2,5,2,218,194,181,137,240,69,27,203,20
],[
2,2,3,3,3,3,3,3,3,3,3,93,140,143,196,154,37,16,155,67
],[
228,228,45,166,176,231,51,172,153,117,232,176,98,220,178,145,60,16,5,6
],[
213,161,132,50,145,235,106,121,23,141,41,145,16,28,81,220,43,24,178,245
],[
101,30,197,137,135,96,72,104,240,83,41,219,148,167,165,57,69,124,177,181
],[
50,211,153,122,173,66,231,250,49,237,134,130,163,177,39,18,216,162,228,109
],[
88,184,35,108,97,197,190,151,47,170,97,246,123,203,51,37,66,192,184,167
],[
199,78,246,124,219,149,214,246,92,138,206,200,252,168,189,96,67,227,22,119
],[
216,222,65,230,252,93,62,187,87,253,140,140,247,35,73,11,150,50,154,219
],[
27,1,77,162,100,140,189,96,67,233,246,255,198,126,26,43,188,114,4,99
],[
116,97,42,80,200,84,200,86,90,240,59,106,30,237,170,35,25,202,236,19
],[
104,191,166,87,131,244,180,109,195,240,203,70,34,84,92,156,67,201,187,134
],[
178,55,128,74,108,56,46,114,162,204,18,34,186,78,110,168,151,166,215,85
],[
26,193,220,139,232,62,232,24,110,106,106,194,35,111,50,35,13,200,30,184
],[
135,248,247,52,65,124,150,26,136,254,75,138,200,203,127,91,79,135,151,107
],[
83,32,28,51,55,0,25,159,10,135,197,28,81,184,98,242,6,50,101,212
],[
224,98,215,181,213,248,251,222,222,151,49,62,250,209,26,1,117,82,253,100
],[
106,91,106,199,135,115,29,3,16,89,36,255,38,60,69,126,74,46,154,59
],[
29,215,126,56,105,102,173,83,101,205,166,26,53,46,84,224,177,144,238,17
]
]