aLevelData = [
[
2,2,2,219,8,80,129,136,146,65,58,241,215,48,117,106,47,35,236,83
],[
2,2,2,200,162,218,143,71,200,186,56,178,153,81,144,141,150,238,59,67
],[
2,2,2,143,241,172,200,185,138,222,125,0,195,68,84,158,193,2,52,237
],[
2,2,2,70,93,159,121,123,112,146,90,237,33,172,193,213,84,147,208,156
],[
2,2,2,95,148,175,158,189,137,220,47,6,0,194,219,30,153,142,242,173
],[
2,2,2,176,62,69,208,60,250,42,15,247,168,198,142,192,187,139,135,61
],[
2,2,2,75,255,247,196,107,191,152,124,183,196,16,191,44,230,104,195,61
],[
2,2,2,158,191,122,34,16,64,182,116,73,81,145,247,197,13,12,183,52
],[
245,246,86,125,226,16,164,4,63,110,112,41,116,32,158,17,165,18,122,168
],[
157,49,76,230,5,207,45,82,218,73,24,197,30,231,68,113,205,3,177,33
],[
18,110,1,194,187,15,138,35,235,205,169,249,14,176,89,38,18,66,4,59
],[
213,60,153,59,217,94,222,162,63,159,8,165,243,134,137,188,36,216,41,94
],[
247,115,88,11,124,122,194,144,225,178,37,135,229,44,95,29,144,37,204,24
],[
33,42,206,24,73,128,173,28,150,194,162,73,50,204,46,231,205,216,176,173
],[
216,231,55,62,244,99,149,243,170,2,181,219,92,237,46,0,123,34,23,236
],[
251,22,30,108,4,159,212,148,235,18,75,3,96,168,227,105,233,39,97,70
],[
143,190,65,244,214,48,78,231,243,53,111,52,58,29,196,80,214,182,241,26
],[
188,112,186,28,226,191,209,14,171,193,235,156,166,33,25,106,121,59,86,84
],[
24,128,92,250,59,28,189,124,14,215,46,130,42,57,38,128,196,242,168,56
],[
36,121,92,128,89,242,229,69,44,85,111,208,82,205,135,72,230,94,48,120
]
]