aLevelData = [
[
2,2,2,2,2,2,2,2,2,6,5,2,245,240,140,68,231,72,55,106
],[
61,42,34,44,171,9,75,164,174,0,173,235,204,8,172,234,29,109,179,109
],[
10,131,28,121,85,149,80,224,90,30,47,18,148,59,178,54,98,97,206,122
],[
11,75,156,167,0,55,184,248,98,82,231,44,196,113,252,218,50,1,252,5
],[
114,65,128,240,137,175,91,51,130,191,125,15,106,211,23,255,159,104,0,143
],[
75,141,88,113,43,154,107,206,149,30,215,218,185,25,242,171,39,108,102,75
],[
145,141,30,12,210,127,102,27,48,2,77,88,222,7,78,101,197,102,48,253
],[
133,211,43,136,182,15,76,236,115,91,27,165,25,50,122,24,76,55,208,36
],[
59,109,103,251,37,166,19,48,29,62,21,17,10,8,62,54,241,137,88,90
],[
119,100,193,106,161,22,89,220,223,227,158,66,73,16,22,31,40,83,238,249
],[
184,136,224,175,44,165,90,13,243,240,220,158,58,112,161,193,178,161,131,255
],[
147,108,25,156,225,85,34,108,238,247,38,232,32,173,90,129,244,147,197,53
],[
67,173,161,95,196,101,4,211,211,59,191,42,112,184,134,91,139,163,82,140
],[
127,120,4,39,220,22,75,47,105,184,199,213,105,38,111,70,30,45,48,200
],[
140,76,214,5,127,176,48,166,207,99,111,36,227,192,208,219,116,42,123,97
],[
147,253,170,21,238,197,13,251,79,174,110,199,101,60,145,55,199,60,94,166
],[
54,251,65,223,34,181,210,47,112,80,177,190,123,74,180,30,89,241,69,37
],[
95,210,5,248,231,115,182,105,80,69,87,131,71,212,144,98,69,65,81,73
],[
89,242,183,238,40,136,47,24,50,17,221,108,87,127,63,132,153,90,13,66
],[
35,177,100,100,139,86,36,88,84,75,151,81,183,119,83,154,162,157,97,43
]
]