aLevelData = [
[
2,2,2,2,5,193,237,188,74,224,206,161,65,66,15,236,124,136,157,99
],[
2,2,2,4,2,240,223,193,190,201,212,162,23,11,106,12,156,121,105,111
],[
5,3,3,3,5,135,182,250,43,80,170,113,10,32,39,106,14,138,204,23
],[
2,3,2,2,2,110,118,42,216,219,93,38,12,7,188,158,40,104,194,80
],[
2,3,2,2,2,6,58,76,247,127,195,20,182,59,218,37,186,200,170,147
],[
2,3,2,2,3,28,234,180,104,4,50,19,225,20,210,4,219,4,176,165
],[
2,3,2,2,3,136,137,185,253,102,124,120,61,114,56,231,69,153,68,133
],[
2,3,2,2,3,106,111,50,168,119,35,198,21,241,179,91,206,160,92,131
],[
2,3,3,2,3,43,74,85,238,44,194,188,141,14,34,209,246,28,84,98
],[
2,2,3,2,3,11,200,215,134,214,250,191,142,184,168,254,57,195,167,227
],[
2,2,3,2,3,39,100,193,224,144,69,7,144,54,113,104,248,152,186,131
],[
2,2,3,2,3,14,105,88,186,119,64,210,136,149,145,34,20,193,220,20
],[
2,2,2,2,3,6,213,36,239,153,238,163,87,241,112,188,114,176,74,49
],[
2,2,2,2,3,74,196,123,150,114,130,213,6,237,249,0,20,75,128,195
],[
4,21,146,127,60,107,220,252,245,236,147,104,54,214,11,157,3,110,134,163
],[
210,163,74,118,62,238,246,9,255,124,21,138,26,143,244,232,85,34,177,147
],[
238,204,149,131,140,230,163,123,118,240,113,143,3,49,55,228,82,158,38,183
],[
58,253,251,160,132,74,211,24,88,90,65,58,246,190,158,198,167,234,160,107
],[
242,151,46,70,18,101,115,166,168,197,50,18,174,22,89,141,172,14,216,24
],[
46,92,179,121,117,139,86,59,109,42,42,246,223,42,101,208,232,135,38,68
]
]