aLevelData = [
[
12,2,2,2,2,2,2,2,2,2,2,2,2,120,99,232,249,152,58,6
],[
2,2,2,2,2,2,2,2,2,2,2,2,13,251,192,120,106,180,38,205
],[
2,2,3,3,3,3,3,3,3,3,2,3,3,23,232,18,175,184,108,147
],[
11,2,3,2,2,2,2,2,2,3,2,3,2,69,237,46,114,132,227,117
],[
2,2,3,2,2,2,2,2,2,3,2,3,2,100,152,39,105,131,133,188
],[
2,2,3,2,2,2,2,2,2,3,2,3,2,213,255,14,107,44,17,214
],[
10,2,3,2,2,2,2,2,2,2,2,2,2,90,202,49,197,224,125,137
],[
2,2,3,2,2,2,2,2,3,3,3,3,3,173,152,68,169,45,180,86
],[
124,214,148,102,123,141,152,38,32,48,50,10,158,125,63,78,207,47,151,58
],[
110,105,226,165,134,88,174,184,42,21,191,244,103,200,166,118,119,19,150,122
],[
55,174,114,31,220,78,42,106,225,204,72,140,67,131,198,104,241,250,35,80
],[
126,195,182,15,26,162,65,45,192,242,201,110,177,69,165,156,32,75,214,134
],[
47,245,150,73,26,217,51,206,178,217,30,148,14,255,63,176,125,172,140,18
],[
190,242,218,9,116,62,243,10,212,58,232,173,161,241,169,248,90,53,210,224
],[
178,61,200,13,64,147,5,222,120,46,176,173,218,218,113,84,105,225,131,239
],[
95,228,11,228,31,10,168,33,107,93,75,165,215,112,73,66,125,69,174,161
],[
243,111,213,134,122,116,53,85,120,117,126,214,41,17,229,53,145,134,187,77
],[
181,25,69,37,10,185,200,187,46,223,227,1,214,184,33,38,8,134,207,22
],[
138,68,11,68,154,136,30,167,223,174,12,2,160,51,105,105,52,95,109,1
],[
185,39,75,7,9,81,191,20,234,217,230,159,133,148,83,195,26,19,95,66
]
]