aLevelData = [
[
10,2,2,8,2,2,2,2,2,2,2,2,2,2,178,133,221,206,186,170
],[
2,2,2,2,2,2,2,2,2,2,2,2,2,2,237,95,14,226,245,126
],[
2,2,2,2,2,2,3,3,3,3,2,2,2,2,74,158,169,226,220,234
],[
9,2,2,2,2,2,2,2,2,3,2,2,2,2,252,129,115,8,55,84
],[
3,3,3,3,3,3,3,2,2,3,2,2,2,2,181,88,72,90,49,124
],[
2,2,2,2,2,2,2,2,2,3,2,2,2,2,93,223,148,184,178,254
],[
2,2,2,2,2,2,2,2,2,3,3,2,2,2,31,159,167,101,88,236
],[
2,2,2,2,2,2,2,2,2,2,3,2,2,2,22,88,0,174,227,249
],[
2,2,2,2,2,2,2,2,2,2,3,2,2,2,70,168,213,198,58,247
],[
2,2,2,2,3,3,3,3,2,2,3,2,2,2,164,99,132,245,83,154
],[
2,2,2,2,3,2,2,3,2,2,3,2,2,2,86,94,191,160,159,177
],[
2,2,2,2,3,2,2,3,2,2,3,3,3,5,121,153,130,217,209,95
],[
2,2,2,2,3,2,2,3,2,2,2,2,3,2,6,13,51,127,15,245
],[
2,2,2,2,3,2,2,3,2,2,2,2,3,2,183,133,141,14,243,122
],[
2,2,2,2,3,2,2,3,2,2,2,2,3,2,243,79,20,170,235,13
],[
2,2,2,2,3,2,2,3,2,2,2,2,3,2,45,171,71,28,206,154
],[
2,2,2,2,3,2,2,3,2,2,2,2,3,2,59,55,217,168,202,161
],[
2,2,2,2,3,2,2,3,2,2,2,2,3,2,145,213,127,13,244,252
],[
93,188,75,16,24,229,255,165,134,89,174,178,80,103,126,149,237,253,177,87
],[
209,17,122,50,225,63,15,80,43,180,0,214,212,74,199,33,81,244,160,79
]
]