aLevelData = [
[
2,2,3,3,3,3,3,3,3,3,39,2,56,243,163,32,108,234,61,15
],[
2,2,2,2,2,2,2,2,2,2,167,101,142,23,225,4,4,254,150,234
],[
3,2,3,3,3,3,3,3,3,3,132,32,129,113,84,194,168,28,57,163
],[
2,2,2,2,2,2,2,2,2,2,152,206,220,212,242,57,114,202,38,152
],[
3,2,3,3,3,3,3,3,3,3,156,178,127,161,140,4,96,181,106,91
],[
205,91,246,132,44,236,110,212,77,144,178,191,169,104,166,167,231,13,216,242
],[
165,58,99,95,116,197,19,154,36,212,201,14,67,77,33,250,224,142,83,199
],[
148,95,87,153,196,36,77,36,32,88,27,193,111,54,88,192,143,185,105,0
],[
183,199,233,190,0,169,79,171,36,191,202,65,133,114,112,86,113,105,152,242
],[
164,0,132,94,14,246,68,125,215,101,214,95,161,248,146,20,13,88,198,190
],[
128,231,157,234,39,177,69,33,56,160,80,185,123,239,91,241,10,224,238,62
],[
85,178,164,223,104,205,140,183,113,65,206,92,124,110,146,108,130,4,29,32
],[
162,47,61,35,174,11,232,164,233,94,32,170,15,134,25,167,150,176,158,81
],[
52,75,177,173,161,189,114,108,158,84,66,123,54,127,39,214,68,62,114,157
],[
53,215,160,105,15,203,127,224,178,8,146,135,95,96,181,216,118,58,4,149
],[
132,135,250,91,124,248,214,122,69,110,67,4,117,179,55,36,93,103,28,177
],[
69,61,46,3,248,103,36,6,132,78,18,140,59,135,142,232,253,2,18,184
],[
186,133,161,2,50,89,173,131,255,68,57,67,214,183,59,109,10,71,68,94
],[
81,97,98,252,203,58,70,73,64,6,162,56,170,106,213,191,243,51,202,45
],[
255,72,29,190,237,221,128,108,154,234,94,9,103,220,190,139,61,138,105,167
]
]