aLevelData = [
[
6,2,8,2,9,2,10,2,11,52,88,20,214,95,68,68,171,242,157,72
],[
2,2,2,2,2,2,2,2,12,172,3,107,28,185,133,38,101,173,121,28
],[
2,2,3,3,3,3,3,3,3,77,224,99,18,141,241,251,46,203,194,38
],[
2,2,3,2,2,2,2,2,2,21,39,195,36,80,17,116,11,244,93,37
],[
2,2,3,2,2,2,2,2,2,116,130,153,0,116,12,158,74,206,153,101
],[
2,2,3,2,3,3,3,3,3,230,102,203,28,27,249,191,121,151,12,53
],[
2,2,3,2,2,2,2,5,5,79,179,34,241,95,248,50,97,112,226,88
],[
2,2,3,5,5,5,2,3,3,127,162,229,203,249,255,174,15,143,83,171
],[
2,2,2,2,2,2,2,2,2,108,189,61,205,158,155,135,141,206,1,179
],[
2,3,2,2,3,1,3,2,2,45,193,238,214,64,80,43,170,108,24,43
],[
2,3,2,2,3,2,3,2,2,222,111,114,54,176,96,166,199,190,55,91
],[
2,3,2,3,2,2,2,3,2,50,25,144,82,137,156,172,84,193,124,185
],[
2,3,2,3,2,2,2,3,3,105,17,31,83,75,155,50,74,26,78,246
],[
2,3,2,3,2,2,2,3,2,166,81,11,218,232,249,6,79,147,29,112
],[
2,3,2,3,2,2,3,3,2,216,235,125,83,96,253,134,189,209,223,130
],[
32,226,57,13,249,49,4,200,176,145,146,81,191,165,207,114,23,174,198,152
],[
191,161,103,135,191,125,135,77,60,219,40,116,228,198,251,124,141,206,35,137
],[
24,88,60,88,156,56,156,119,193,130,216,182,105,156,138,217,150,152,82,143
],[
136,193,27,168,37,116,160,130,158,50,46,196,80,242,171,79,232,188,215,114
],[
203,115,210,93,181,243,223,217,159,92,103,54,231,172,65,132,171,148,48,6
]
]