aLevelData = [
[
4,2,2,2,2,2,2,2,2,2,2,2,2,2,75,253,246,16,35,118
],[
5,2,5,3,2,2,2,2,2,2,2,2,2,2,196,57,47,251,128,101
],[
2,5,5,3,3,3,3,3,3,3,3,3,3,3,205,253,39,173,129,130
],[
3,3,5,5,5,5,5,5,5,5,3,2,2,2,243,114,244,29,127,243
],[
2,3,5,5,5,5,5,5,5,5,3,6,2,2,61,30,45,30,96,6
],[
3,3,5,5,5,5,3,3,3,3,3,3,3,3,197,167,20,62,94,88
],[
3,5,5,5,5,5,3,2,2,2,2,2,2,2,202,8,130,168,234,181
],[
3,5,5,3,3,3,3,8,2,2,2,5,5,5,141,142,96,25,86,151
],[
3,5,5,3,2,2,3,3,3,3,2,5,3,3,87,60,17,55,68,82
],[
3,5,5,3,2,2,2,2,2,3,2,5,3,5,116,92,39,237,25,73
],[
14,114,36,162,218,201,37,195,69,89,64,86,36,52,139,37,234,142,183,44
],[
110,116,243,243,238,187,13,27,83,54,218,54,182,44,217,220,36,8,19,251
],[
158,83,69,110,100,224,65,209,116,70,146,148,77,147,95,79,248,63,146,85
],[
73,95,56,140,99,27,43,124,122,98,239,165,221,221,219,22,51,33,121,59
],[
4,40,47,247,124,2,30,242,108,200,74,53,146,210,251,244,26,41,100,170
],[
100,63,131,108,8,222,72,118,24,95,249,11,165,28,213,124,132,40,248,134
],[
81,61,126,224,181,245,235,21,229,61,203,144,107,7,149,245,41,64,213,184
],[
155,2,138,232,92,10,205,75,236,108,180,176,176,133,118,129,58,50,208,152
],[
203,63,167,83,22,35,238,235,71,234,202,1,68,114,244,122,51,218,96,141
],[
60,56,28,26,144,138,122,62,170,240,113,36,213,24,65,30,238,249,86,244
]
]