aLevelData = [
[
2,2,2,152,122,114,95,17,193,206,255,79,228,10,148,242,21,105,230,240
],[
2,2,2,129,45,191,56,110,90,161,150,134,188,184,215,114,43,14,45,171
],[
2,2,2,14,254,213,141,30,235,246,174,109,50,205,109,166,92,7,206,150
],[
2,2,2,153,110,133,235,106,200,80,60,157,252,138,74,126,119,254,134,76
],[
2,2,2,206,249,211,234,165,163,140,215,207,142,201,96,183,144,222,20,254
],[
2,2,2,206,37,121,101,26,254,253,238,127,19,47,62,25,225,47,70,42
],[
2,2,2,116,99,34,107,113,108,65,160,90,89,199,111,14,26,47,114,143
],[
55,53,139,8,194,243,120,15,138,74,167,39,145,131,75,137,192,54,175,36
],[
218,107,202,226,175,0,21,45,146,75,153,178,12,255,76,100,210,84,157,196
],[
245,98,78,96,89,206,130,154,104,169,23,171,7,149,53,232,201,42,39,67
],[
99,152,106,20,97,141,4,26,23,89,23,188,217,80,182,149,111,111,247,48
],[
195,67,74,16,221,7,9,244,17,13,80,89,119,95,14,63,156,165,92,48
],[
119,73,14,127,159,218,136,206,187,174,212,210,57,204,241,91,67,8,109,142
],[
238,112,54,117,181,231,173,187,39,16,252,176,220,110,169,147,173,201,108,17
],[
36,211,62,9,50,11,179,146,32,226,137,63,200,28,129,162,5,122,109,14
],[
104,150,139,161,45,14,17,130,109,228,9,104,149,37,95,92,22,201,57,191
],[
94,219,134,142,8,218,218,229,79,94,121,194,201,254,178,12,82,114,110,212
],[
69,245,8,218,243,237,95,83,77,206,42,233,228,60,140,4,20,112,233,72
],[
123,220,247,95,176,18,24,248,50,226,231,15,159,194,16,111,39,116,102,118
],[
63,226,47,25,154,77,194,39,85,166,85,210,114,60,16,107,135,152,102,109
]
]