aLevelData = [
[
2,2,2,2,2,2,2,2,2,6,5,2,2,2,2,2,2,2,2,122
],[
2,3,5,3,5,5,5,3,5,3,5,2,5,3,5,3,5,5,2,205
],[
2,3,2,3,2,2,2,3,5,3,5,2,5,3,5,3,5,5,3,211
],[
2,2,2,2,2,2,2,2,2,2,2,2,5,5,5,5,5,5,3,114
],[
2,3,5,3,5,5,5,3,2,3,5,5,5,3,2,3,5,5,3,108
],[
2,3,5,3,5,5,5,3,2,3,5,5,5,3,2,3,5,5,3,45
],[
2,5,5,5,5,5,5,5,5,5,5,5,5,2,2,5,5,5,3,81
],[
2,3,5,3,5,5,5,3,5,3,5,5,5,3,5,3,5,5,3,91
],[
2,3,5,3,5,5,5,3,5,3,5,5,5,3,5,3,5,5,3,204
],[
2,5,5,5,5,5,5,5,5,5,5,5,5,5,5,5,5,5,3,0
],[
66,145,85,34,220,252,158,229,252,158,247,100,36,126,147,20,191,229,237,156
],[
173,205,100,231,251,151,40,119,242,252,90,252,84,70,111,37,226,192,214,182
],[
33,107,218,219,94,242,201,187,240,224,86,81,189,17,60,119,0,102,36,68
],[
73,189,201,152,197,33,90,245,191,61,32,145,103,23,96,169,210,251,131,23
],[
67,180,116,39,169,3,74,167,104,73,39,61,92,135,95,254,27,136,221,59
],[
123,93,195,158,85,10,81,118,136,127,8,80,64,202,15,199,120,138,213,157
],[
189,167,248,10,53,64,102,83,225,229,194,159,31,7,9,7,115,172,117,236
],[
134,103,161,141,111,136,239,216,50,144,39,129,134,232,96,82,220,210,36,194
],[
156,159,207,200,178,35,56,241,73,102,147,177,214,156,150,246,89,87,219,3
],[
224,252,134,124,76,115,39,189,87,35,226,112,214,30,205,95,60,152,153,134
]
]