aLevelData = [
[
2,2,2,2,5,5,2,2,2,2,93,108,101,122,238,107,153,141,233,25
],[
2,2,2,4,2,2,2,2,2,2,236,187,43,55,46,101,27,217,46,238
],[
5,3,3,3,5,5,3,3,3,3,37,16,208,122,106,197,96,245,181,232
],[
2,3,2,2,2,2,2,2,2,3,38,88,177,203,59,39,90,200,155,62
],[
2,3,2,2,2,2,2,2,2,3,178,42,122,206,181,75,220,163,142,249
],[
2,3,2,2,3,2,2,2,2,3,96,168,11,30,92,172,79,160,47,102
],[
2,3,2,2,3,2,2,2,2,3,199,135,211,183,95,94,178,48,245,219
],[
2,3,2,2,3,5,5,3,3,3,187,212,13,194,180,31,199,6,210,71
],[
2,3,3,2,3,2,2,3,2,2,15,49,135,193,20,7,155,7,251,102
],[
2,2,3,2,3,2,2,3,2,1,126,153,212,113,221,65,205,238,115,156
],[
2,2,3,2,3,2,2,3,2,2,165,235,34,214,100,168,66,181,74,177
],[
2,2,3,2,3,2,2,3,2,2,57,217,5,75,75,66,39,17,180,18
],[
2,2,2,2,3,2,2,3,2,2,214,223,244,148,197,239,107,126,100,66
],[
2,2,2,2,3,2,2,3,2,2,37,115,84,66,247,204,30,165,203,152
],[
2,2,2,2,3,2,2,3,2,2,36,148,56,225,216,13,86,50,43,134
],[
6,2,2,2,3,2,2,3,5,5,208,85,73,211,58,97,131,73,165,245
],[
8,2,2,2,3,2,2,3,5,5,140,36,113,190,233,38,99,63,163,129
],[
9,2,2,2,3,2,2,3,5,5,247,209,63,247,248,232,239,64,77,153
],[
10,2,2,2,3,5,5,5,2,2,10,172,22,89,186,9,248,8,245,199
],[
11,2,2,2,2,2,2,2,2,2,180,46,174,90,255,132,76,224,142,182
]
]