aLevelData = [
[
2,2,2,2,2,2,137,65,90,188,65,163,215,158,211,137,150,82,36,147
],[
2,2,13,5,5,2,198,30,239,223,27,178,185,44,104,102,8,64,112,196
],[
2,2,2,5,5,2,208,136,250,70,46,255,35,96,88,80,248,193,213,63
],[
2,2,2,2,2,2,68,215,233,69,167,145,84,122,232,104,60,185,140,160
],[
2,2,2,2,2,2,103,254,168,203,173,18,243,144,173,107,31,170,192,77
],[
106,51,43,54,112,35,153,121,67,20,200,41,189,72,130,56,21,236,207,224
],[
177,158,105,66,59,46,112,78,247,161,95,226,84,124,63,54,193,63,26,119
],[
193,47,179,178,66,88,116,244,43,211,168,176,52,69,234,96,250,168,221,111
],[
83,78,30,87,222,34,119,7,223,50,86,135,74,106,125,222,30,162,250,52
],[
244,220,90,52,216,198,26,180,87,135,94,152,217,183,229,243,50,175,61,112
],[
115,4,51,241,6,78,142,117,250,46,253,63,155,143,77,53,70,43,223,134
],[
123,81,90,143,52,230,157,0,117,171,248,58,37,189,155,252,28,98,78,63
],[
125,2,99,94,70,116,233,122,37,124,35,29,142,145,57,29,10,227,44,196
],[
210,156,15,45,156,102,117,241,181,46,38,4,80,40,22,217,30,20,151,205
],[
30,191,205,194,183,204,98,10,4,180,124,136,111,12,236,17,129,7,169,24
],[
248,59,124,139,26,168,252,248,74,246,189,244,217,254,197,189,30,140,63,30
],[
201,99,116,147,116,130,246,174,123,166,30,185,14,16,185,157,132,136,255,3
],[
242,162,197,184,253,64,243,86,236,88,55,33,2,248,251,47,10,135,149,204
],[
51,77,190,28,30,54,70,2,54,210,6,65,64,161,21,225,50,142,63,213
],[
73,185,178,218,86,121,251,162,89,162,49,50,80,3,112,137,81,51,137,130
]
]