aLevelData = [
[
12,2,2,2,2,2,2,2,63,45,210,129,204,87,33,114,167,2,179,72
],[
2,2,2,2,2,2,2,2,189,50,6,220,153,27,23,137,53,157,211,213
],[
2,2,3,3,3,3,3,3,15,11,206,84,128,48,55,202,73,148,12,144
],[
11,2,3,2,2,2,2,2,111,251,138,57,74,47,232,116,216,255,68,52
],[
2,2,3,2,2,2,2,2,87,136,222,15,18,179,132,228,123,255,77,193
],[
2,2,3,2,2,2,2,2,122,129,138,4,5,41,250,192,241,70,61,98
],[
10,2,3,2,2,2,2,2,7,76,139,148,91,213,166,97,217,231,13,154
],[
33,117,115,121,149,40,111,133,175,95,117,181,153,116,5,216,247,65,34,52
],[
7,226,6,110,237,189,20,170,72,192,14,242,9,234,136,220,133,13,157,103
],[
201,210,224,39,45,253,149,162,44,242,34,249,114,120,192,203,55,190,118,86
],[
204,156,72,223,115,26,172,84,116,54,61,49,109,226,179,160,234,77,19,228
],[
53,99,35,247,112,151,33,114,224,224,180,174,140,1,35,41,7,14,197,43
],[
138,44,185,169,69,152,214,105,247,235,229,103,189,156,14,120,39,198,145,45
],[
145,43,183,250,177,122,7,151,108,205,188,167,238,118,119,152,249,251,50,202
],[
125,95,117,243,106,163,204,194,194,141,120,194,242,168,101,130,98,140,92,243
],[
75,95,122,17,201,156,225,197,49,19,173,10,164,50,42,80,228,130,68,29
],[
103,116,62,250,170,94,167,141,200,193,138,3,75,205,230,177,66,39,93,250
],[
148,233,48,115,147,235,107,69,212,65,93,211,63,4,75,157,98,86,102,100
],[
10,160,249,144,21,30,231,206,130,158,85,253,202,132,164,75,115,18,162,155
],[
226,230,1,43,113,196,8,115,193,150,136,80,82,177,18,97,80,90,103,177
]
]