aLevelData = [
[
4,2,2,2,2,2,2,2,2,2,8,2,2,2,2,3,11,14,27,164
],[
47,140,40,38,232,226,226,5,104,76,39,242,170,170,225,129,3,204,57,139
],[
250,236,7,209,89,124,140,225,132,35,99,62,10,2,181,187,122,59,173,40
],[
120,180,43,48,15,24,189,130,73,31,203,47,253,16,17,83,233,132,82,248
],[
0,108,75,55,5,85,231,160,89,235,177,221,18,188,142,145,76,63,172,134
],[
196,21,182,8,163,142,74,140,151,111,172,150,40,243,188,217,74,15,37,159
],[
46,250,216,107,94,237,185,221,9,40,151,215,155,53,98,222,145,112,152,195
],[
140,199,1,130,164,191,156,106,254,183,217,126,161,113,8,28,133,206,18,220
],[
237,217,103,187,247,7,55,121,114,190,229,63,239,19,185,133,27,216,213,51
],[
76,214,106,6,89,87,43,54,175,232,2,86,161,92,2,123,0,20,158,160
],[
236,126,24,73,233,220,60,103,54,71,77,124,90,243,64,255,255,180,40,2
],[
3,193,242,18,205,185,82,95,221,227,253,29,167,186,25,41,162,169,241,240
],[
156,19,238,141,80,150,195,49,58,145,231,200,170,227,72,217,24,246,62,174
],[
183,253,189,182,76,121,208,39,65,2,66,231,245,68,158,173,87,72,91,100
],[
179,245,80,208,204,214,110,115,42,29,173,178,181,232,71,52,131,196,37,139
],[
239,111,150,22,235,227,71,37,151,143,112,95,18,232,75,97,143,32,202,168
],[
172,53,137,177,0,46,2,94,243,162,0,156,211,121,86,67,36,246,208,62
],[
55,246,106,235,254,114,192,196,30,75,198,64,70,71,185,244,191,86,85,254
],[
69,27,73,163,22,167,232,55,72,136,33,61,95,2,177,208,31,156,151,66
],[
159,223,200,2,159,90,37,195,27,233,170,218,33,55,232,232,223,130,181,186
]
]