aLevelData = [
[
2,2,2,2,5,5,2,2,2,2,2,2,2,2,2,2,2,195,252,147
],[
2,2,2,4,2,2,2,2,2,2,2,5,2,2,2,5,2,246,132,40
],[
5,3,3,3,5,5,3,3,3,3,3,3,3,3,3,3,3,6,0,131
],[
17,213,53,65,9,154,25,59,100,239,44,6,52,39,202,158,87,60,80,252
],[
180,9,128,230,193,185,39,11,73,128,252,79,108,137,204,100,231,47,212,154
],[
149,111,111,248,54,157,241,139,112,87,210,254,19,184,15,107,161,205,205,113
],[
14,77,63,135,196,132,203,143,234,145,104,175,230,209,75,92,32,155,194,183
],[
9,46,96,29,93,231,90,249,165,184,49,221,255,213,145,210,33,176,122,236
],[
156,40,157,33,94,253,9,90,123,136,6,203,45,169,65,128,25,0,42,57
],[
211,96,155,120,165,128,186,216,140,244,32,160,132,92,59,152,5,220,240,28
],[
206,204,133,110,225,176,191,81,207,106,71,211,53,174,82,106,135,183,129,66
],[
12,56,6,214,42,150,9,190,228,84,74,199,161,207,7,73,47,43,32,181
],[
7,141,121,110,211,138,160,218,45,224,176,184,170,100,117,180,23,60,208,56
],[
2,78,93,134,125,248,84,4,30,2,173,214,74,209,136,178,179,221,203,240
],[
32,101,13,225,109,97,179,98,210,184,88,177,104,179,115,127,232,177,51,70
],[
182,29,174,220,31,158,59,73,223,141,28,214,231,172,97,102,93,21,8,9
],[
227,112,105,207,28,105,210,218,108,98,110,183,0,100,107,239,15,92,91,216
],[
95,132,219,177,10,31,115,238,130,105,190,209,211,206,203,58,40,90,194,192
],[
145,113,203,0,3,192,43,53,161,115,176,10,57,168,80,172,18,36,13,34
],[
229,69,28,225,41,56,69,155,147,108,141,89,222,71,19,201,200,23,56,217
]
]