aLevelData = [
[
5,5,3,5,5,5,5,5,5,5,3,5,5,5,5,5,5,5,164,155
],[
4,2,3,5,5,5,5,5,5,5,3,5,5,5,5,5,5,5,146,134
],[
2,2,3,2,3,3,3,3,3,2,3,3,3,3,3,5,5,3,206,123
],[
5,2,2,2,3,2,2,2,2,2,5,5,5,5,5,5,5,3,23,205
],[
2,2,2,3,2,2,2,2,2,2,5,5,5,5,5,5,5,3,186,184
],[
2,2,2,3,2,2,5,3,3,2,3,3,3,3,3,5,5,3,161,174
],[
2,2,2,2,2,2,5,5,3,2,2,2,2,2,2,2,2,3,219,69
],[
5,2,2,2,2,2,5,5,3,2,2,2,2,2,2,2,2,3,102,85
],[
2,2,5,5,3,2,5,5,3,2,3,3,3,5,5,3,5,3,64,71
],[
2,2,5,5,3,2,5,5,3,6,3,3,5,5,5,3,5,3,11,168
],[
2,2,3,3,3,2,5,5,3,5,5,3,5,5,5,3,5,3,198,119
],[
2,2,3,2,2,2,5,5,3,5,5,5,3,5,5,3,5,3,114,205
],[
2,2,3,2,2,2,5,5,3,5,5,5,3,3,5,3,5,3,141,200
],[
2,2,3,2,5,2,3,3,3,5,5,5,3,3,5,3,5,3,211,236
],[
2,2,2,2,5,2,3,5,5,5,5,5,5,3,5,3,5,3,168,75
],[
2,2,2,2,5,2,5,5,5,5,5,5,5,5,5,3,5,3,14,54
],[
2,2,3,3,3,2,3,3,5,5,5,5,3,5,3,3,5,3,25,79
],[
63,38,252,204,147,6,2,2,91,182,33,93,95,169,138,156,117,48,220,50
],[
82,251,151,236,159,220,211,213,80,207,50,87,49,56,19,162,193,107,8,82
],[
68,113,139,75,20,10,236,232,56,238,142,86,55,88,83,58,46,197,85,154
]
]