aLevelData = [
[
2,130,120,153,158,8,76,38,18,146,55,16,155,102,179,239,60,4,145,105
],[
2,214,93,83,4,169,64,214,55,24,21,52,199,172,205,232,81,92,25,51
],[
5,34,12,218,191,79,83,217,131,3,129,185,230,19,225,42,39,216,59,95
],[
2,252,61,157,193,121,23,91,229,52,181,85,187,167,184,120,9,213,37,136
],[
2,24,49,185,28,174,187,125,234,59,108,154,68,87,212,109,227,108,2,222
],[
228,176,164,238,16,87,111,144,96,6,193,186,192,138,133,187,20,202,88,207
],[
121,250,233,241,205,18,166,240,113,127,149,197,77,24,127,36,21,83,84,81
],[
203,185,203,53,134,151,73,177,113,247,4,50,22,206,104,134,221,119,186,238
],[
207,96,251,116,160,4,15,126,237,25,30,164,194,10,59,191,95,167,67,66
],[
60,28,8,206,74,31,175,0,124,110,87,142,134,121,252,146,229,91,154,37
],[
31,15,149,48,76,225,88,127,213,34,60,23,124,32,172,202,156,86,136,8
],[
178,223,198,248,29,49,95,199,34,7,105,65,51,159,128,158,113,38,107,158
],[
111,113,253,216,57,237,56,78,149,217,185,70,136,178,80,85,28,239,238,189
],[
97,239,196,249,178,48,169,149,57,193,188,67,182,250,75,44,123,106,244,132
],[
187,17,10,97,5,207,59,205,12,29,111,25,169,251,242,117,35,41,214,190
],[
173,154,147,151,48,38,241,187,75,127,40,146,153,102,69,2,50,31,207,135
],[
116,34,171,134,3,19,61,222,14,244,208,193,212,154,56,194,103,93,181,46
],[
176,20,27,160,180,65,48,208,21,136,86,172,220,102,106,170,117,31,235,92
],[
251,248,95,69,183,167,242,235,227,8,97,45,179,17,22,215,150,8,149,116
],[
185,243,22,99,204,81,115,45,10,7,69,22,115,157,74,242,92,170,11,58
]
]