aLevelData = [
[
5,5,213,50,59,110,222,165,124,37,139,106,12,22,28,207,215,7,140,242
],[
4,2,80,54,116,28,110,74,45,80,244,138,52,36,246,77,211,208,153,177
],[
2,2,254,133,26,144,124,0,18,176,71,94,248,58,52,50,231,110,214,213
],[
5,2,161,148,160,253,213,54,75,145,157,140,119,188,75,56,149,65,101,52
],[
2,2,4,14,238,8,122,19,231,64,166,84,22,29,20,61,6,139,80,54
],[
2,2,79,83,78,120,23,146,9,31,217,106,107,128,102,247,109,188,41,132
],[
2,2,127,150,174,255,42,129,102,171,244,253,164,21,132,36,236,73,6,128
],[
5,2,109,69,209,32,204,174,71,235,35,194,253,52,74,142,29,142,85,97
],[
2,2,8,225,93,128,63,189,132,27,131,239,51,128,59,82,166,143,23,232
],[
2,2,171,110,243,41,166,126,254,155,217,141,27,163,226,77,135,155,133,4
],[
2,2,188,36,172,134,150,190,172,97,181,150,202,87,34,158,254,17,53,227
],[
2,2,247,17,182,28,94,233,66,126,95,170,240,216,102,160,53,219,38,60
],[
2,2,5,185,224,82,59,243,226,133,59,107,78,255,214,193,28,101,110,220
],[
2,2,98,9,90,199,211,98,139,191,134,186,112,138,250,39,24,10,86,188
],[
2,2,151,17,245,0,170,119,33,159,158,106,31,96,109,6,109,87,43,37
],[
2,2,71,92,160,121,111,188,55,216,46,46,23,214,150,8,143,153,11,178
],[
2,2,183,233,2,91,84,135,7,236,253,192,5,58,124,65,194,128,119,45
],[
2,2,169,12,80,109,204,56,73,72,41,156,236,51,44,130,170,234,118,154
],[
2,3,194,191,221,240,100,50,180,26,22,195,76,182,88,4,186,20,131,242
],[
2,3,219,47,247,133,150,226,117,134,97,88,202,161,7,197,174,187,168,83
]
]