aLevelData = [
[
2,2,2,2,2,2,2,2,2,6,5,2,2,87,182,246,78,112,60,47
],[
2,3,5,3,5,5,5,3,5,3,5,2,5,123,156,221,27,142,30,100
],[
2,3,2,3,2,2,2,3,5,3,5,2,5,165,211,229,143,228,24,85
],[
2,2,2,2,2,2,2,2,2,2,2,2,5,195,250,3,74,253,60,169
],[
2,3,5,3,5,5,5,3,2,3,5,5,5,90,12,147,91,91,254,33
],[
2,3,5,3,5,5,5,3,2,3,5,5,5,195,37,216,40,49,153,138
],[
2,5,5,5,5,5,5,5,5,5,5,5,5,40,47,227,33,72,91,251
],[
2,3,5,3,5,5,5,3,5,3,5,5,5,63,247,118,114,200,211,184
],[
2,3,5,3,5,5,5,3,5,3,5,5,5,107,223,202,102,232,17,127
],[
2,5,5,5,5,5,5,5,5,5,5,5,5,167,71,207,239,148,12,34
],[
2,3,5,3,2,2,2,3,2,3,2,2,2,84,142,224,154,74,212,218
],[
5,3,5,3,2,2,2,3,2,3,2,2,2,136,48,84,254,108,209,194
],[
5,5,5,5,5,5,5,5,5,5,5,5,5,3,177,67,232,90,152,16
],[
5,3,5,3,5,5,5,3,5,3,5,5,2,61,107,115,148,184,34,19
],[
166,230,170,131,123,59,120,247,198,166,140,255,36,103,243,0,184,37,145,229
],[
18,59,29,18,86,84,109,153,154,55,244,177,143,228,137,100,100,223,105,135
],[
231,204,128,239,238,60,228,226,245,199,163,204,8,91,190,51,228,211,117,237
],[
89,203,197,145,242,179,48,43,216,35,188,52,244,110,62,193,84,122,216,250
],[
208,207,193,206,237,237,68,229,1,227,12,214,152,29,158,155,23,126,39,66
],[
159,175,120,228,52,182,79,219,31,202,216,48,144,101,115,83,136,156,184,15
]
]