aLevelData = [
[
2,2,2,2,2,2,2,2,2,2,2,2,2,239,178,20,162,202,11,141
],[
2,2,13,5,5,2,2,12,5,5,2,3,2,228,59,76,75,106,163,104
],[
2,2,2,5,5,2,2,2,5,5,2,3,2,64,243,20,52,187,31,251
],[
2,2,2,2,2,2,2,2,2,2,2,3,2,124,46,39,2,81,52,202
],[
2,2,2,2,2,2,2,2,2,2,2,3,3,52,160,210,139,98,9,253
],[
2,2,2,2,2,2,2,2,2,2,2,2,2,25,198,237,93,15,231,201
],[
2,2,2,2,2,2,2,2,2,2,2,2,2,81,221,188,195,51,6,20
],[
2,2,2,2,2,2,2,2,2,2,2,2,2,131,221,141,54,68,108,169
],[
2,2,2,2,2,2,2,2,2,2,3,2,2,196,43,68,192,229,215,84
],[
2,2,2,2,2,2,2,2,2,3,3,2,3,147,162,57,155,183,145,166
],[
234,68,177,42,236,209,150,32,101,159,198,255,183,20,98,119,170,107,9,189
],[
108,171,249,35,215,213,119,235,243,98,114,93,188,236,99,23,37,44,119,165
],[
92,36,240,81,80,157,200,60,113,212,152,174,182,113,185,171,229,184,169,199
],[
15,3,176,59,89,112,195,55,3,215,168,122,162,255,91,33,176,17,177,188
],[
71,76,59,167,42,251,109,152,5,164,255,116,246,131,148,103,75,54,154,51
],[
142,186,113,200,191,150,207,22,224,86,99,31,183,59,184,80,207,49,93,17
],[
192,1,67,155,176,200,102,9,26,168,175,178,206,189,25,183,57,83,20,216
],[
231,86,39,140,70,9,216,80,173,251,208,63,156,56,59,227,70,188,110,75
],[
76,45,204,93,204,201,234,110,154,157,241,16,205,247,68,43,126,31,99,80
],[
204,66,16,73,35,175,176,245,191,70,243,83,107,44,183,220,143,196,42,22
]
]