aLevelData = [
[
4,2,5,5,2,2,2,2,236,164,116,8,112,62,113,244,72,40,160,216
],[
2,2,2,2,2,2,5,2,129,5,174,5,64,58,250,165,18,241,145,230
],[
2,2,2,2,2,2,3,3,125,100,92,91,219,88,152,159,104,231,135,59
],[
3,3,3,3,3,3,3,2,153,131,101,201,175,56,158,90,141,49,62,22
],[
2,2,3,2,2,2,2,2,198,126,169,34,251,21,140,199,100,22,19,208
],[
13,2,3,2,2,2,2,2,172,83,93,51,2,15,45,244,109,6,226,71
],[
2,5,3,2,2,2,2,2,95,174,169,245,142,189,241,0,255,235,31,138
],[
2,12,3,2,2,2,2,2,99,249,131,243,167,242,139,66,199,177,55,198
],[
5,2,3,3,3,3,3,3,227,163,205,253,148,206,206,180,128,18,40,112
],[
11,2,3,2,2,2,2,2,44,175,173,13,18,8,196,165,244,167,95,179
],[
2,5,3,2,2,2,2,2,111,128,45,120,211,122,16,158,50,43,209,28
],[
2,10,3,2,2,2,2,2,183,227,19,89,57,237,133,148,16,17,92,131
],[
40,93,1,58,84,38,6,79,228,73,95,60,121,182,207,4,24,48,160,26
],[
126,78,151,126,179,198,39,41,226,234,229,171,104,115,60,19,43,126,98,15
],[
45,212,138,84,97,110,92,64,189,57,162,190,144,22,68,107,22,37,118,247
],[
73,67,48,205,251,209,222,246,34,184,90,58,115,169,23,137,50,170,159,154
],[
72,206,63,210,150,67,0,103,137,146,218,197,238,35,37,49,8,0,80,172
],[
224,218,213,26,221,81,108,163,148,112,128,90,225,119,223,28,55,222,181,187
],[
52,150,187,92,121,146,172,30,184,134,249,253,14,239,189,245,148,83,243,106
],[
49,202,231,199,178,189,234,102,28,238,74,176,64,184,129,133,145,153,173,222
]
]