aLevelData = [
[
2,2,3,3,3,3,3,203,123,213,118,183,251,201,130,29,102,238,26,125
],[
2,2,2,2,2,2,2,12,235,155,209,208,161,178,29,115,95,196,72,21
],[
3,2,3,3,3,3,3,85,141,42,248,76,7,230,136,148,141,122,152,61
],[
2,2,2,2,2,2,2,64,148,239,138,170,168,3,162,161,63,4,137,110
],[
3,2,3,3,3,3,3,146,28,79,47,87,246,135,122,219,125,251,67,81
],[
2,2,3,2,2,2,2,230,158,0,105,240,194,10,37,106,139,71,233,246
],[
164,6,209,14,48,42,70,68,4,139,212,206,19,153,54,65,41,67,179,157
],[
221,23,174,138,193,170,120,225,219,58,104,110,89,146,46,245,128,46,100,114
],[
230,160,102,165,225,50,100,206,63,205,181,182,55,25,110,238,160,230,52,91
],[
97,203,78,243,41,12,254,193,96,193,18,47,93,53,182,132,217,141,140,172
],[
163,170,255,56,150,80,212,165,201,135,1,225,5,65,195,11,124,62,235,122
],[
183,45,120,2,209,20,107,114,227,241,215,97,191,162,56,43,225,2,5,54
],[
162,85,137,122,175,230,238,64,186,238,155,41,111,184,192,115,170,3,46,120
],[
231,168,109,119,250,124,8,151,0,120,44,41,149,23,113,46,71,0,248,25
],[
75,229,182,214,111,171,15,10,80,203,167,157,205,248,117,118,187,2,25,133
],[
218,250,111,7,8,151,100,5,181,216,8,30,151,235,229,135,159,78,144,80
],[
43,52,125,233,125,42,23,228,108,250,16,252,89,207,246,87,101,155,8,8
],[
225,182,71,216,7,200,208,70,231,232,104,204,163,5,89,100,223,133,125,75
],[
116,45,152,5,100,65,234,161,19,236,5,62,180,225,221,206,1,67,30,26
],[
47,195,194,7,33,8,226,23,220,83,204,50,59,99,87,167,227,150,115,110
]
]