aLevelData = [
[
2,2,2,2,5,5,2,2,2,2,2,227,156,131,76,102,229,112,107,149
],[
2,2,2,4,2,2,2,2,2,2,2,249,149,23,124,194,5,169,100,113
],[
5,3,3,3,5,5,3,3,3,3,3,250,0,250,22,25,191,174,109,247
],[
2,3,2,2,2,2,2,2,2,3,2,182,90,251,219,157,36,90,198,8
],[
2,3,2,2,2,2,2,2,2,3,2,165,210,176,151,75,41,21,109,251
],[
2,3,2,2,3,2,2,2,2,3,2,187,176,228,251,205,135,127,16,30
],[
2,3,2,2,3,2,2,2,2,3,2,39,33,227,191,49,124,169,37,21
],[
2,3,2,2,3,5,5,3,3,3,3,203,3,125,30,196,35,63,175,200
],[
2,3,3,2,3,2,2,3,2,2,2,49,6,204,94,237,159,219,223,149
],[
2,2,3,2,3,2,2,3,2,1,2,95,172,115,9,186,184,59,45,18
],[
2,2,3,2,3,2,2,3,2,2,2,166,208,143,205,20,237,74,170,147
],[
2,2,3,2,3,2,2,3,2,2,2,104,42,85,243,103,16,57,194,208
],[
2,2,2,2,3,2,2,3,2,2,2,152,149,15,1,250,210,115,194,46
],[
20,83,119,84,15,95,155,82,28,94,105,191,139,46,220,0,59,6,218,176
],[
105,255,172,70,198,211,178,241,204,228,85,199,81,128,60,31,93,99,195,59
],[
57,125,169,43,200,246,8,237,26,112,139,217,63,140,219,61,89,175,90,68
],[
245,6,20,28,156,199,243,87,164,186,50,146,76,249,19,85,9,244,213,59
],[
26,183,224,83,98,112,68,197,119,43,97,185,247,225,231,116,27,177,2,196
],[
142,109,206,159,127,88,17,7,245,46,41,48,98,101,67,229,124,179,206,40
],[
72,208,48,25,119,125,183,25,246,197,210,46,193,131,129,169,248,36,10,7
]
]