aLevelData = [
[
2,2,2,2,2,2,2,2,2,2,2,2,2,2,2,103,125,250,122,129
],[
2,2,2,2,2,2,2,2,2,2,2,2,2,2,2,133,29,151,215,189
],[
2,2,2,2,2,2,2,2,2,2,2,2,2,2,2,5,115,199,158,147
],[
2,2,2,13,2,2,2,2,2,2,2,2,2,2,2,122,224,8,118,175
],[
2,2,2,2,2,2,2,2,2,2,2,2,2,2,2,234,54,78,64,38
],[
2,2,2,2,2,2,2,2,2,2,2,2,2,2,2,240,17,94,215,2
],[
2,2,2,2,2,2,2,2,2,2,2,2,2,2,2,174,75,0,238,241
],[
181,112,222,167,66,252,220,2,108,12,69,63,143,89,123,133,64,244,219,17
],[
225,139,239,144,114,232,228,204,170,186,62,139,71,152,202,180,162,67,212,180
],[
134,43,155,32,66,53,2,156,253,188,136,251,74,214,122,168,253,216,104,68
],[
60,28,213,144,217,1,50,142,223,52,14,227,106,46,135,128,188,254,4,129
],[
142,73,38,85,164,143,251,32,164,175,117,93,40,174,27,200,18,180,255,123
],[
32,87,240,87,192,28,240,165,37,59,233,253,154,163,155,103,22,62,217,193
],[
17,118,245,97,151,248,121,251,155,184,23,196,141,53,227,215,47,254,192,216
],[
164,117,24,216,201,211,209,121,201,108,124,83,236,53,207,150,176,131,85,240
],[
27,21,100,177,79,85,80,45,95,219,222,97,97,51,251,218,197,224,174,211
],[
229,160,76,158,220,242,235,69,156,214,24,112,59,212,205,137,142,63,157,31
],[
249,187,50,136,133,253,249,203,51,210,28,189,145,99,177,105,138,183,49,181
],[
130,121,43,67,163,252,57,150,113,124,52,118,165,167,164,149,56,91,122,114
],[
190,178,2,126,245,60,19,126,158,139,137,48,139,245,244,49,250,149,146,30
]
]