aLevelData = [
[
6,2,2,2,2,2,2,2,2,2,217,128,85,236,149,60,148,20,173,132
],[
2,2,2,2,2,2,2,2,2,2,77,119,26,190,91,84,174,196,70,229
],[
2,2,2,2,2,2,2,2,2,2,74,66,20,227,82,95,97,77,94,159
],[
3,3,3,3,3,3,3,3,3,3,178,102,50,7,7,253,241,131,175,240
],[
2,2,2,2,2,2,2,2,2,2,141,134,96,243,130,240,135,142,196,52
],[
2,2,2,2,2,2,2,2,2,2,221,101,245,186,59,188,220,130,175,58
],[
2,2,2,2,2,3,2,2,3,2,19,11,207,237,255,115,77,143,5,223
],[
2,2,3,3,3,3,3,3,3,3,204,8,251,29,242,51,221,136,191,229
],[
2,2,2,2,2,2,2,2,2,2,194,44,29,44,14,43,184,212,232,96
],[
2,2,2,2,2,2,2,2,2,4,15,48,239,65,204,23,40,10,80,44
],[
3,3,3,3,3,3,3,3,3,3,59,24,147,98,224,146,43,192,148,79
],[
2,2,2,2,2,2,2,2,2,2,170,98,144,244,45,193,251,93,50,52
],[
2,2,2,2,2,2,2,2,2,2,95,63,170,182,90,11,80,233,150,21
],[
2,2,3,3,3,3,3,3,3,3,56,91,250,245,171,8,34,45,50,33
],[
2,2,3,2,2,2,2,2,2,2,13,13,241,12,22,212,54,172,38,24
],[
2,2,3,2,2,2,2,2,2,2,82,226,39,104,168,84,188,47,3,109
],[
2,2,3,3,3,3,3,2,2,2,47,219,45,165,171,63,189,2,171,54
],[
48,222,178,138,59,236,61,20,96,118,245,36,192,232,42,35,48,146,125,118
],[
142,170,220,166,86,144,180,190,112,86,97,245,76,128,234,141,49,8,235,251
],[
210,166,210,72,35,78,78,183,106,249,5,168,153,168,134,188,219,166,126,58
]
]