aLevelData = [
[
4,2,2,2,2,2,2,2,2,2,2,2,2,2,2,2,2,2,2,164
],[
5,2,5,3,2,2,2,2,2,2,2,2,2,2,2,2,2,2,2,175
],[
2,5,5,3,3,3,3,3,3,3,3,3,3,3,3,3,3,3,2,215
],[
3,3,5,5,5,5,5,5,5,5,3,2,2,2,2,2,2,2,2,247
],[
2,3,5,5,5,5,5,5,5,5,3,6,2,2,2,2,2,2,2,120
],[
3,3,5,5,5,5,3,3,3,3,3,3,3,3,3,2,3,3,3,71
],[
3,5,5,5,5,5,3,2,2,2,2,2,2,2,2,2,2,2,2,26
],[
3,5,5,3,3,3,3,8,2,2,2,5,5,5,5,5,5,5,5,81
],[
3,5,5,3,2,2,3,3,3,3,2,5,3,3,3,5,3,3,3,73
],[
3,5,5,3,2,2,2,2,2,3,2,5,3,5,5,5,5,5,5,117
],[
3,5,5,3,2,2,3,2,2,3,2,5,3,5,5,5,5,5,5,232
],[
5,5,5,3,2,2,3,2,2,3,2,5,3,5,5,5,5,5,5,32
],[
5,5,5,3,2,2,3,2,2,3,2,5,3,3,3,5,5,5,5,113
],[
5,3,3,3,2,2,3,2,2,3,2,5,2,2,3,3,3,3,3,131
],[
5,3,2,2,2,2,3,2,2,3,2,5,2,2,2,2,2,2,2,114
],[
165,187,89,15,168,95,162,212,189,52,43,102,198,33,139,12,185,212,9,8
],[
164,183,186,40,238,32,234,152,223,201,189,250,98,127,22,184,10,30,184,153
],[
84,188,172,147,44,37,226,225,178,136,27,85,61,111,5,238,160,244,168,173
],[
173,50,2,165,248,251,238,82,222,201,75,43,197,246,89,122,164,47,102,108
],[
199,38,171,100,204,135,113,149,242,46,120,208,147,151,152,154,238,149,169,130
]
]