aLevelData = [
[
12,2,44,52,0,38,135,157,160,244,76,249,198,16,147,149,223,63,218,134
],[
2,2,250,99,74,224,45,78,61,40,52,216,254,11,92,47,207,79,160,111
],[
2,2,49,11,17,115,95,19,123,234,28,183,69,173,174,173,153,80,43,75
],[
11,2,197,246,243,249,225,106,126,231,178,108,88,251,207,73,105,14,2,175
],[
2,2,122,87,241,190,245,39,254,98,236,215,107,225,93,255,194,176,181,233
],[
2,2,116,139,146,70,192,196,205,31,214,220,184,14,61,80,164,173,114,181
],[
10,2,167,79,210,7,156,238,185,63,106,101,236,35,138,223,52,98,195,144
],[
2,2,76,224,56,163,253,79,165,115,136,255,230,253,68,247,185,150,136,68
],[
2,2,196,217,203,145,218,228,10,248,122,196,107,24,152,45,31,104,160,110
],[
9,2,140,202,185,165,172,100,71,47,176,171,179,99,234,192,110,128,233,0
],[
2,2,51,227,230,215,141,126,95,212,154,133,1,3,14,106,203,119,122,12
],[
2,2,113,38,207,44,254,250,30,32,190,36,161,203,91,180,255,204,70,102
],[
8,2,204,246,88,191,79,0,186,89,137,126,2,124,114,16,158,237,134,218
],[
2,2,118,11,128,52,205,23,102,162,104,212,197,6,243,80,62,20,160,1
],[
2,2,65,7,17,19,25,146,120,1,41,26,253,99,117,34,96,7,100,7
],[
6,2,223,66,196,237,90,136,14,249,181,59,235,193,126,193,248,0,207,217
],[
2,2,198,143,118,47,38,144,84,46,163,236,3,21,79,1,188,77,195,148
],[
119,250,97,13,83,208,220,227,57,39,251,85,188,82,153,91,68,45,241,220
],[
108,246,24,33,168,94,203,138,43,223,107,127,8,79,70,170,151,182,24,99
],[
26,93,210,108,160,39,153,223,42,36,18,100,13,100,221,167,151,9,95,10
]
]