aLevelData = [
[
2,2,2,2,2,2,2,27,232,42,150,38,173,104,116,8,207,223,178,164
],[
2,2,2,2,2,2,2,61,22,207,76,138,159,34,203,230,62,109,169,76
],[
2,2,3,2,3,2,2,78,181,170,253,97,81,152,44,39,66,66,251,145
],[
2,2,3,2,3,2,2,194,197,166,53,31,10,254,245,202,144,26,219,171
],[
2,2,3,2,3,2,2,108,73,72,184,142,74,78,198,69,192,90,159,6
],[
2,2,3,2,2,2,2,224,22,84,105,109,141,213,116,230,145,190,28,254
],[
2,2,3,2,3,3,3,89,116,9,76,111,113,154,68,202,220,41,102,54
],[
2,2,3,2,2,2,2,93,144,181,253,47,235,107,192,119,160,235,166,212
],[
2,2,3,2,3,3,3,157,247,185,55,225,35,140,245,62,137,33,26,93
],[
2,2,3,2,2,2,2,191,11,1,2,6,208,33,145,196,145,42,210,53
],[
2,2,3,3,3,3,3,237,81,241,93,34,231,201,65,117,49,97,86,213
],[
1,2,3,2,2,2,2,116,183,58,187,79,189,162,84,77,162,148,226,187
],[
82,214,96,183,64,166,100,138,99,171,74,56,126,44,143,85,165,128,123,25
],[
253,197,3,183,195,213,237,235,144,118,53,210,219,209,176,255,191,38,239,203
],[
254,189,102,236,71,32,205,74,180,135,199,14,151,148,194,251,118,64,30,1
],[
84,22,145,15,50,159,202,42,214,29,84,188,203,123,190,46,169,133,249,184
],[
151,85,1,120,13,13,191,194,223,204,47,184,119,218,190,26,97,38,246,95
],[
14,243,92,4,209,206,153,36,46,195,217,73,84,208,113,130,232,154,196,181
],[
4,95,103,55,128,44,131,154,112,80,123,198,237,16,207,75,25,156,65,246
],[
93,66,54,163,245,226,94,81,175,162,151,124,239,226,15,167,247,115,169,56
]
]