aLevelData = [
[
5,5,5,5,5,2,2,2,2,2,2,2,2,2,2,181,103,199,115,120
],[
5,2,2,2,2,2,2,2,2,2,2,2,2,2,2,254,156,103,133,96
],[
5,2,5,3,3,3,3,3,3,3,2,2,3,3,3,33,24,241,214,202
],[
57,121,191,202,67,126,134,51,13,78,210,95,156,165,252,144,60,116,198,211
],[
207,224,74,42,102,142,48,233,14,30,36,97,237,245,135,188,141,64,101,40
],[
119,53,168,56,4,156,139,134,112,143,81,158,48,126,54,23,133,118,166,3
],[
82,162,173,138,43,18,175,209,174,187,89,33,22,191,215,69,13,239,71,51
],[
194,142,110,239,60,88,170,173,238,195,40,54,139,133,87,140,27,86,157,209
],[
79,247,72,101,17,115,199,79,96,165,26,222,91,250,135,143,155,121,143,50
],[
198,0,32,73,97,208,12,177,230,75,186,132,23,253,28,61,145,218,224,29
],[
164,198,235,206,98,91,3,71,246,230,203,239,56,178,245,5,126,138,179,63
],[
180,121,110,177,175,212,187,241,190,122,139,121,130,91,161,76,0,55,74,221
],[
245,168,72,44,105,99,15,50,135,187,52,127,172,103,34,34,190,132,15,201
],[
191,222,46,41,162,107,38,160,93,24,196,25,63,200,236,49,132,154,214,152
],[
39,107,119,185,247,157,60,157,237,22,254,12,189,139,51,246,171,254,97,18
],[
160,133,217,197,125,78,161,69,175,224,178,254,4,163,99,53,188,163,38,235
],[
228,145,114,4,223,11,0,168,70,28,58,234,242,7,241,167,86,64,78,177
],[
18,188,11,45,198,106,226,58,36,2,70,212,74,253,82,247,78,228,255,7
],[
26,206,153,111,122,37,116,137,115,168,219,190,215,182,73,238,22,201,220,17
],[
87,65,6,31,199,99,134,46,49,161,150,218,208,27,102,234,97,103,202,49
]
]