aLevelData = [
[
2,2,3,3,3,208,149,109,221,82,149,20,48,199,49,152,227,46,181,30
],[
2,2,2,2,2,88,247,37,173,78,114,222,61,167,136,123,17,110,169,246
],[
3,2,3,3,3,71,24,5,15,174,10,255,242,215,92,222,20,111,221,198
],[
2,2,2,2,2,94,203,87,232,141,197,20,245,217,199,160,216,212,37,209
],[
3,2,3,3,3,164,150,176,5,203,23,136,171,146,220,49,5,193,214,233
],[
43,159,135,57,84,29,102,203,81,82,133,123,90,39,113,176,13,84,89,237
],[
180,139,115,163,199,242,156,74,178,215,63,175,215,160,119,144,215,0,120,102
],[
13,113,43,130,92,222,24,91,43,159,137,39,173,171,236,168,102,9,122,73
],[
235,136,22,105,233,176,120,247,104,248,138,63,81,58,18,3,46,99,146,206
],[
50,111,108,133,121,149,74,63,144,190,189,86,56,60,37,191,103,185,208,150
],[
144,109,102,253,36,149,132,39,89,32,167,176,42,171,76,48,159,175,85,15
],[
78,249,175,155,34,91,50,87,91,162,200,150,214,199,210,73,143,106,199,22
],[
100,123,30,170,28,59,111,79,167,99,213,193,167,162,150,61,48,77,6,220
],[
204,83,168,31,195,111,151,203,153,161,36,247,215,222,193,99,15,7,30,11
],[
26,24,145,252,164,162,187,103,235,123,105,244,195,179,184,88,222,203,125,42
],[
74,34,227,242,59,176,86,132,11,246,160,140,127,53,82,105,76,223,102,63
],[
217,75,34,71,71,172,64,106,175,68,75,15,170,213,76,49,23,89,166,180
],[
24,242,63,249,94,36,224,176,167,66,223,237,132,38,251,126,96,37,135,125
],[
190,67,203,33,194,162,167,217,243,65,121,156,63,227,65,122,64,76,3,120
],[
189,179,109,154,116,117,186,65,22,7,214,183,148,46,195,9,153,114,59,21
]
]