aLevelData = [
[
2,2,2,2,2,2,2,2,2,2,2,2,2,2,2,2,2,2,5,3
],[
2,2,2,2,2,2,2,2,3,3,3,3,3,3,3,3,3,2,5,3
],[
2,2,3,2,3,2,2,2,2,3,2,2,2,2,2,2,2,2,5,3
],[
2,2,3,2,3,2,2,2,2,2,3,2,2,2,2,2,2,2,5,3
],[
2,2,3,2,3,2,2,2,2,2,2,3,2,2,2,2,2,3,2,3
],[
2,2,3,2,2,2,2,2,2,2,2,2,3,2,2,3,3,2,2,3
],[
2,2,3,2,3,3,3,3,3,3,3,3,3,2,2,2,2,2,2,2
],[
2,2,3,2,2,2,2,2,2,2,2,2,2,2,2,2,2,2,2,2
],[
2,2,3,2,3,3,3,3,3,3,3,3,3,3,3,3,3,3,2,2
],[
2,2,3,2,2,2,2,2,2,2,2,2,2,2,2,2,2,2,2,2
],[
2,2,3,3,3,3,3,3,3,3,3,3,3,3,3,3,3,3,2,2
],[
1,2,3,2,2,2,2,2,2,2,2,2,2,2,2,2,2,2,2,2
],[
2,2,3,5,5,2,2,2,5,5,5,5,5,5,5,5,5,5,2,5
],[
21,21,173,203,178,107,99,194,191,174,153,96,101,116,99,246,7,162,218,201
],[
37,201,32,7,129,182,158,255,128,68,144,144,210,117,196,226,85,193,158,85
],[
55,174,96,183,92,161,168,186,255,244,59,165,155,72,0,73,12,29,80,55
],[
241,160,109,48,86,195,79,221,144,147,167,192,103,199,30,107,123,148,221,240
],[
224,201,83,152,12,23,50,216,243,176,187,128,112,21,60,54,231,40,215,35
],[
41,137,132,236,151,31,89,228,139,245,10,128,243,72,172,11,63,222,190,154
],[
126,153,105,67,195,75,7,138,206,204,227,28,232,74,63,192,15,225,156,138
]
]