aLevelData = [
[
2,95,195,33,152,244,76,238,56,56,76,197,104,200,125,205,196,157,133,96
],[
2,73,143,109,180,106,23,84,187,95,89,101,71,193,98,6,114,84,174,82
],[
2,61,36,237,202,119,211,6,71,225,49,93,52,143,13,82,249,145,75,10
],[
2,186,211,55,113,66,66,25,127,58,48,10,187,159,250,5,254,115,232,65
],[
2,122,178,84,190,250,135,15,30,107,192,0,183,156,128,14,230,66,51,65
],[
2,166,63,199,35,97,36,26,109,6,244,174,223,91,43,164,112,149,254,232
],[
2,167,38,229,169,73,214,87,12,52,21,212,33,139,143,41,22,19,2,240
],[
2,170,221,76,86,229,38,201,33,6,123,219,241,190,33,202,197,155,179,207
],[
194,199,13,107,48,242,105,253,198,141,200,148,39,57,148,2,172,127,131,50
],[
100,193,190,187,89,112,67,180,21,128,135,203,101,25,96,145,93,144,35,24
],[
156,149,9,192,210,174,216,78,127,228,191,62,253,187,129,91,192,104,214,140
],[
221,63,14,241,201,107,247,46,99,225,1,7,53,151,160,46,247,240,242,88
],[
85,123,162,150,243,222,12,227,173,13,161,249,35,192,141,106,117,35,152,235
],[
75,207,74,243,25,249,83,133,161,233,42,73,185,174,243,226,78,17,166,124
],[
169,199,110,164,241,235,79,93,241,171,12,112,28,65,72,3,206,37,235,109
],[
213,128,199,73,48,228,124,201,22,59,152,78,59,254,3,53,78,168,155,243
],[
198,105,27,100,222,30,65,96,222,129,48,144,157,157,19,127,68,134,3,244
],[
84,70,43,128,235,26,41,83,67,223,184,83,123,199,140,112,154,80,126,49
],[
209,119,233,147,0,40,84,20,124,250,81,11,16,25,164,58,65,131,168,166
],[
214,120,239,167,152,43,41,59,87,190,71,159,45,109,224,33,7,10,211,48
]
]