aLevelData = [
[
2,2,3,3,3,3,3,3,3,3,3,3,3,3,3,65,91,49,49,216
],[
2,2,2,2,2,2,2,2,2,2,2,2,2,2,2,96,255,108,118,218
],[
3,2,3,3,3,3,3,3,3,3,3,2,3,3,3,211,105,91,217,15
],[
2,2,2,2,2,2,2,2,2,2,2,2,2,2,3,75,44,61,159,165
],[
69,193,231,151,80,56,249,58,22,22,12,62,150,49,42,210,84,201,40,196
],[
244,198,219,234,7,66,137,192,37,71,158,82,60,218,160,93,39,56,101,177
],[
131,95,132,217,190,208,9,254,112,148,109,9,239,125,197,8,30,174,57,211
],[
133,93,184,239,167,216,234,178,143,198,102,168,173,176,38,54,224,192,55,125
],[
212,200,181,129,142,133,247,139,69,38,7,204,116,8,85,66,45,196,172,224
],[
176,107,100,233,60,16,218,157,37,135,29,23,39,109,234,118,250,104,219,59
],[
38,176,219,242,25,207,221,21,119,165,206,45,177,174,199,58,217,136,136,85
],[
181,175,34,148,18,140,243,46,90,174,215,223,105,87,157,142,157,58,184,46
],[
44,131,55,226,187,24,248,100,44,30,24,167,183,192,173,187,60,43,184,242
],[
215,221,85,65,182,32,53,232,39,209,78,85,245,102,209,70,245,48,93,47
],[
220,220,114,219,83,64,40,85,78,85,33,9,153,127,188,39,179,21,139,72
],[
224,29,8,84,122,87,131,163,136,126,95,98,146,202,126,57,179,185,250,42
],[
239,15,22,189,199,27,116,90,11,61,136,246,240,165,76,242,98,93,53,63
],[
155,138,102,199,245,239,37,8,252,178,139,2,200,99,127,84,138,58,229,162
],[
100,160,18,57,126,241,131,246,86,129,207,100,87,221,219,36,174,83,77,146
],[
89,180,67,165,128,88,68,23,9,99,119,198,103,71,18,91,178,138,22,41
]
]