aLevelData = [
[
4,2,2,2,2,2,2,2,2,2,2,2,2,2,2,2,2,2,2,53
],[
5,2,5,3,2,2,2,2,2,2,2,2,2,2,2,2,2,2,2,43
],[
2,5,5,3,3,3,3,3,3,3,3,3,3,3,3,3,3,3,2,172
],[
3,3,5,5,5,5,5,5,5,5,3,2,2,2,2,2,2,2,2,50
],[
2,3,5,5,5,5,5,5,5,5,3,6,2,2,2,2,2,2,2,245
],[
3,3,5,5,5,5,3,3,3,3,3,3,3,3,3,2,3,3,3,93
],[
3,5,5,5,5,5,3,2,2,2,2,2,2,2,2,2,2,2,2,254
],[
3,5,5,3,3,3,3,8,2,2,2,5,5,5,5,5,5,5,5,190
],[
3,5,5,3,2,2,3,3,3,3,2,5,3,3,3,5,3,3,3,8
],[
3,5,5,3,2,2,2,2,2,3,2,5,3,5,5,5,5,5,5,57
],[
3,5,5,3,2,2,3,2,2,3,2,5,3,5,5,5,5,5,5,101
],[
5,5,5,3,2,2,3,2,2,3,2,5,3,5,5,5,5,5,5,216
],[
5,5,5,3,2,2,3,2,2,3,2,5,3,3,3,5,5,5,5,12
],[
5,3,3,3,2,2,3,2,2,3,2,5,2,2,3,3,3,3,3,123
],[
5,3,2,2,2,2,3,2,2,3,2,5,2,2,2,2,2,2,2,250
],[
5,3,3,2,2,2,3,2,5,5,5,5,2,2,2,2,2,2,2,69
],[
5,5,3,3,2,2,3,2,5,3,5,5,3,3,3,3,3,3,2,125
],[
5,5,5,5,3,3,3,2,5,3,5,5,2,2,2,2,2,3,2,55
],[
211,212,196,203,39,239,112,17,178,112,195,217,91,182,112,150,21,247,163,87
],[
3,215,66,249,223,58,114,155,156,87,94,83,74,15,52,31,59,124,111,31
]
]