aLevelData = [
[
4,2,44,229,225,165,160,136,59,14,63,93,224,243,84,25,1,211,45,92
],[
5,2,13,109,102,228,28,138,106,1,142,30,54,72,239,143,96,140,30,85
],[
88,10,175,195,239,228,141,36,21,209,228,10,231,18,62,227,233,168,236,205
],[
143,196,167,172,3,127,119,121,34,203,212,221,199,169,11,254,77,157,228,153
],[
79,95,130,81,178,212,138,70,230,60,136,234,104,173,142,16,140,192,30,70
],[
121,138,73,101,117,206,25,102,99,112,45,119,137,45,163,78,151,138,59,190
],[
229,10,184,136,253,164,138,115,89,116,171,159,110,177,199,22,233,223,159,164
],[
56,70,175,233,76,162,14,172,157,28,151,114,111,121,70,79,84,146,228,253
],[
243,4,231,43,7,40,148,23,171,70,102,95,212,5,179,21,31,38,141,17
],[
205,114,231,139,11,241,248,233,119,93,229,213,225,214,154,147,78,215,248,145
],[
67,105,54,64,64,151,129,35,138,33,230,38,45,117,114,48,66,218,152,251
],[
110,239,210,36,171,84,139,126,75,167,61,172,58,178,215,239,131,226,97,60
],[
21,251,226,146,200,11,130,138,155,157,236,48,63,46,246,17,218,229,132,149
],[
5,126,169,143,22,136,16,19,165,208,155,136,73,29,73,253,163,29,93,193
],[
158,160,189,45,244,4,152,197,245,240,75,128,132,70,134,99,98,82,170,84
],[
175,72,118,46,173,237,227,17,200,148,76,252,211,76,210,157,149,88,255,103
],[
132,223,170,230,208,229,26,79,163,122,110,92,168,49,59,86,202,212,120,115
],[
62,86,151,99,195,9,245,38,40,17,116,32,15,25,102,111,242,69,174,124
],[
99,103,33,208,152,117,51,42,38,59,207,206,13,77,134,31,245,64,236,112
],[
183,25,63,24,31,6,74,196,241,76,137,18,41,129,142,91,135,251,163,207
]
]