aLevelData = [
[
6,2,8,2,9,2,10,2,11,3,2,2,5,173,113,58,16,170,121,101
],[
2,2,2,2,2,2,2,2,12,3,5,2,2,6,169,30,217,201,69,217
],[
2,2,3,3,3,3,3,3,3,3,2,2,3,53,76,54,215,4,189,129
],[
2,2,3,2,2,2,2,2,2,2,5,2,3,90,147,11,236,93,0,166
],[
2,2,3,2,2,2,2,2,2,2,2,2,3,181,119,148,134,131,1,82
],[
2,2,3,2,3,3,3,3,3,3,2,5,3,110,157,123,208,114,90,44
],[
2,2,3,2,2,2,2,5,5,3,2,2,3,70,183,217,9,229,122,241
],[
2,2,3,5,5,5,2,3,3,3,5,2,3,216,106,83,107,149,242,187
],[
2,2,2,2,2,2,2,2,2,2,2,2,5,111,21,16,205,61,233,29
],[
2,3,2,2,3,1,3,2,2,2,2,2,5,73,30,133,207,222,153,162
],[
2,3,2,2,3,2,3,2,2,2,2,5,5,13,169,233,224,2,249,175
],[
2,3,2,3,2,2,2,3,2,2,2,2,5,176,113,85,229,113,72,192
],[
2,3,2,3,2,2,2,3,3,3,2,2,3,19,217,119,59,197,151,2
],[
2,3,2,3,2,2,2,3,2,2,5,2,5,140,60,54,85,62,100,69
],[
2,3,2,3,2,2,3,3,2,2,2,2,5,217,233,6,181,196,179,63
],[
2,3,2,3,2,2,3,3,2,2,2,5,5,130,53,23,49,150,128,229
],[
2,3,2,3,2,2,3,3,2,2,2,2,5,248,234,198,138,223,238,202
],[
146,212,43,255,107,26,38,230,108,62,136,150,21,76,125,156,153,66,90,6
],[
153,197,130,187,51,19,138,14,59,57,155,146,200,134,24,47,243,63,129,117
],[
219,148,152,49,237,211,194,62,98,220,175,158,8,213,61,201,70,31,154,69
]
]