aLevelData = [
[
2,2,2,2,2,2,64,129,110,13,173,65,93,245,26,208,106,217,132,139
],[
2,2,2,2,2,2,147,150,237,186,12,90,81,183,214,244,219,83,147,78
],[
2,2,2,2,2,2,89,117,153,55,238,4,69,102,6,7,145,188,143,11
],[
2,2,2,13,2,2,233,202,103,197,59,147,16,249,78,147,171,155,84,0
],[
2,2,2,2,2,2,36,51,194,79,170,134,95,250,98,114,155,129,92,26
],[
2,2,2,2,2,2,35,175,198,67,178,30,95,254,42,253,47,136,227,17
],[
118,110,67,250,226,244,143,184,4,184,0,109,5,147,26,100,149,192,57,83
],[
37,64,109,221,86,124,135,91,177,45,116,220,152,121,202,106,124,94,161,144
],[
81,84,164,25,63,46,104,25,155,66,252,50,21,201,193,16,51,137,123,54
],[
254,177,169,253,251,4,18,217,92,57,161,223,120,162,114,132,121,13,45,168
],[
84,232,147,211,255,168,86,190,222,107,46,21,126,219,41,123,133,86,67,207
],[
233,77,54,173,97,234,147,56,25,246,18,23,170,249,38,190,73,163,213,239
],[
62,106,199,128,153,117,157,94,32,185,132,210,139,98,9,3,244,116,47,189
],[
137,178,190,112,132,191,223,124,93,131,230,171,61,208,111,255,183,69,172,175
],[
179,115,253,108,170,63,193,232,25,135,109,153,47,9,219,187,201,128,228,148
],[
161,15,48,251,194,227,77,27,64,21,255,117,37,205,215,36,174,173,7,101
],[
184,109,117,86,117,194,14,254,99,133,93,142,127,17,92,230,182,237,138,91
],[
156,171,61,184,96,15,58,130,0,116,131,129,185,108,112,123,194,167,1,67
],[
57,22,115,243,94,79,17,117,255,52,77,72,51,207,15,128,75,129,77,15
],[
6,92,220,68,4,205,134,145,125,126,92,145,51,122,77,73,165,147,248,175
]
]