aLevelData = [
[
2,16,133,173,139,29,82,165,206,27,74,46,26,184,42,165,176,71,205,7
],[
2,231,206,243,166,22,90,66,33,180,150,138,146,190,156,77,9,89,11,127
],[
3,58,185,90,138,114,65,108,149,208,236,100,6,177,235,186,69,108,144,143
],[
2,195,64,106,61,60,138,178,51,57,59,229,0,216,138,179,173,207,230,24
],[
3,80,175,47,201,222,102,37,209,65,8,33,124,170,207,3,116,41,96,107
],[
2,42,123,79,44,119,35,230,253,132,188,34,114,231,141,255,43,14,94,245
],[
3,76,225,138,195,44,163,86,107,82,25,129,126,157,239,28,153,194,87,156
],[
2,48,252,243,46,138,254,245,74,13,45,133,139,188,12,99,190,254,247,205
],[
2,57,161,21,163,110,30,136,201,191,31,230,205,148,62,237,201,171,16,114
],[
2,139,176,98,155,244,14,194,78,158,4,66,233,193,251,120,52,88,23,201
],[
3,148,127,12,232,129,32,51,153,57,206,221,187,182,241,231,133,222,36,142
],[
8,16,251,219,133,21,106,73,69,249,151,129,165,6,41,219,170,252,121,153
],[
160,200,73,202,105,147,179,111,22,254,95,221,180,172,249,98,104,2,226,43
],[
191,42,38,101,63,94,175,163,66,99,184,128,4,83,132,133,250,160,79,77
],[
101,86,133,230,40,160,50,123,214,142,185,48,16,21,202,78,14,88,142,160
],[
123,37,36,29,134,195,81,198,54,235,115,210,253,20,183,9,145,244,140,110
],[
247,67,88,32,224,194,105,130,57,124,46,154,254,75,167,183,79,159,26,87
],[
197,123,8,71,6,192,95,12,151,174,241,130,242,168,37,195,217,55,236,74
],[
233,82,247,89,114,221,40,151,134,111,70,254,80,88,244,244,167,227,228,184
],[
227,216,72,0,240,69,137,225,161,126,60,238,70,99,82,164,128,225,142,6
]
]