aLevelData = [
[
4,2,5,5,2,2,2,2,2,2,2,2,239,88,38,139,25,172,239,32
],[
2,2,2,2,2,2,5,2,2,2,5,2,208,98,120,197,103,82,199,182
],[
2,2,2,2,2,2,3,3,3,3,3,3,53,73,10,191,231,8,134,92
],[
3,3,3,3,3,3,3,2,2,2,2,2,26,143,209,31,42,155,65,82
],[
2,2,3,2,2,2,2,2,2,2,2,2,68,109,164,222,195,205,49,107
],[
13,2,3,2,2,2,2,2,2,3,2,2,185,79,191,201,203,213,53,142
],[
2,5,3,2,2,2,2,2,2,3,2,2,67,85,66,1,96,220,78,55
],[
2,12,3,2,2,2,2,2,2,3,2,2,240,211,176,124,33,130,33,245
],[
5,2,3,3,3,3,3,3,3,3,2,2,149,210,112,131,180,87,120,233
],[
11,2,3,2,2,2,2,2,2,2,2,2,70,141,80,50,65,98,193,77
],[
2,5,3,2,2,2,2,2,2,2,2,2,223,245,253,251,244,158,141,235
],[
2,10,3,2,2,2,2,2,2,2,2,2,127,46,140,34,127,120,19,161
],[
5,2,2,2,2,2,2,2,2,2,2,2,8,16,244,66,149,82,171,228
],[
2,2,2,2,2,2,2,2,2,2,2,2,160,166,145,199,112,3,83,57
],[
9,5,3,2,2,2,2,2,2,2,2,2,51,178,163,115,76,85,45,190
],[
2,2,3,2,2,2,2,2,3,3,3,3,238,39,205,218,234,133,255,159
],[
5,8,3,2,2,2,2,2,3,2,2,2,197,174,151,229,14,199,178,162
],[
2,2,3,2,2,2,2,2,5,2,1,2,238,34,236,82,1,191,211,156
],[
6,5,3,3,3,3,3,3,3,2,2,2,100,19,156,50,16,9,21,249
],[
2,2,2,2,2,2,2,2,2,2,2,2,102,71,219,106,10,178,205,56
]
]