aLevelData = [
[
2,2,2,2,2,108,153,105,38,212,199,231,203,198,142,255,127,244,99,155
],[
2,3,5,3,5,148,58,74,7,56,219,0,82,73,14,121,248,106,185,141
],[
2,3,2,3,2,189,86,124,238,220,116,241,93,97,172,50,29,212,122,156
],[
2,2,2,2,2,168,23,64,211,162,145,225,6,11,141,139,117,184,220,212
],[
2,3,5,3,5,48,4,194,9,33,195,16,194,76,119,141,186,86,199,154
],[
2,3,5,3,5,222,68,44,22,164,134,238,128,158,52,79,91,79,151,5
],[
2,5,5,5,5,215,61,235,238,173,71,99,0,75,57,110,127,49,158,57
],[
2,3,5,3,5,114,155,214,117,87,96,104,90,22,26,153,236,52,135,61
],[
2,3,5,3,5,125,73,47,205,115,180,71,186,75,141,214,1,222,219,22
],[
2,5,5,5,5,0,227,7,29,135,182,145,188,51,88,2,168,247,182,34
],[
2,3,5,3,2,215,252,46,106,45,171,79,188,88,8,224,82,249,65,36
],[
5,3,5,3,2,245,4,134,93,111,105,28,143,66,244,173,134,154,113,227
],[
5,5,5,5,5,26,129,21,53,178,82,25,0,7,112,168,217,43,55,251
],[
5,3,5,3,5,34,201,51,195,219,174,144,199,187,136,210,206,127,238,199
],[
191,131,161,185,7,143,18,231,59,243,36,55,254,214,50,37,38,203,84,255
],[
26,165,222,84,126,141,42,170,19,81,152,111,216,255,210,50,118,179,85,19
],[
218,173,45,120,36,166,255,2,192,100,77,192,210,141,246,162,216,185,252,48
],[
139,202,138,123,5,128,54,84,41,72,131,189,64,85,170,157,224,242,154,184
],[
18,23,61,221,179,58,253,97,27,103,135,205,253,147,206,212,142,46,83,136
],[
234,247,165,205,179,20,35,13,251,98,9,45,100,10,171,192,133,85,251,123
]
]