aLevelData = [
[
4,2,5,5,2,2,2,2,2,2,2,2,2,2,2,2,2,2,2,114
],[
2,2,2,2,2,2,5,2,2,2,5,2,2,2,5,3,3,3,3,136
],[
2,2,2,2,2,2,3,3,3,3,3,3,3,2,2,2,2,5,2,22
],[
3,3,3,3,3,3,3,2,2,2,2,2,3,2,2,2,2,5,2,40
],[
2,2,3,2,2,2,2,2,2,2,2,2,3,2,2,2,2,3,2,49
],[
13,2,3,2,2,2,2,2,2,3,2,2,3,2,2,2,2,3,2,13
],[
2,5,3,2,2,2,2,2,2,3,2,2,3,2,2,2,2,3,2,134
],[
2,12,3,2,2,2,2,2,2,3,2,2,3,2,2,2,2,3,2,35
],[
5,2,3,3,3,3,3,3,3,3,2,2,3,3,3,3,3,3,2,162
],[
11,2,3,2,2,2,2,2,2,2,2,2,2,2,2,2,2,5,2,207
],[
2,5,3,2,2,2,2,2,2,2,2,2,2,2,2,2,2,5,2,60
],[
71,163,200,161,106,128,160,8,166,185,105,143,175,6,140,70,99,153,3,148
],[
163,163,201,214,98,25,143,72,251,184,177,41,200,71,104,26,240,28,65,200
],[
128,225,206,202,190,152,155,205,186,221,99,238,37,107,132,103,102,226,177,110
],[
235,200,231,90,189,205,162,8,88,83,80,125,185,45,6,204,184,167,114,58
],[
152,199,17,161,221,211,161,18,93,19,218,190,154,216,89,23,79,190,221,50
],[
73,45,181,112,120,38,121,93,70,60,249,216,39,224,115,117,114,226,9,31
],[
111,53,113,2,177,243,239,168,166,160,128,97,108,179,88,233,230,82,143,69
],[
16,94,24,238,143,175,242,49,141,161,162,214,195,207,224,0,215,30,145,84
],[
233,254,245,93,105,236,34,47,43,59,177,75,189,21,183,195,248,189,247,159
]
]