aLevelData = [
[
10,2,60,215,223,115,36,121,48,22,175,179,43,107,33,81,186,194,84,79
],[
2,2,59,13,68,73,41,241,210,51,248,29,193,74,64,219,5,74,30,228
],[
2,2,61,226,216,121,126,101,191,175,82,194,90,11,0,182,192,78,14,64
],[
9,2,70,146,5,86,90,150,116,214,175,87,55,191,155,224,249,161,189,98
],[
3,3,248,82,226,135,8,227,41,4,219,210,102,110,127,129,197,78,40,231
],[
2,2,176,119,48,134,242,151,92,157,28,13,97,158,39,250,167,226,92,155
],[
2,2,76,156,113,214,108,12,245,18,160,245,238,76,196,80,192,103,254,66
],[
2,2,80,196,251,76,106,19,124,194,96,105,18,126,244,146,37,213,120,168
],[
2,2,59,202,52,228,119,130,8,181,96,248,83,15,229,242,19,6,157,52
],[
2,2,77,155,83,243,175,214,193,140,116,21,156,118,136,163,209,117,236,140
],[
2,2,15,17,93,176,133,71,48,23,237,126,129,132,201,189,140,77,236,26
],[
2,2,91,105,61,118,162,203,184,103,231,238,181,118,229,178,109,139,51,102
],[
2,2,186,165,33,38,30,206,227,103,7,79,241,208,81,32,173,76,13,162
],[
70,93,129,144,221,179,111,51,231,253,155,214,211,255,135,122,236,228,129,203
],[
128,214,223,82,66,205,138,235,237,164,185,122,42,114,255,218,180,23,136,22
],[
186,21,160,220,133,162,116,46,90,251,29,91,162,250,218,46,72,235,157,101
],[
99,156,202,100,21,179,59,43,178,68,135,134,37,163,132,131,144,119,10,41
],[
51,16,250,103,143,251,127,75,203,211,148,117,86,89,199,202,206,199,60,109
],[
33,98,244,235,242,79,79,181,62,167,208,212,63,206,33,216,144,0,87,17
],[
147,44,118,2,16,6,56,19,30,88,10,134,71,152,88,172,231,192,10,89
]
]