aLevelData = [
[
10,65,145,79,123,114,7,10,41,3,192,221,252,235,37,152,78,172,1,234
],[
2,228,133,229,49,115,232,203,145,99,46,249,67,210,138,40,48,220,59,230
],[
2,191,26,6,57,235,104,228,133,152,236,248,175,39,84,195,131,72,94,155
],[
9,83,15,158,89,225,75,124,83,128,19,124,138,117,161,194,36,163,100,213
],[
28,104,80,163,56,194,121,197,59,182,224,5,92,242,140,29,248,177,221,194
],[
132,223,30,225,197,125,89,41,67,72,111,201,251,149,103,123,84,128,7,193
],[
84,69,161,110,20,238,48,105,113,47,164,174,5,142,121,149,86,198,142,87
],[
76,110,53,206,233,214,134,124,52,50,250,207,118,250,53,163,169,144,34,9
],[
46,36,69,71,190,213,77,32,163,24,233,85,40,94,221,107,78,241,85,175
],[
192,31,121,120,9,155,65,172,5,32,139,133,149,87,107,149,151,251,194,8
],[
22,59,18,42,189,96,144,41,146,175,123,27,225,145,173,66,117,241,112,143
],[
14,230,146,102,16,146,188,161,121,74,255,215,21,246,176,222,245,187,118,142
],[
29,216,161,200,125,206,189,183,35,196,103,86,174,41,96,51,6,155,224,114
],[
74,8,45,20,10,19,107,122,183,185,182,36,87,52,110,191,125,31,210,95
],[
121,220,209,9,204,51,28,116,223,59,128,16,244,126,115,72,92,88,237,4
],[
234,160,121,115,169,138,139,7,202,204,20,193,224,0,84,174,80,74,239,178
],[
2,58,68,132,93,244,250,250,115,142,219,135,120,185,230,2,121,164,159,168
],[
74,29,170,101,193,250,152,79,33,183,1,115,217,96,211,213,111,177,233,178
],[
183,125,224,8,72,76,38,89,48,72,83,171,231,90,189,211,130,144,70,243
],[
41,194,121,66,203,117,214,11,16,255,105,249,144,236,162,145,66,161,96,0
]
]