aLevelData = [
[
5,5,3,5,5,5,89,132,96,163,136,56,186,113,198,203,92,185,160,98
],[
4,2,3,5,5,5,104,102,106,212,229,175,141,178,183,60,33,133,206,138
],[
2,2,3,2,3,3,191,86,157,144,144,116,206,163,170,113,52,151,157,110
],[
5,2,2,2,3,2,1,39,72,152,57,150,242,243,102,151,150,87,142,107
],[
2,2,2,3,2,2,125,184,98,73,18,170,184,2,243,35,59,229,68,131
],[
2,2,2,3,2,2,97,224,72,211,158,233,50,74,216,156,56,22,26,38
],[
2,2,2,2,2,2,234,89,140,97,194,113,163,64,252,124,149,110,167,27
],[
5,2,2,2,2,2,16,50,253,119,43,150,240,130,157,200,5,128,44,192
],[
2,2,5,5,3,2,101,197,105,35,50,192,155,104,23,56,249,57,35,214
],[
2,2,5,5,3,2,28,28,215,228,179,82,125,84,121,255,188,4,100,140
],[
2,2,3,3,3,2,106,64,31,74,161,137,187,88,21,148,162,198,164,150
],[
2,2,3,2,2,2,204,250,47,191,53,83,169,4,142,13,109,34,50,101
],[
2,2,3,2,2,2,213,224,93,253,8,148,152,129,19,232,120,139,60,222
],[
136,196,146,18,132,77,201,64,200,93,69,5,7,43,117,234,64,14,98,158
],[
238,226,136,131,128,175,228,108,8,133,78,166,55,170,9,53,137,248,153,95
],[
189,128,212,111,136,115,60,179,138,67,140,199,129,5,145,21,189,26,59,157
],[
212,14,244,242,150,192,48,133,67,195,70,38,252,5,126,200,120,174,107,133
],[
248,75,123,226,125,44,204,83,56,10,65,2,66,238,214,204,141,77,48,140
],[
27,120,121,157,109,52,106,154,63,164,169,104,114,112,86,119,74,32,224,68
],[
217,201,30,35,187,236,155,59,4,155,49,210,119,221,217,203,249,84,193,108
]
]