aLevelData = [
[
6,204,212,129,224,127,157,195,127,178,17,127,69,179,90,4,214,226,100,94
],[
2,154,90,239,32,110,212,227,97,153,201,227,5,1,215,36,62,159,102,128
],[
2,81,48,139,198,158,45,45,85,219,254,102,233,160,107,43,180,40,83,48
],[
3,177,86,160,6,53,246,122,134,199,70,187,115,49,180,163,91,215,234,206
],[
2,190,72,8,98,115,19,48,141,70,220,72,47,230,174,251,211,255,147,1
],[
2,228,163,98,161,30,238,217,116,66,234,235,107,14,176,91,19,108,208,138
],[
2,24,234,243,142,9,106,191,131,90,26,251,38,175,167,244,160,88,174,31
],[
2,159,23,116,255,171,42,214,73,184,133,131,71,247,96,104,122,242,241,108
],[
131,216,123,94,68,21,135,43,66,38,113,85,77,172,39,160,100,191,46,15
],[
211,132,230,14,158,2,14,241,34,49,138,157,250,84,100,133,32,137,18,217
],[
84,159,247,249,194,39,44,48,223,206,127,159,148,234,188,119,158,82,44,108
],[
53,115,92,102,235,160,31,121,216,170,214,23,244,177,239,132,196,57,172,139
],[
57,128,38,112,213,16,145,37,15,144,193,192,249,223,237,45,32,100,180,32
],[
179,159,93,78,232,4,99,221,156,10,49,25,58,127,42,104,221,30,236,128
],[
185,99,214,215,183,158,200,91,95,71,41,100,251,145,47,231,249,65,90,236
],[
146,193,66,66,169,112,147,113,246,61,86,240,99,116,114,152,182,215,114,89
],[
113,241,136,44,246,167,210,72,239,16,221,153,237,135,104,110,79,254,106,114
],[
102,149,86,221,215,107,157,235,64,179,116,142,30,11,217,95,238,10,208,219
],[
146,24,243,204,247,131,41,5,245,207,182,82,118,77,116,175,219,239,95,184
],[
155,90,87,97,45,61,34,231,41,225,177,7,170,2,164,109,246,222,16,111
]
]