aLevelData = [
[
2,2,2,2,2,2,2,2,2,2,2,2,2,49,7,201,100,217,219,37
],[
2,2,2,2,2,2,2,2,3,3,3,3,3,2,45,152,2,113,13,175
],[
2,2,3,2,3,2,2,2,2,3,2,2,2,217,214,93,131,84,199,171
],[
2,2,3,2,3,2,2,2,2,2,3,2,2,122,13,0,17,83,153,87
],[
2,2,3,2,3,2,2,2,2,2,2,3,2,93,186,197,242,112,25,31
],[
2,2,3,2,2,2,2,2,2,2,2,2,3,183,228,178,185,4,242,235
],[
2,2,3,2,3,3,3,3,3,3,3,3,3,41,160,146,232,212,242,227
],[
2,2,3,2,2,2,2,2,2,2,2,2,2,95,109,113,206,168,184,92
],[
2,2,3,2,3,3,3,3,3,3,3,3,3,230,20,148,171,147,128,56
],[
69,112,42,189,115,241,195,221,149,73,197,250,20,139,6,97,151,15,142,209
],[
122,23,165,55,124,178,49,188,183,225,63,1,214,249,224,169,130,72,54,25
],[
29,251,206,123,179,63,48,9,45,167,181,136,200,206,153,18,198,61,81,25
],[
100,143,31,169,11,211,227,237,202,49,52,245,4,209,175,182,102,248,143,83
],[
28,116,127,155,69,59,172,210,164,79,29,180,152,228,71,183,78,197,220,145
],[
53,244,229,250,178,144,16,179,22,252,75,199,205,62,145,17,215,165,4,254
],[
125,175,61,148,60,41,224,179,6,152,115,155,170,216,112,175,144,3,152,121
],[
169,149,139,237,166,205,150,242,104,86,204,30,184,38,88,193,57,167,17,38
],[
154,20,79,21,16,38,253,156,4,241,240,16,9,8,119,78,16,232,52,70
],[
223,148,42,187,191,124,22,68,117,163,3,151,116,1,25,6,81,39,182,74
],[
119,33,192,128,28,160,57,113,116,89,19,22,36,168,70,92,249,121,33,36
]
]