aLevelData = [
[
2,2,2,2,2,2,2,2,2,2,2,2,8,81,24,20,155,66,138,47
],[
2,2,13,5,5,2,2,12,5,5,2,3,52,244,56,20,251,130,36,202
],[
2,2,2,5,5,2,2,2,5,5,2,3,167,88,91,62,65,231,213,149
],[
2,2,2,2,2,2,2,2,2,2,2,3,42,158,157,193,95,21,49,82
],[
2,2,2,2,2,2,2,2,2,2,2,3,252,139,44,143,255,146,34,198
],[
2,2,2,2,2,2,2,2,2,2,2,2,79,9,204,224,253,75,101,56
],[
2,2,2,2,2,2,2,2,2,2,2,2,201,166,83,174,232,15,10,247
],[
2,2,2,2,2,2,2,2,2,2,2,2,4,19,46,55,133,17,247,209
],[
2,2,2,2,2,2,2,2,2,2,3,2,15,167,218,125,75,106,102,156
],[
2,2,2,2,2,2,2,2,2,3,3,2,235,218,108,201,232,149,98,177
],[
2,2,2,2,2,2,2,2,3,3,2,9,14,202,9,36,187,241,78,108
],[
228,185,110,221,88,66,94,173,73,141,106,6,8,49,28,90,16,79,95,247
],[
70,199,228,219,127,172,197,201,67,246,105,156,209,119,167,220,98,17,46,143
],[
178,37,36,81,189,78,13,167,198,80,239,145,158,75,179,94,35,53,207,196
],[
7,134,34,48,211,53,31,91,43,228,46,30,83,88,79,135,242,43,1,44
],[
22,197,98,191,121,136,151,227,3,75,110,62,143,10,66,208,242,219,32,131
],[
57,36,39,3,51,12,53,207,48,47,192,145,7,150,1,171,94,230,88,18
],[
37,215,236,95,100,232,146,35,55,82,240,123,22,58,226,229,90,42,28,82
],[
253,194,17,125,162,171,20,122,213,205,189,146,147,194,143,78,13,138,215,210
],[
169,128,215,108,74,140,36,109,209,155,77,56,228,76,189,152,238,236,227,87
]
]