aLevelData = [
[
12,2,2,2,179,90,176,195,121,251,57,36,162,217,208,11,38,226,59,120
],[
2,2,2,2,21,175,61,111,116,10,14,158,71,173,8,64,239,77,163,65
],[
2,2,3,3,182,215,163,163,169,250,144,32,166,229,103,17,181,82,143,142
],[
11,2,3,2,155,195,14,215,173,11,253,242,227,17,57,150,45,209,92,72
],[
2,2,3,2,10,163,236,196,86,192,210,158,99,2,13,41,76,235,167,152
],[
2,2,3,2,134,233,232,99,184,216,203,237,205,201,174,99,71,2,77,231
],[
10,2,3,2,214,70,241,238,41,86,229,230,4,183,42,29,147,182,107,222
],[
2,2,3,2,254,170,51,221,61,121,94,212,46,93,206,111,228,232,95,102
],[
2,2,3,2,66,70,28,232,201,195,179,64,175,140,38,179,49,186,196,167
],[
42,140,88,11,227,244,160,242,45,86,0,129,173,140,120,12,120,45,212,124
],[
224,15,34,244,141,10,105,180,207,255,152,61,50,25,189,181,83,83,119,142
],[
243,59,174,99,74,245,129,34,157,130,128,112,19,67,28,73,197,184,91,231
],[
20,142,209,230,63,217,203,165,53,158,205,239,167,148,63,219,98,43,99,240
],[
220,206,138,141,12,101,136,136,127,31,101,22,169,110,85,235,121,83,234,162
],[
48,219,137,94,114,234,27,178,157,55,4,190,91,152,89,155,115,128,77,250
],[
229,197,237,7,53,167,14,148,7,15,131,115,236,20,147,35,124,195,170,176
],[
165,32,78,212,66,104,85,98,239,153,85,228,28,52,93,131,97,66,226,40
],[
17,149,252,225,18,80,211,134,236,170,83,156,31,238,40,121,186,198,230,169
],[
41,186,135,145,79,244,27,82,213,70,187,241,193,110,191,180,74,152,49,207
],[
234,36,129,63,182,170,121,247,235,59,116,58,201,234,203,72,164,139,145,60
]
]