aLevelData = [
[
2,2,2,2,2,2,2,2,2,2,2,2,2,2,2,2,2,2,12,46
],[
2,2,2,2,2,2,2,2,2,2,2,2,2,2,2,2,2,2,182,195
],[
2,2,2,2,2,2,2,2,2,2,2,2,2,2,2,2,2,4,95,49
],[
2,2,2,13,2,2,2,2,2,2,2,2,2,2,2,2,2,2,249,83
],[
2,2,2,2,2,2,2,2,2,2,2,2,2,2,2,2,2,2,224,91
],[
2,2,2,2,2,2,2,2,2,2,2,2,2,2,2,2,2,2,183,174
],[
2,2,2,2,2,2,2,2,2,2,2,2,2,2,2,2,2,2,85,170
],[
2,2,2,2,2,2,2,2,2,1,2,2,2,2,2,2,2,2,0,110
],[
2,2,11,2,2,2,2,2,2,2,2,2,2,2,2,2,2,2,130,35
],[
2,2,2,2,2,2,2,2,2,2,2,2,2,2,2,2,2,2,217,90
],[
2,2,2,2,2,2,2,2,2,2,2,2,2,2,2,2,2,2,156,116
],[
2,2,2,2,2,2,2,2,2,2,2,2,2,2,2,2,2,2,70,48
],[
0,216,168,162,37,59,73,158,207,159,54,210,134,190,77,112,71,240,150,46
],[
121,80,215,146,34,26,98,108,91,88,50,164,2,190,54,53,174,210,237,122
],[
232,80,51,169,152,204,91,157,189,153,125,216,97,234,17,200,205,55,189,73
],[
249,226,108,108,70,27,160,118,111,1,9,44,189,9,86,78,123,164,75,98
],[
170,28,20,178,246,191,217,152,232,64,146,249,92,90,29,16,54,182,141,109
],[
81,15,198,61,184,148,71,203,25,142,70,71,118,66,2,199,30,25,85,139
],[
220,254,136,133,110,8,108,24,56,89,166,33,58,70,75,52,64,184,173,40
],[
88,209,116,213,137,211,240,28,194,62,173,40,17,57,72,244,21,51,130,13
]
]