aLevelData = [
[
2,2,2,2,2,2,2,2,2,2,2,2,2,2,2,2,2,2,29,90
],[
2,2,2,2,2,2,2,2,2,2,2,2,2,2,2,2,2,2,233,153
],[
2,2,2,2,2,2,2,2,2,2,2,2,2,2,2,2,2,4,230,151
],[
2,2,2,13,2,2,2,2,2,2,2,2,2,2,2,2,2,2,171,43
],[
2,2,2,2,2,2,2,2,2,2,2,2,2,2,2,2,2,2,228,184
],[
2,2,2,2,2,2,2,2,2,2,2,2,2,2,2,2,2,2,47,36
],[
2,2,2,2,2,2,2,2,2,2,2,2,2,2,2,2,2,2,169,155
],[
2,2,2,2,2,2,2,2,2,1,2,2,2,2,2,2,2,2,48,100
],[
2,2,11,2,2,2,2,2,2,2,2,2,2,2,2,2,2,2,97,75
],[
2,2,2,2,2,2,2,2,2,2,2,2,2,2,2,2,2,2,221,109
],[
2,2,2,2,2,2,2,2,2,2,2,2,2,2,2,2,2,2,88,115
],[
2,2,2,2,2,2,2,2,2,2,2,2,2,2,2,2,2,2,126,117
],[
2,2,2,2,2,2,2,2,2,2,2,2,2,2,2,2,2,10,188,25
],[
2,2,2,2,2,2,2,2,2,2,2,2,2,2,2,2,2,2,91,185
],[
2,9,2,2,2,2,2,2,2,2,2,2,2,2,2,2,2,2,163,136
],[
2,2,2,2,2,2,2,2,2,2,2,2,2,2,2,12,2,2,217,19
],[
2,2,2,2,2,2,2,2,2,2,2,2,2,2,2,2,2,2,79,142
],[
2,2,2,6,2,2,2,2,2,2,2,2,2,2,2,2,2,2,231,207
],[
2,2,2,2,2,2,2,2,2,2,2,2,2,2,2,2,2,2,177,232
],[
152,187,45,251,17,125,157,197,166,41,152,18,64,19,244,243,2,226,137,108
]
]