aLevelData = [
[
6,2,2,2,2,2,2,2,2,2,2,2,2,35,227,56,172,100,176,100
],[
2,2,2,2,2,2,2,2,2,2,2,2,2,176,4,21,169,199,79,188
],[
89,7,218,120,75,0,197,123,57,145,62,201,103,1,70,236,133,74,184,233
],[
215,184,135,116,147,179,71,96,139,217,239,89,11,81,221,213,5,91,26,72
],[
107,43,224,151,221,247,89,208,132,79,170,24,62,173,48,229,251,77,9,109
],[
103,62,215,94,201,186,192,207,42,179,186,118,187,174,5,28,113,212,248,79
],[
242,70,1,87,180,178,232,107,99,36,83,36,132,30,143,49,89,234,141,77
],[
4,47,43,110,238,195,181,63,106,192,172,209,150,218,198,141,130,239,53,110
],[
149,224,44,109,44,160,160,60,131,138,76,54,217,248,247,151,207,17,249,232
],[
18,226,252,190,57,177,0,164,241,141,162,86,87,42,157,48,165,236,145,229
],[
17,66,3,116,242,53,165,88,37,65,216,255,175,99,112,126,163,115,183,131
],[
71,180,180,139,114,170,173,85,56,43,234,150,201,185,188,238,151,15,190,27
],[
183,250,91,109,138,106,144,121,156,201,243,18,204,139,245,117,174,7,100,196
],[
45,133,52,182,117,152,126,140,16,174,201,71,78,229,137,24,235,32,229,24
],[
236,91,189,57,202,59,236,124,210,233,202,101,204,33,245,173,219,134,82,54
],[
164,57,78,68,178,169,106,233,25,173,246,193,90,208,28,224,135,235,33,9
],[
168,250,232,32,92,40,184,226,196,44,62,212,156,216,214,121,171,239,6,200
],[
94,56,75,221,176,208,25,239,76,196,29,130,246,223,197,222,39,193,2,191
],[
247,49,77,78,64,181,232,80,1,95,102,158,0,233,109,213,180,5,187,78
],[
97,238,103,81,133,67,105,133,115,21,93,171,62,63,132,140,216,245,12,48
]
]