aLevelData = [
[
6,174,97,226,198,87,157,207,91,189,50,240,147,133,203,153,126,79,17,27
],[
2,62,128,102,160,96,69,214,86,109,213,74,208,187,246,255,169,137,194,55
],[
2,106,75,171,47,173,67,189,80,131,81,35,169,20,12,237,157,133,17,16
],[
217,31,156,174,138,173,85,152,204,37,108,18,101,139,231,214,179,19,59,91
],[
227,134,26,86,100,230,141,130,155,85,66,156,217,51,39,178,138,135,56,158
],[
175,160,148,206,142,252,215,70,167,104,164,231,235,105,129,241,41,219,232,199
],[
201,216,154,242,188,219,55,105,179,37,12,15,143,96,44,126,25,131,194,3
],[
244,245,165,233,208,245,45,251,223,57,70,68,141,213,194,25,108,95,244,90
],[
109,81,122,244,86,174,90,170,112,233,81,22,128,2,103,234,249,242,199,124
],[
112,73,206,130,80,22,98,25,207,7,133,13,33,209,41,84,235,210,70,219
],[
250,245,43,134,53,215,18,114,208,40,246,125,195,83,169,8,123,97,33,251
],[
207,26,18,10,53,110,195,55,54,20,26,152,31,113,248,91,250,187,205,7
],[
188,94,99,4,192,159,254,94,116,127,167,198,83,226,197,218,19,240,237,166
],[
31,188,251,106,71,35,98,157,182,248,192,51,37,94,182,28,79,116,246,13
],[
165,56,157,130,66,165,196,4,33,31,81,167,142,17,19,216,218,213,15,85
],[
83,212,20,125,115,238,150,202,88,28,185,156,116,83,171,56,134,172,55,16
],[
201,195,151,69,107,92,138,106,64,77,167,139,184,152,241,109,15,215,171,24
],[
195,221,110,147,75,154,120,239,6,63,71,134,114,163,103,133,158,229,136,168
],[
226,84,211,69,205,139,126,140,95,224,158,13,120,0,61,123,145,211,173,175
],[
170,166,27,239,131,136,103,113,15,244,52,27,38,177,59,141,122,247,228,97
]
]