aLevelData = [
[
2,2,219,39,61,249,249,208,116,250,64,88,4,18,225,253,196,14,132,147
],[
2,2,194,11,222,204,128,222,134,182,93,179,4,133,81,243,43,147,221,108
],[
5,2,170,165,66,172,221,112,242,173,233,92,68,184,7,135,107,131,32,13
],[
5,2,169,157,155,135,192,11,115,209,170,52,140,17,137,250,71,244,225,42
],[
5,5,84,59,5,22,199,119,207,128,110,16,148,186,98,140,87,12,221,14
],[
5,2,61,86,75,29,65,246,164,167,41,236,248,70,185,60,76,193,38,148
],[
5,2,164,214,206,47,97,55,37,249,205,210,243,244,245,85,189,218,183,242
],[
2,2,128,4,27,96,166,138,231,34,50,172,109,11,62,113,168,2,167,141
],[
2,2,135,3,7,136,137,102,227,29,138,100,38,225,221,215,206,37,154,65
],[
2,2,230,28,57,16,180,65,96,32,51,243,250,130,196,98,137,124,32,175
],[
2,2,189,208,145,79,69,65,98,177,229,84,147,32,201,84,210,234,25,152
],[
2,2,167,194,205,9,239,99,195,222,139,118,14,170,89,182,146,153,99,82
],[
2,2,206,246,87,146,248,241,56,190,79,160,82,60,173,67,115,248,91,204
],[
2,2,88,9,42,159,102,145,191,150,155,228,47,72,195,237,204,139,239,206
],[
2,2,62,55,35,199,213,45,79,89,29,152,128,171,179,115,88,44,88,76
],[
13,2,188,122,68,71,204,131,188,101,24,234,231,6,16,172,222,173,189,3
],[
2,2,2,4,175,138,146,32,55,162,125,5,214,21,116,109,244,250,68,197
],[
2,2,213,217,99,121,202,15,200,113,164,115,0,220,110,57,127,44,92,23
],[
2,2,52,97,254,167,96,139,185,13,167,138,120,217,104,25,159,47,74,11
],[
65,37,23,211,146,108,206,74,159,51,243,173,60,72,42,229,62,128,4,12
]
]