aLevelData = [
[
4,2,5,5,88,243,211,11,9,146,29,253,9,78,244,150,34,151,152,107
],[
2,2,2,2,163,82,236,31,179,218,111,135,229,68,110,13,13,232,120,82
],[
2,2,2,2,81,28,19,24,131,67,173,94,174,7,213,204,238,226,171,82
],[
3,3,3,3,133,227,149,13,44,175,52,106,167,198,151,141,156,7,174,244
],[
165,119,1,87,164,62,161,211,87,242,95,72,44,24,61,0,86,232,34,145
],[
32,81,210,4,129,61,28,54,241,22,86,127,124,137,6,146,21,138,226,164
],[
44,152,251,209,131,66,53,187,61,234,250,116,56,201,47,158,156,51,103,208
],[
180,28,87,60,253,220,139,143,125,47,87,25,86,128,15,46,155,103,122,204
],[
98,112,133,125,27,30,53,127,32,47,223,35,141,34,155,115,81,247,246,23
],[
133,54,231,122,253,50,5,40,29,143,246,123,238,2,43,118,113,88,202,241
],[
52,186,236,246,34,47,9,108,159,98,176,242,213,166,124,14,72,55,67,135
],[
177,194,144,15,9,40,84,37,228,128,216,58,0,91,246,19,30,75,137,110
],[
16,166,34,232,20,135,253,30,96,22,51,19,254,9,48,210,218,107,104,84
],[
26,156,70,163,173,154,101,64,39,126,3,194,204,74,179,193,234,225,81,242
],[
109,87,59,147,173,107,190,10,138,82,207,201,187,183,252,116,99,255,162,70
],[
229,209,95,177,250,214,202,68,1,189,98,210,150,131,197,209,101,241,35,0
],[
64,102,241,77,112,214,226,245,73,19,19,237,2,75,133,129,195,210,209,59
],[
254,34,23,6,3,33,56,147,207,162,69,252,37,45,55,167,225,3,224,110
],[
136,93,33,252,35,245,94,122,78,199,47,108,140,25,88,213,221,185,252,162
],[
147,134,13,69,97,49,7,161,181,69,222,38,71,101,52,61,242,213,208,230
]
]