aLevelData = [
[
2,2,2,2,2,2,2,2,38,150,136,156,151,51,37,178,207,89,140,45
],[
2,2,2,2,2,2,2,2,139,223,12,178,42,184,159,229,17,197,109,219
],[
2,2,2,2,2,2,2,2,79,237,146,209,125,112,33,30,232,120,105,102
],[
2,2,2,3,3,3,3,3,243,242,119,17,182,155,220,251,235,94,176,109
],[
2,2,2,2,2,2,2,2,11,221,214,77,180,78,130,145,78,136,249,249
],[
2,2,2,2,2,2,2,2,238,93,152,254,122,43,24,6,15,174,16,217
],[
2,2,2,2,2,3,2,2,159,24,187,88,223,100,252,109,96,231,159,62
],[
2,2,2,3,3,3,3,3,251,40,226,166,115,241,52,229,86,166,60,150
],[
2,2,2,2,2,2,2,2,36,214,29,226,179,16,249,244,210,248,180,172
],[
2,2,2,2,2,2,2,2,45,153,250,152,113,253,131,32,176,251,149,0
],[
2,2,3,3,3,3,3,3,6,81,203,252,125,243,22,206,46,162,1,100
],[
2,2,2,2,2,2,2,2,169,191,57,72,151,98,76,96,158,167,177,215
],[
2,2,2,2,2,2,2,2,133,72,9,91,153,113,164,137,79,207,71,165
],[
2,2,3,3,3,3,3,3,42,235,44,143,223,182,75,242,184,100,216,191
],[
2,2,3,2,2,2,2,2,54,126,13,218,250,51,41,19,229,240,185,87
],[
2,2,3,2,2,2,2,2,127,48,22,39,149,148,47,74,39,54,136,191
],[
2,2,3,3,3,3,2,2,129,59,131,246,167,167,223,64,246,117,126,131
],[
9,232,107,50,218,28,27,124,41,224,243,196,34,200,11,82,58,125,50,72
],[
90,88,50,215,63,47,85,178,33,111,39,195,146,107,126,30,170,244,184,51
],[
97,42,68,71,60,145,100,37,44,104,48,16,179,54,223,253,72,165,66,255
]
]