aLevelData = [
[
4,2,2,2,2,2,2,2,2,2,8,2,2,2,2,3,2,136,176,50
],[
2,2,3,2,9,2,2,2,2,2,2,2,2,3,2,2,3,171,113,254
],[
2,3,2,2,2,2,3,2,2,3,2,3,2,2,3,2,2,108,210,194
],[
2,3,2,2,2,3,2,2,3,2,2,2,3,2,2,3,2,253,215,150
],[
2,3,2,2,3,2,2,3,2,2,2,2,2,3,2,2,3,167,250,30
],[
2,3,2,3,2,2,3,2,2,3,2,3,2,2,3,2,2,69,71,76
],[
2,2,3,2,2,3,2,2,3,2,2,2,3,2,2,3,2,204,146,157
],[
2,2,2,2,3,2,2,3,2,2,2,2,2,3,2,2,3,217,189,56
],[
2,2,2,3,2,2,3,2,2,3,2,3,2,2,3,5,2,131,220,210
],[
2,2,3,2,2,3,2,2,3,2,2,2,3,2,2,3,2,224,16,229
],[
2,2,5,2,3,2,2,3,2,2,2,2,2,3,5,2,3,233,69,36
],[
2,2,2,3,2,2,3,2,2,3,2,3,2,2,3,2,2,33,13,150
],[
2,2,3,2,5,3,2,2,3,2,2,2,3,5,2,3,2,65,219,233
],[
28,157,67,131,28,117,110,39,255,163,159,160,176,115,197,175,70,179,68,181
],[
227,9,248,179,219,138,119,116,25,135,151,9,191,170,49,118,13,66,36,171
],[
132,220,156,182,75,19,148,54,209,169,153,19,180,214,209,108,226,223,61,209
],[
254,235,59,179,5,19,79,24,49,184,34,147,29,25,203,116,43,36,78,60
],[
35,141,98,84,28,30,120,254,160,78,248,139,11,20,206,207,52,253,37,210
],[
79,125,114,200,18,130,181,67,23,79,252,168,130,136,40,223,227,137,243,79
],[
94,252,50,10,9,171,88,68,149,146,60,10,49,57,28,49,171,65,225,140
]
]