aLevelData = [
[
4,2,2,2,2,2,2,2,2,2,2,2,2,2,30,213,126,74,254,73
],[
5,2,5,3,2,2,2,2,2,2,2,2,2,2,30,178,51,168,80,109
],[
2,5,5,3,3,3,3,3,3,3,3,3,3,3,71,219,168,213,252,49
],[
3,3,5,5,5,5,5,5,5,5,3,2,2,2,133,222,72,87,53,167
],[
2,3,5,5,5,5,5,5,5,5,3,6,2,2,158,133,96,79,111,245
],[
3,3,5,5,5,5,3,3,3,3,3,3,3,3,163,10,241,153,123,116
],[
3,5,5,5,5,5,3,2,2,2,2,2,2,2,31,13,101,37,1,203
],[
3,5,5,3,3,3,3,8,2,2,2,5,5,5,67,133,45,158,2,225
],[
3,5,5,3,2,2,3,3,3,3,2,5,3,3,142,89,122,191,100,200
],[
3,5,5,3,2,2,2,2,2,3,2,5,3,5,149,111,140,231,180,227
],[
3,5,5,3,2,2,3,2,2,3,2,5,3,5,2,82,78,193,164,253
],[
5,5,5,3,2,2,3,2,2,3,2,5,3,5,218,181,56,37,240,12
],[
5,5,5,3,2,2,3,2,2,3,2,5,3,3,177,134,171,127,174,207
],[
5,3,3,3,2,2,3,2,2,3,2,5,2,2,81,76,68,83,54,140
],[
5,3,2,2,2,2,3,2,2,3,2,5,2,2,253,1,221,192,32,150
],[
5,3,3,2,2,2,3,2,5,5,5,5,2,2,97,173,51,17,19,106
],[
5,5,3,3,2,2,3,2,5,3,5,5,3,3,191,103,101,183,83,121
],[
5,5,5,5,3,3,3,2,5,3,5,5,2,2,7,144,203,67,79,2
],[
210,86,222,62,166,136,129,236,28,234,85,193,227,250,47,84,12,26,58,45
],[
202,65,226,31,119,241,241,217,216,105,248,183,162,27,241,222,61,96,34,135
]
]