aLevelData = [
[
4,2,5,5,2,2,2,2,246,8,35,81,245,108,12,143,145,221,48,5
],[
2,2,2,2,2,2,5,2,199,176,151,109,254,1,4,73,61,12,205,108
],[
2,2,2,2,2,2,3,3,154,219,233,189,246,34,75,56,231,103,110,53
],[
3,3,3,3,3,3,3,2,246,101,50,237,11,179,230,58,37,161,166,158
],[
2,2,3,2,2,2,2,2,78,99,231,135,207,113,80,209,160,45,204,141
],[
13,2,3,2,2,2,2,2,34,198,221,1,16,93,51,239,179,103,125,27
],[
2,5,3,2,2,2,2,2,86,83,127,7,250,108,100,1,75,0,86,95
],[
2,12,3,2,2,2,2,2,210,194,77,10,107,109,36,57,250,170,242,127
],[
5,2,3,3,3,3,3,3,90,52,151,8,150,58,149,32,92,5,34,244
],[
11,2,3,2,2,2,2,2,174,218,123,157,219,34,122,90,174,200,107,29
],[
2,5,3,2,2,2,2,2,229,227,28,74,228,149,51,187,171,50,196,7
],[
2,10,3,2,2,2,2,2,6,165,35,4,3,16,247,138,169,179,144,122
],[
5,2,2,2,2,2,2,2,231,15,123,255,203,75,83,20,245,214,217,71
],[
2,2,2,2,2,2,2,2,74,78,71,188,237,161,226,116,107,114,207,207
],[
53,190,39,80,84,191,78,161,88,16,128,215,145,19,172,246,130,144,134,184
],[
147,158,216,138,6,199,24,216,44,103,64,138,217,85,218,207,21,197,90,25
],[
20,109,177,105,105,231,31,204,118,87,73,37,39,77,139,46,224,237,143,186
],[
179,77,31,61,215,30,55,141,85,143,95,234,5,110,55,61,185,144,84,157
],[
184,116,74,23,110,35,10,175,97,90,111,162,103,235,19,238,23,97,103,20
],[
125,227,3,29,18,91,58,219,234,215,242,113,48,47,178,22,208,232,253,21
]
]