aLevelData = [
[
5,5,5,5,5,2,2,2,2,2,2,2,2,2,2,2,2,2,2,2
],[
5,2,2,2,2,2,2,2,2,2,2,2,2,2,2,2,2,2,2,2
],[
5,2,5,3,3,3,3,3,3,3,2,2,3,3,3,3,3,3,2,2
],[
2,2,5,2,3,2,2,2,2,2,2,2,3,2,2,2,2,3,2,2
],[
2,2,3,2,3,2,2,2,2,2,2,2,3,2,2,2,2,3,3,3
],[
2,2,3,2,3,3,3,3,3,3,2,2,3,5,5,5,5,5,5,5
],[
4,2,3,2,2,2,2,2,2,3,2,2,3,2,2,2,2,2,2,1
],[
2,2,3,2,2,3,3,3,3,3,2,2,3,3,3,2,2,3,3,3
],[
2,2,2,2,2,3,2,2,2,2,2,2,2,2,3,2,2,3,2,2
],[
2,3,2,2,2,3,2,2,2,3,2,2,3,3,3,2,2,3,3,3
],[
93,157,102,95,169,155,4,251,183,11,35,147,77,111,201,103,189,155,15,125
],[
2,115,210,140,11,246,172,25,87,124,34,224,194,59,31,117,159,16,162,43
],[
6,125,179,53,111,238,155,11,128,64,84,16,36,131,63,113,221,255,21,80
],[
91,118,32,34,77,169,171,85,119,29,183,54,5,31,239,19,31,6,222,156
],[
189,184,96,143,189,112,86,149,51,190,158,103,0,207,67,52,166,238,240,71
],[
90,75,171,229,91,251,191,116,131,65,250,227,27,12,25,69,244,192,129,191
],[
179,57,48,165,109,14,242,224,116,18,216,147,112,33,230,254,177,25,12,162
],[
195,38,88,165,67,67,105,121,242,253,39,185,8,122,177,83,203,187,151,236
],[
95,30,74,128,224,39,208,73,174,127,188,227,8,61,94,173,221,101,55,114
],[
222,174,175,73,216,137,11,185,65,94,153,33,17,25,45,87,211,229,209,144
]
]