aLevelData = [
[
2,2,2,2,2,11,2,2,2,2,2,2,2,2,9,2,2,2,2,2
],[
2,2,2,2,2,2,2,2,2,2,2,2,2,2,2,2,2,2,2,2
],[
5,2,5,2,5,5,5,2,5,5,5,2,5,5,5,2,5,2,5,2
],[
5,2,5,2,5,2,5,2,5,2,5,2,5,2,5,2,2,5,2,2
],[
5,5,5,2,5,5,5,2,5,5,5,2,5,5,5,2,2,5,2,2
],[
5,2,5,2,5,2,5,2,5,2,2,2,5,2,2,2,2,5,2,2
],[
5,2,5,2,5,2,5,2,5,2,2,2,5,2,2,2,5,5,5,2
],[
2,2,2,12,2,2,2,2,2,2,2,2,2,10,2,2,2,2,2,2
],[
2,2,7,2,2,2,2,2,8,2,2,2,2,2,2,2,7,2,2,6
],[
2,2,7,2,5,5,5,2,5,5,5,2,5,5,2,2,7,2,2,2
],[
2,2,7,2,5,2,2,2,2,5,2,2,5,2,5,2,7,2,2,2
],[
9,234,250,222,102,226,38,99,0,216,55,147,132,86,227,97,230,15,95,61
],[
165,20,196,233,80,75,183,136,73,30,73,248,201,112,28,97,36,213,200,14
],[
78,2,124,124,158,130,233,177,211,171,91,207,85,209,41,233,189,185,80,21
],[
150,80,91,195,101,157,134,77,232,245,34,207,156,110,59,56,129,150,121,161
],[
33,100,68,222,207,110,43,83,45,93,135,9,241,158,91,2,232,91,127,201
],[
59,170,254,76,241,4,188,238,181,248,92,217,217,32,96,145,156,85,146,207
],[
168,31,163,140,223,111,19,92,87,145,80,253,163,92,34,48,85,172,70,199
],[
192,18,90,0,3,201,249,17,67,236,38,4,55,231,238,197,234,44,73,122
],[
188,39,66,18,170,115,87,33,208,78,35,235,44,74,58,190,165,70,85,134
]
]