aLevelData = [
[
4,2,5,5,2,2,2,2,2,2,2,2,2,2,2,2,2,2,2,2
],[
2,2,2,2,2,2,5,2,2,2,5,2,2,2,5,3,3,3,3,2
],[
2,2,2,2,2,2,3,3,3,3,3,3,3,2,2,2,2,5,2,2
],[
57,144,116,255,231,8,204,250,44,210,225,160,208,104,216,207,67,74,193,170
],[
50,66,202,247,88,237,178,196,151,119,129,81,71,166,119,42,206,26,66,148
],[
112,211,116,42,105,243,51,200,57,197,50,168,64,255,225,203,138,68,225,155
],[
236,237,187,206,80,9,209,141,77,162,149,214,251,67,248,31,5,182,38,60
],[
255,18,112,130,250,246,137,45,86,15,246,255,216,224,192,42,252,194,108,112
],[
141,41,44,137,114,42,87,197,203,58,23,242,61,57,98,128,137,175,43,227
],[
100,85,217,57,131,215,248,45,245,216,46,27,181,54,113,117,128,144,120,101
],[
228,6,111,179,154,64,239,234,21,178,45,182,91,30,114,145,20,90,203,158
],[
224,83,1,213,238,82,203,97,203,126,67,70,119,163,151,71,190,49,1,7
],[
197,136,249,110,228,114,169,78,179,241,161,71,104,60,204,232,96,4,162,22
],[
251,251,160,178,173,151,245,118,82,19,127,32,194,184,245,211,166,90,102,186
],[
138,37,226,238,51,154,119,154,50,212,95,93,185,16,119,239,174,108,243,8
],[
254,239,80,125,52,202,139,172,74,221,145,27,190,125,246,92,233,117,233,52
],[
141,74,104,252,173,196,176,70,161,169,248,196,105,204,94,102,66,70,34,195
],[
119,4,18,186,122,130,69,89,51,213,12,253,152,239,38,187,126,31,51,255
],[
174,215,107,115,60,178,144,35,20,181,33,222,214,214,209,223,228,186,56,173
],[
185,195,199,63,124,74,1,100,212,41,232,98,255,125,182,221,30,170,206,251
]
]