aLevelData = [
[
2,2,2,2,2,2,2,2,2,2,2,2,2,204,132,222,252,17,180,148
],[
2,2,2,2,2,2,2,2,2,2,2,2,2,77,6,97,42,243,27,77
],[
2,2,2,2,2,2,2,2,2,2,2,2,2,46,214,235,176,196,21,103
],[
2,2,2,3,3,3,3,3,3,3,3,3,3,207,237,64,49,209,9,200
],[
2,2,2,2,2,2,2,2,2,2,2,2,2,70,206,155,179,224,42,77
],[
2,2,2,2,2,2,2,2,2,2,2,2,2,148,155,33,52,187,214,162
],[
2,2,2,2,2,3,2,2,3,2,2,3,2,84,169,92,97,103,199,68
],[
2,2,2,3,3,3,3,3,3,3,3,3,3,40,218,87,21,109,25,170
],[
2,2,2,2,2,2,2,2,2,2,2,2,2,46,42,12,147,101,233,225
],[
2,2,2,2,2,2,2,2,2,2,2,2,2,29,239,30,13,121,128,186
],[
2,2,3,3,3,3,3,3,3,3,3,3,3,141,58,178,253,114,197,171
],[
2,2,2,2,2,2,2,2,2,2,2,2,2,140,156,2,250,195,198,88
],[
2,2,2,2,2,2,2,2,2,2,2,2,2,195,76,195,217,28,241,6
],[
2,2,3,3,3,3,3,3,3,2,2,3,3,185,182,174,104,5,192,11
],[
2,2,3,2,2,2,2,2,2,2,2,2,2,38,145,8,169,41,51,100
],[
2,2,3,2,2,2,2,2,2,2,2,2,2,26,139,46,80,245,86,241
],[
216,42,143,2,185,148,115,53,195,205,0,33,129,70,183,212,28,151,161,198
],[
125,19,144,12,178,160,167,206,147,198,28,251,165,5,61,59,62,108,177,38
],[
234,103,1,179,14,217,87,243,203,106,133,255,37,35,72,47,101,56,206,140
],[
187,36,119,136,40,251,217,237,155,252,6,20,91,102,17,87,164,142,206,200
]
]