aLevelData = [
[
2,2,3,3,3,3,3,3,3,3,3,170,97,215,147,57,42,94,157,121
],[
2,2,2,2,2,2,2,2,2,2,2,135,43,199,138,236,117,188,118,8
],[
3,2,3,3,3,3,3,3,3,3,3,192,61,9,73,83,198,227,158,237
],[
2,2,2,2,2,2,2,2,2,2,2,111,203,128,180,16,70,51,110,168
],[
3,2,3,3,3,3,3,3,3,3,3,104,73,243,0,235,105,226,139,126
],[
2,2,3,2,2,2,2,2,2,2,2,78,148,145,95,18,78,140,44,173
],[
3,2,3,2,2,3,3,3,3,3,3,187,211,247,185,153,117,152,120,178
],[
2,2,3,2,2,3,2,2,2,2,2,104,71,23,14,227,106,52,103,8
],[
2,3,3,2,2,3,3,3,3,2,2,171,159,221,198,78,93,235,254,193
],[
2,2,2,2,2,2,2,2,2,3,2,243,154,228,117,225,244,169,237,108
],[
3,3,3,3,2,2,2,2,2,3,2,188,87,21,160,92,252,212,150,31
],[
8,2,6,3,2,3,3,3,3,3,2,10,228,243,160,254,226,177,131,64
],[
2,2,2,3,2,3,2,2,2,3,2,161,34,98,74,196,49,10,13,140
],[
2,2,2,2,2,3,2,2,2,3,2,236,232,144,238,63,190,219,233,2
],[
154,19,22,55,9,230,129,140,136,42,183,40,59,192,32,163,226,191,143,86
],[
8,206,24,214,125,210,34,187,7,202,188,166,85,246,53,130,52,63,230,9
],[
6,211,83,138,111,16,115,234,81,163,75,234,251,241,194,167,157,182,176,103
],[
255,235,56,146,115,238,88,255,9,221,190,113,1,66,221,98,134,246,65,255
],[
153,63,31,115,75,60,49,104,47,131,192,203,15,8,3,208,222,65,167,55
],[
238,135,175,205,99,192,126,53,232,59,50,232,160,219,52,123,95,120,13,33
]
]