aLevelData = [
[
2,2,2,2,2,2,2,2,2,2,2,2,13,95,223,43,80,118,52,159
],[
2,2,2,2,2,2,2,2,3,3,3,3,221,88,57,208,201,78,98,113
],[
2,2,3,2,3,2,2,2,2,3,2,2,209,183,226,251,86,254,203,69
],[
2,2,3,2,3,2,2,2,2,2,3,2,166,202,119,84,125,116,40,116
],[
2,2,3,2,3,2,2,2,2,2,2,3,204,190,235,135,184,194,194,158
],[
2,2,3,2,2,2,2,2,2,2,2,2,230,40,1,198,246,156,249,37
],[
2,2,3,2,3,3,3,3,3,3,3,3,77,127,212,69,24,221,192,175
],[
2,2,3,2,2,2,2,2,2,2,2,2,141,160,80,188,116,3,30,168
],[
2,2,3,2,3,3,3,3,3,3,3,3,231,73,182,232,86,174,175,189
],[
2,2,3,2,2,2,2,2,2,2,2,2,206,158,27,10,122,37,34,99
],[
2,2,3,3,3,3,3,3,3,3,3,3,106,167,233,102,147,209,185,78
],[
1,2,3,2,2,2,2,2,2,2,2,2,23,207,93,197,199,191,203,250
],[
2,2,3,5,5,2,2,2,5,5,5,5,230,102,7,244,48,34,69,38
],[
2,2,3,2,2,5,5,5,5,5,2,2,27,32,78,67,93,207,36,83
],[
6,5,3,3,3,2,5,2,2,2,2,2,174,149,233,7,207,192,253,73
],[
203,191,103,24,125,146,118,147,82,127,167,83,81,7,202,254,88,24,97,25
],[
168,132,73,30,163,178,156,207,213,148,213,201,50,216,53,92,158,99,102,154
],[
179,251,95,174,190,67,135,112,10,237,29,54,98,43,215,236,209,102,201,103
],[
172,51,137,246,210,131,145,58,51,25,228,56,143,66,245,173,128,192,196,161
],[
187,7,74,63,147,172,23,228,191,26,58,118,92,135,97,247,54,38,65,90
]
]