aLevelData = [
[
5,5,3,5,5,5,5,5,5,5,3,5,5,5,5,5,139,115,14,245
],[
4,2,3,5,5,5,5,5,5,5,3,5,5,5,5,5,12,146,15,21
],[
2,2,3,2,3,3,3,3,3,2,3,3,3,3,3,5,124,15,114,167
],[
5,2,2,2,3,2,2,2,2,2,5,5,5,5,5,5,217,3,181,191
],[
2,2,2,3,2,2,2,2,2,2,5,5,5,5,5,5,51,76,20,53
],[
2,2,2,3,2,2,5,3,3,2,3,3,3,3,3,5,86,152,82,85
],[
2,2,2,2,2,2,5,5,3,2,2,2,2,2,2,2,169,192,181,216
],[
5,2,2,2,2,2,5,5,3,2,2,2,2,2,2,2,86,88,83,20
],[
2,2,5,5,3,2,5,5,3,2,3,3,3,5,5,3,171,132,140,111
],[
2,2,5,5,3,2,5,5,3,6,3,3,5,5,5,3,193,12,216,25
],[
2,2,3,3,3,2,5,5,3,5,5,3,5,5,5,3,91,179,195,251
],[
2,2,3,2,2,2,5,5,3,5,5,5,3,5,5,3,16,197,53,234
],[
2,2,3,2,2,2,5,5,3,5,5,5,3,3,5,3,173,240,247,33
],[
213,84,115,238,234,221,187,171,49,209,205,240,48,165,22,7,91,21,52,160
],[
240,116,0,198,32,64,204,18,111,249,233,31,93,51,109,61,70,235,50,106
],[
135,23,34,126,226,128,178,165,36,212,173,18,4,247,51,242,79,155,1,159
],[
66,16,243,23,55,93,198,172,133,143,35,253,161,81,217,36,137,189,107,49
],[
98,114,202,216,95,231,99,102,230,255,92,249,238,221,27,241,172,249,9,162
],[
110,115,149,75,199,168,123,76,236,4,70,147,94,23,19,88,201,234,153,10
],[
44,147,102,137,59,7,107,149,2,48,187,135,202,63,144,62,64,68,143,93
]
]