aLevelData = [
[
5,5,5,5,5,2,2,2,2,2,2,2,2,2,2,199,235,9,58,118
],[
5,2,2,2,2,2,2,2,2,2,2,2,2,2,2,6,122,228,202,90
],[
5,2,5,3,3,3,3,3,3,3,2,2,3,3,3,210,33,124,72,58
],[
2,2,5,2,3,2,2,2,2,2,2,2,3,2,2,141,136,108,54,173
],[
2,2,3,2,3,2,2,2,2,2,2,2,3,2,2,52,135,201,129,78
],[
2,2,3,2,3,3,3,3,3,3,2,2,3,5,5,188,224,88,181,0
],[
4,2,3,2,2,2,2,2,2,3,2,2,3,2,2,238,232,27,204,211
],[
2,2,3,2,2,3,3,3,3,3,2,2,3,3,3,158,8,20,2,51
],[
2,2,2,2,2,3,2,2,2,2,2,2,2,2,3,34,125,227,128,173
],[
2,3,2,2,2,3,2,2,2,3,2,2,3,3,3,203,118,147,78,152
],[
2,3,2,2,2,3,2,2,2,3,2,2,3,5,5,58,2,20,76,77
],[
2,3,2,3,3,2,2,3,2,3,2,2,3,2,2,127,184,73,212,173
],[
2,3,2,3,6,2,2,3,3,3,2,2,3,3,3,36,102,157,51,51
],[
2,3,2,3,8,2,2,3,2,2,2,2,2,2,3,159,3,14,184,11
],[
2,3,2,3,9,2,3,3,2,2,2,2,2,2,3,18,43,193,14,236
],[
2,3,2,3,10,2,3,3,3,2,2,2,2,2,3,53,29,207,107,172
],[
2,3,2,3,11,2,3,3,3,2,2,2,2,2,3,27,236,8,55,149
],[
2,3,3,3,12,2,2,2,3,3,2,2,3,3,3,109,252,59,45,247
],[
2,2,2,2,5,2,5,2,2,3,2,2,2,2,2,165,172,215,66,42
],[
35,152,205,98,49,141,209,242,244,46,115,182,231,212,61,99,254,121,207,106
]
]