aLevelData = [
[
10,2,2,8,2,2,2,2,2,2,2,2,2,2,2,2,2,173,198,187
],[
2,2,2,2,2,2,2,2,2,2,2,2,2,2,2,2,2,143,172,118
],[
2,2,2,2,2,2,3,3,3,3,2,2,2,2,2,3,3,230,160,255
],[
9,2,2,2,2,2,2,2,2,3,2,2,2,2,2,3,2,43,254,246
],[
3,3,3,3,3,3,3,2,2,3,2,2,2,2,2,2,2,106,234,4
],[
2,2,2,2,2,2,2,2,2,3,2,2,2,2,2,3,2,88,34,97
],[
2,2,2,2,2,2,2,2,2,3,3,2,2,2,2,3,2,0,132,132
],[
2,2,2,2,2,2,2,2,2,2,3,2,2,2,2,3,2,203,79,43
],[
2,2,2,2,2,2,2,2,2,2,3,2,2,2,2,3,2,7,20,63
],[
2,2,2,2,3,3,3,3,2,2,3,2,2,2,2,3,2,62,112,61
],[
2,2,2,2,3,2,2,3,2,2,3,2,2,2,2,3,2,217,104,69
],[
2,2,2,2,3,2,2,3,2,2,3,3,3,5,2,3,2,3,254,220
],[
2,2,2,2,3,2,2,3,2,2,2,2,3,2,2,3,2,131,187,182
],[
80,147,129,196,73,123,145,126,154,82,245,219,39,246,97,206,239,1,91,210
],[
74,248,158,198,110,198,193,252,56,105,20,141,42,236,203,239,176,149,94,201
],[
167,95,47,5,31,170,110,39,96,50,57,222,44,62,8,217,68,26,73,220
],[
46,198,71,19,52,240,80,166,176,32,23,141,135,51,87,166,244,10,185,5
],[
135,131,248,139,109,168,67,186,241,39,227,199,67,3,29,241,120,136,90,18
],[
211,132,133,116,67,180,181,229,44,125,12,14,106,220,223,0,148,160,22,16
],[
125,215,214,229,1,134,94,207,254,157,47,90,160,41,112,36,226,204,144,235
]
]