aLevelData = [
[
4,2,2,2,2,2,2,2,2,2,2,2,2,2,2,2,2,208,129,19
],[
5,2,5,3,2,2,2,2,2,2,2,2,2,2,2,2,2,29,175,23
],[
2,5,5,3,3,3,3,3,3,3,3,3,3,3,3,3,3,248,191,25
],[
3,3,5,5,5,5,5,5,5,5,3,2,2,2,2,2,2,41,14,209
],[
2,3,5,5,5,5,5,5,5,5,3,6,2,2,2,2,2,37,132,197
],[
3,3,5,5,5,5,3,3,3,3,3,3,3,3,3,2,3,149,90,158
],[
3,5,5,5,5,5,3,2,2,2,2,2,2,2,2,2,2,136,92,23
],[
3,5,5,3,3,3,3,8,2,2,2,5,5,5,5,5,5,110,63,250
],[
3,5,5,3,2,2,3,3,3,3,2,5,3,3,3,5,3,50,129,25
],[
3,5,5,3,2,2,2,2,2,3,2,5,3,5,5,5,5,119,224,75
],[
3,5,5,3,2,2,3,2,2,3,2,5,3,5,5,5,5,136,7,213
],[
5,5,5,3,2,2,3,2,2,3,2,5,3,5,5,5,5,187,141,60
],[
5,5,5,3,2,2,3,2,2,3,2,5,3,3,3,5,5,172,18,53
],[
5,3,3,3,2,2,3,2,2,3,2,5,2,2,3,3,3,123,136,244
],[
5,3,2,2,2,2,3,2,2,3,2,5,2,2,2,2,2,100,173,252
],[
5,3,3,2,2,2,3,2,5,5,5,5,2,2,2,2,2,191,209,54
],[
5,5,3,3,2,2,3,2,5,3,5,5,3,3,3,3,3,40,29,82
],[
5,5,5,5,3,3,3,2,5,3,5,5,2,2,2,2,2,43,37,213
],[
90,191,164,231,191,255,209,215,193,192,126,73,73,213,125,206,110,133,77,254
],[
61,60,250,199,186,128,62,4,34,39,236,81,115,199,142,30,46,111,77,3
]
]