aLevelData = [
[
2,2,2,2,253,38,60,126,156,67,59,183,135,255,209,220,168,46,207,133
],[
2,2,13,5,3,82,252,109,61,18,185,129,91,231,229,55,205,25,255,33
],[
2,2,2,5,171,234,138,194,62,16,182,160,194,105,60,154,106,235,138,124
],[
2,2,2,2,165,218,32,209,160,61,58,249,12,146,175,123,33,193,25,156
],[
2,2,2,2,227,79,54,48,164,212,142,176,202,175,86,141,210,248,149,196
],[
2,2,2,2,149,182,133,179,202,82,60,42,205,76,139,198,159,45,39,122
],[
2,2,2,2,45,189,6,111,213,117,12,14,38,55,231,91,231,61,56,132
],[
2,2,2,2,91,80,243,185,196,58,8,63,38,125,67,192,77,69,112,230
],[
17,156,196,40,217,221,120,227,94,107,183,172,178,162,186,229,128,14,50,142
],[
149,219,230,94,159,141,157,18,53,242,62,6,24,84,54,2,185,242,26,86
],[
251,178,141,41,57,16,101,14,139,90,9,216,69,31,29,176,193,229,98,100
],[
95,26,215,2,201,77,37,166,124,158,57,144,132,115,51,121,134,109,127,39
],[
4,155,65,64,221,237,247,92,19,235,90,93,209,166,132,3,173,239,88,187
],[
42,200,31,184,129,24,111,69,161,163,81,90,116,56,162,109,100,44,186,138
],[
30,8,76,166,149,127,141,49,74,163,153,234,204,88,18,247,122,8,10,53
],[
144,152,35,205,98,155,244,8,226,198,175,100,104,164,1,231,179,139,58,179
],[
43,207,174,219,104,53,91,117,248,171,204,240,93,54,61,168,86,43,255,184
],[
96,162,30,15,123,40,66,199,49,180,211,178,213,221,96,53,9,73,66,89
],[
130,105,124,31,16,99,230,20,216,80,139,38,228,168,79,182,223,250,213,238
],[
25,225,159,85,210,51,119,160,180,123,14,204,161,170,228,105,175,9,103,57
]
]