aLevelData = [
[
4,2,2,2,2,2,2,2,2,2,2,2,2,2,2,34,5,196,64,211
],[
5,2,5,3,2,2,2,2,2,2,2,2,2,2,2,120,27,107,2,24
],[
2,5,5,3,3,3,3,3,3,3,3,3,3,3,3,239,15,243,237,187
],[
13,21,121,136,153,215,60,97,227,188,126,6,247,178,72,229,226,160,180,69
],[
23,62,102,197,17,41,91,5,57,55,226,163,9,7,231,105,114,221,119,196
],[
123,173,129,120,44,118,218,147,170,210,132,159,163,202,48,28,236,238,1,46
],[
105,166,147,146,46,195,60,214,227,89,146,202,109,209,45,50,203,58,174,189
],[
61,224,255,59,172,32,221,10,70,122,148,209,105,232,10,113,194,110,255,57
],[
182,243,147,90,0,79,9,154,156,165,202,76,228,243,173,127,250,231,117,118
],[
101,245,156,88,255,166,79,41,14,51,185,249,177,82,132,91,126,80,157,25
],[
105,96,56,38,231,51,21,212,84,200,1,71,146,134,159,42,244,136,104,160
],[
90,56,241,126,157,31,108,183,45,251,114,24,248,18,0,53,142,199,191,163
],[
131,107,136,103,21,85,39,175,15,53,95,192,238,165,47,48,65,1,84,85
],[
86,121,15,253,18,100,40,95,33,215,51,82,80,119,18,189,54,139,187,79
],[
26,86,60,112,17,163,252,119,103,161,67,29,64,241,252,49,127,254,186,142
],[
231,141,250,75,128,149,168,49,61,80,228,114,219,146,5,151,12,90,222,187
],[
213,166,65,247,53,140,194,29,7,135,189,169,41,15,155,244,222,108,80,171
],[
113,203,40,128,28,146,196,31,39,241,95,100,84,185,87,203,123,114,232,40
],[
114,168,58,152,47,133,158,183,49,165,20,19,28,37,18,225,163,253,128,239
],[
170,144,7,218,172,130,139,129,91,202,246,185,135,8,56,67,65,24,140,251
]
]