aLevelData = [
[
2,2,2,2,2,2,2,2,2,2,2,74,206,23,239,191,250,53,239,239
],[
2,2,13,5,5,2,2,12,5,5,2,23,16,8,237,130,228,142,142,74
],[
2,2,2,5,5,2,2,2,5,5,2,208,61,108,44,239,205,49,194,198
],[
2,2,2,2,2,2,2,2,2,2,2,198,18,247,222,150,153,190,177,224
],[
2,2,2,2,2,2,2,2,2,2,2,168,4,203,24,187,226,41,77,109
],[
2,2,2,2,2,2,2,2,2,2,2,24,229,69,62,183,21,207,147,29
],[
2,2,2,2,2,2,2,2,2,2,2,240,85,254,38,50,177,192,161,194
],[
2,2,2,2,2,2,2,2,2,2,2,65,140,1,146,62,142,85,199,73
],[
172,123,27,71,12,144,127,111,214,170,4,161,59,202,251,250,182,12,91,165
],[
145,33,100,244,172,255,130,175,122,215,116,172,76,72,173,159,210,210,251,52
],[
222,141,102,91,108,27,91,227,224,219,10,75,142,95,12,213,127,33,73,219
],[
114,113,25,102,34,178,169,253,199,198,161,187,223,199,3,165,46,248,86,58
],[
4,251,5,75,190,68,2,12,143,205,174,108,129,11,253,162,182,34,213,8
],[
244,85,184,45,97,192,163,37,138,73,54,36,170,212,20,76,42,182,141,194
],[
100,108,123,7,172,142,105,134,145,254,251,105,96,101,138,177,234,224,14,134
],[
135,246,65,203,91,206,1,246,216,158,246,31,132,103,118,86,253,224,165,58
],[
58,175,225,200,19,223,93,112,4,143,11,110,46,231,192,87,158,81,147,242
],[
210,229,134,74,121,36,104,1,123,234,249,231,57,158,80,203,22,172,122,146
],[
54,53,100,134,134,5,250,240,252,197,145,232,32,113,130,108,203,13,24,176
],[
46,148,173,181,23,50,15,29,112,178,41,62,8,58,223,117,151,54,57,188
]
]