aLevelData = [
[
5,5,3,5,215,52,95,203,175,192,193,204,118,73,200,19,203,8,150,201
],[
4,2,3,5,135,126,119,158,229,11,30,3,230,187,50,153,243,99,9,233
],[
2,2,3,2,196,237,179,85,130,240,58,78,40,132,40,200,47,84,74,235
],[
5,2,2,2,106,244,180,12,47,117,5,219,183,55,236,222,199,255,235,30
],[
2,2,2,3,144,73,91,32,213,224,177,22,75,171,255,87,69,202,190,13
],[
2,2,2,3,144,226,202,45,156,180,174,173,221,245,34,241,113,89,210,134
],[
2,2,2,2,3,242,97,18,239,184,174,139,167,105,86,168,85,147,122,149
],[
5,2,2,2,194,238,194,235,118,240,161,223,33,156,219,186,57,155,69,137
],[
2,2,5,5,229,141,204,21,26,161,185,21,3,99,52,163,167,214,6,237
],[
2,2,5,5,198,195,163,45,3,80,103,219,73,212,32,32,103,234,205,143
],[
2,2,3,3,253,197,165,16,156,195,91,28,41,68,161,48,130,188,235,123
],[
2,2,3,2,100,7,117,218,141,253,135,7,29,71,248,14,66,113,241,0
],[
20,63,243,234,190,69,27,8,223,178,165,55,48,109,176,169,102,99,64,220
],[
90,31,137,205,103,155,107,105,19,85,57,68,242,166,190,141,200,79,130,66
],[
238,85,73,160,247,16,221,222,146,126,13,26,178,221,246,148,237,120,129,26
],[
34,193,45,195,95,160,15,224,2,11,23,48,30,215,148,83,32,205,250,129
],[
178,1,227,124,223,95,85,195,120,135,67,9,183,219,86,229,35,213,237,203
],[
179,159,98,59,54,221,143,56,242,205,144,252,140,147,203,234,40,206,46,196
],[
208,111,184,30,26,203,59,19,5,239,96,54,37,51,235,203,0,18,64,56
],[
183,56,38,182,233,221,204,76,212,82,10,254,189,217,232,66,146,186,100,179
]
]