aLevelData = [
[
5,5,3,5,5,5,5,5,5,5,3,5,5,5,5,5,5,5,5,5
],[
4,2,3,5,5,5,5,5,5,5,3,5,5,5,5,5,5,5,5,5
],[
2,2,3,2,3,3,3,3,3,2,3,3,3,3,3,5,5,3,5,5
],[
150,8,113,171,147,71,84,99,130,108,77,125,95,148,213,33,255,82,7,143
],[
243,255,163,16,175,81,88,43,236,47,67,27,74,196,179,129,58,211,47,87
],[
27,74,186,37,163,25,85,119,129,68,198,142,64,55,152,86,111,91,99,152
],[
255,230,77,113,236,247,209,3,32,226,191,106,148,200,132,241,184,108,172,134
],[
21,65,165,108,48,200,198,48,178,24,143,222,199,190,51,116,196,200,83,151
],[
12,29,13,133,52,16,53,75,101,52,226,56,2,113,45,145,139,87,53,134
],[
194,179,103,101,12,96,252,14,25,96,194,167,199,43,32,145,68,71,84,154
],[
115,25,0,116,146,251,229,102,25,143,238,65,229,82,112,150,149,116,176,38
],[
53,231,166,154,26,182,0,116,12,152,106,70,171,197,13,33,11,8,85,81
],[
162,21,248,71,100,30,52,215,44,161,88,164,94,132,133,216,202,99,182,24
],[
212,41,254,183,210,221,17,41,182,191,6,187,237,148,91,130,135,62,58,145
],[
151,143,250,111,221,95,233,201,162,220,73,99,228,34,152,84,179,12,21,115
],[
219,73,127,13,195,178,32,217,149,218,10,45,159,231,161,113,250,161,89,213
],[
105,201,193,63,131,172,193,135,21,248,31,231,194,205,72,173,236,23,78,51
],[
216,28,45,17,12,81,82,145,252,114,94,100,230,209,39,147,251,239,255,184
],[
191,73,58,109,178,116,234,5,48,108,237,122,150,42,42,167,166,116,23,183
],[
45,249,127,222,226,157,130,71,146,18,221,77,122,168,107,237,245,102,236,123
]
]