aLevelData = [
[
4,2,5,14,252,241,199,78,13,133,241,100,88,67,29,239,203,237,85,224
],[
2,2,2,101,23,47,140,248,220,170,0,45,207,90,148,200,52,197,195,45
],[
2,2,2,113,12,57,35,191,206,46,217,37,73,243,39,167,194,202,21,187
],[
3,3,3,39,251,161,252,244,36,189,34,83,209,152,50,135,76,30,242,138
],[
2,2,3,183,194,160,245,87,123,227,33,51,12,2,140,222,137,84,126,145
],[
13,2,3,23,248,236,124,243,197,156,94,182,132,138,84,215,93,139,238,113
],[
2,5,3,144,48,136,70,102,237,216,5,102,122,195,200,203,122,117,225,54
],[
2,12,3,91,176,214,161,125,100,170,148,150,129,94,155,85,9,184,247,69
],[
5,2,3,105,67,148,245,9,151,59,86,34,218,9,100,208,135,32,8,104
],[
11,2,3,110,156,61,11,253,201,115,123,189,147,48,46,31,61,253,161,121
],[
2,5,3,86,128,239,76,233,230,162,200,245,132,201,146,28,189,75,196,159
],[
2,10,3,38,122,54,138,232,235,252,44,102,134,47,202,32,217,241,149,215
],[
5,2,2,177,171,216,243,236,153,118,33,137,137,148,64,1,223,147,126,218
],[
2,2,2,221,65,190,121,33,80,62,56,111,7,118,184,177,55,67,121,60
],[
9,5,3,113,68,167,85,118,132,55,244,239,90,51,200,94,142,82,122,85
],[
2,2,3,189,204,54,230,255,108,104,90,198,231,195,37,10,108,136,26,163
],[
5,8,3,124,5,220,246,252,92,149,211,137,133,234,158,11,150,46,173,141
],[
2,2,3,66,213,242,76,160,44,218,13,46,72,116,180,22,60,214,19,176
],[
6,5,3,144,189,0,71,238,115,170,32,29,246,45,184,52,86,99,78,7
],[
2,2,2,95,253,161,230,120,211,251,135,203,121,110,64,166,19,94,121,33
]
]