aLevelData = [
[
2,2,2,2,2,2,2,2,2,6,5,2,2,48,232,229,173,137,10,59
],[
2,3,5,3,5,5,5,3,5,3,5,2,5,183,133,5,183,62,68,15
],[
7,68,142,92,224,188,93,145,161,156,155,123,51,51,44,1,51,189,47,87
],[
83,53,129,117,253,106,131,200,58,85,30,39,211,170,4,8,182,173,56,244
],[
154,71,208,56,230,89,250,222,207,80,61,219,193,250,1,138,1,152,82,89
],[
144,52,225,195,82,52,75,126,111,48,158,245,250,1,26,248,209,26,52,178
],[
196,28,225,220,249,164,16,49,142,103,120,34,129,130,149,202,205,11,237,36
],[
214,236,152,124,7,241,255,35,186,31,228,103,88,72,163,194,193,220,183,82
],[
238,2,127,137,213,231,66,38,140,86,114,100,178,138,45,113,11,64,9,33
],[
106,16,17,228,212,252,11,246,226,74,253,213,103,143,239,248,83,13,241,190
],[
215,62,96,165,202,177,102,188,76,21,192,91,169,148,196,17,128,98,162,222
],[
36,149,234,162,66,55,78,214,196,153,170,122,246,235,65,78,231,10,73,69
],[
19,153,171,55,62,83,4,214,163,159,239,227,78,101,134,162,199,33,38,139
],[
240,54,115,66,48,132,156,201,209,60,225,245,167,243,82,30,243,246,217,27
],[
134,222,122,109,42,100,218,187,61,118,254,127,159,138,86,254,207,50,250,125
],[
80,240,51,178,82,76,61,121,142,37,75,200,114,69,204,229,126,56,237,214
],[
238,93,95,26,153,61,90,150,25,28,226,210,44,206,73,101,90,204,245,174
],[
216,135,99,197,173,252,108,177,19,137,199,220,32,255,208,196,165,248,135,242
],[
87,107,220,48,44,125,42,247,8,154,1,39,153,197,40,250,127,44,226,59
],[
177,0,113,179,28,131,217,229,141,99,230,251,208,70,112,255,26,166,222,78
]
]