aLevelData = [
[
2,2,2,226,130,219,22,197,5,12,145,102,40,212,233,143,90,115,172,164
],[
2,3,5,66,132,90,52,3,48,201,206,191,162,200,22,90,186,3,23,128
],[
2,3,2,6,39,219,233,238,70,57,219,46,124,239,241,138,211,241,28,188
],[
2,2,2,100,0,231,178,191,125,255,246,141,128,242,110,116,37,55,69,59
],[
2,3,5,38,111,41,47,175,234,183,197,109,109,51,128,233,50,125,21,20
],[
49,64,206,34,158,109,44,156,179,232,208,177,175,129,155,206,31,37,21,110
],[
92,85,11,50,85,216,125,52,142,173,183,153,105,68,189,101,165,238,236,147
],[
36,145,223,102,241,160,144,250,129,74,191,30,57,242,152,102,49,224,144,123
],[
56,54,144,182,24,37,85,237,27,96,23,141,205,209,104,233,4,140,96,210
],[
30,1,247,104,138,117,178,47,138,179,130,102,54,254,233,148,197,75,94,99
],[
8,173,243,177,55,17,53,229,240,43,83,127,125,176,131,244,86,198,162,184
],[
230,185,26,156,146,239,9,90,248,30,160,110,116,188,201,40,233,183,12,0
],[
190,103,179,41,38,193,44,105,165,205,176,39,208,90,34,198,84,240,58,49
],[
57,6,226,183,104,117,224,26,107,45,182,226,117,38,198,247,162,154,186,111
],[
127,114,35,165,205,254,96,139,130,232,194,65,17,107,238,230,235,192,130,174
],[
70,217,251,52,29,82,214,18,120,165,245,176,237,157,69,89,103,13,158,148
],[
38,193,234,177,7,181,138,162,6,133,245,12,1,37,162,158,191,210,41,162
],[
48,72,165,209,246,54,92,108,37,239,162,136,71,98,250,170,164,76,127,147
],[
192,172,130,93,36,120,117,199,97,142,7,206,83,237,145,125,163,37,177,5
],[
143,12,52,16,238,179,58,83,110,152,148,98,33,29,113,201,56,57,58,88
]
]