aLevelData = [
[
6,2,2,2,2,2,99,141,217,73,236,92,116,167,138,151,194,255,252,20
],[
2,2,2,2,2,2,20,240,181,135,26,250,131,156,166,53,110,67,180,67
],[
2,2,2,2,2,2,227,75,168,131,18,51,214,135,148,61,71,201,81,195
],[
3,3,3,3,3,3,186,153,161,206,234,90,177,229,15,238,41,35,167,111
],[
2,2,2,2,2,2,11,141,118,32,222,162,204,163,13,51,6,108,138,116
],[
2,2,2,2,2,2,87,117,182,84,201,51,133,10,126,202,221,240,60,125
],[
64,149,41,104,171,13,210,113,190,140,114,124,28,52,114,222,21,42,44,20
],[
131,239,244,182,241,238,89,166,3,81,168,141,18,25,178,136,22,110,207,30
],[
201,51,35,118,9,222,32,198,126,135,76,15,126,62,69,8,45,162,2,87
],[
233,176,91,7,229,216,204,55,19,86,118,15,72,191,102,249,155,218,26,13
],[
14,178,65,204,112,233,195,18,129,79,1,70,88,179,94,212,2,250,254,221
],[
108,110,206,45,130,88,196,109,153,208,104,153,10,212,147,181,32,152,118,188
],[
53,29,223,218,23,5,184,218,177,166,208,226,231,93,223,94,193,36,196,58
],[
204,103,16,84,189,20,200,49,88,242,103,239,144,51,35,122,240,76,113,3
],[
57,4,203,174,77,203,177,139,75,78,238,200,252,72,28,37,110,155,106,167
],[
222,159,157,145,219,186,85,144,169,49,146,54,228,61,118,169,101,98,77,157
],[
106,252,202,127,240,27,147,243,100,144,1,129,123,72,32,139,95,217,254,131
],[
11,91,34,91,248,121,90,60,249,199,186,122,99,87,225,200,114,135,126,168
],[
232,28,19,38,247,149,249,198,97,185,165,187,222,115,41,89,190,223,253,205
],[
207,165,0,12,129,134,186,9,72,52,228,43,66,103,42,254,26,45,47,41
]
]