aLevelData = [
[
4,2,5,5,2,2,2,24,83,19,107,197,3,26,81,100,118,12,216,251
],[
2,2,2,2,2,2,5,108,59,87,151,139,70,69,227,163,71,159,249,54
],[
2,2,2,2,2,2,3,78,138,120,56,15,58,215,19,215,18,249,238,197
],[
3,3,3,3,3,3,3,13,1,47,54,92,103,62,129,81,76,140,229,123
],[
2,2,3,2,2,2,2,10,213,191,19,16,162,0,150,237,17,223,180,170
],[
13,2,3,2,2,2,2,216,203,105,93,136,164,106,251,15,42,194,110,129
],[
2,5,3,2,2,2,2,182,189,231,24,40,5,118,121,32,11,216,56,113
],[
2,12,3,2,2,2,2,168,144,159,210,5,57,171,215,184,26,88,32,47
],[
5,2,3,3,3,3,3,251,30,209,82,55,188,65,100,19,52,247,42,78
],[
11,2,3,2,2,2,2,23,210,80,249,2,135,8,137,105,81,244,43,147
],[
2,5,3,2,2,2,2,227,70,87,230,162,38,168,101,17,84,235,119,140
],[
2,10,3,2,2,2,2,14,118,234,58,52,187,55,61,170,28,8,43,254
],[
5,2,2,2,2,2,2,1,247,194,74,40,153,215,92,61,187,144,21,171
],[
2,2,2,2,2,2,2,235,211,15,177,59,254,130,184,65,217,105,228,98
],[
9,5,3,2,2,2,2,201,224,233,81,70,209,32,210,142,207,218,196,155
],[
2,2,3,2,2,2,2,66,244,94,83,197,171,185,0,204,178,142,255,138
],[
130,66,188,18,242,31,222,188,7,229,190,202,13,129,30,75,230,28,24,64
],[
163,87,84,254,81,213,126,211,21,251,247,236,124,243,203,118,12,247,228,4
],[
31,204,125,49,241,140,217,134,247,169,52,158,114,47,250,135,69,73,55,108
],[
3,7,78,113,77,94,239,223,91,113,67,129,216,14,105,78,243,124,38,71
]
]