aLevelData = [
[
2,2,2,2,2,2,2,2,2,6,5,2,2,2,2,71,203,35,27,36
],[
2,3,5,3,5,5,5,3,5,3,5,2,5,3,5,104,244,250,216,157
],[
2,3,2,3,2,2,2,3,5,3,5,2,5,3,5,162,69,57,247,93
],[
2,2,2,2,2,2,2,2,2,2,2,2,5,5,5,253,144,171,79,53
],[
2,3,5,3,5,5,5,3,2,3,5,5,5,3,2,251,115,35,128,16
],[
2,3,5,3,5,5,5,3,2,3,5,5,5,3,2,152,196,166,195,80
],[
2,5,5,5,5,5,5,5,5,5,5,5,5,2,2,103,155,138,75,203
],[
2,3,5,3,5,5,5,3,5,3,5,5,5,3,5,177,191,137,191,12
],[
69,110,230,86,110,24,183,181,28,240,199,250,39,127,75,28,255,132,216,228
],[
147,67,110,233,113,31,181,191,46,107,134,108,8,126,173,27,202,5,238,21
],[
240,158,70,236,12,162,114,249,104,65,182,9,237,213,215,84,67,112,105,175
],[
58,183,81,2,105,244,130,251,21,102,10,4,84,220,82,115,113,130,161,1
],[
147,250,227,126,154,174,169,195,74,101,112,231,171,21,38,182,175,248,234,94
],[
22,226,20,108,143,210,117,247,32,199,224,27,199,213,232,170,98,119,236,29
],[
204,39,81,209,73,44,15,112,36,180,111,172,150,34,19,52,234,169,54,224
],[
223,26,53,47,78,250,78,244,12,216,168,76,18,221,148,211,219,165,19,24
],[
14,77,152,78,93,206,15,68,173,137,29,151,119,35,170,38,110,146,157,198
],[
98,120,230,55,100,176,194,87,43,39,58,150,182,238,237,170,51,141,16,132
],[
32,153,179,130,176,137,70,230,112,197,91,135,42,0,174,198,9,200,98,196
],[
255,91,141,210,100,189,247,41,224,7,31,220,138,2,127,10,81,244,17,88
]
]