aLevelData = [
[
5,5,3,5,5,5,5,5,5,5,3,5,5,5,5,37,131,69,24,72
],[
4,2,3,5,5,5,5,5,5,5,3,5,5,5,5,245,168,12,84,84
],[
2,2,3,2,3,3,3,3,3,2,3,3,3,3,3,58,137,134,2,166
],[
5,2,2,2,3,2,2,2,2,2,5,5,5,5,5,27,139,2,185,238
],[
2,2,2,3,2,2,2,2,2,2,5,5,5,5,5,45,8,34,134,50
],[
2,2,2,3,2,2,5,3,3,2,3,3,3,3,3,210,118,176,129,187
],[
2,2,2,2,2,2,5,5,3,2,2,2,2,2,2,119,185,135,142,149
],[
5,2,2,2,2,2,5,5,3,2,2,2,2,2,2,221,217,152,181,2
],[
2,2,5,5,3,2,5,5,3,2,3,3,3,5,5,27,1,50,167,32
],[
2,2,5,5,3,2,5,5,3,6,3,3,5,5,5,92,33,23,82,124
],[
2,2,3,3,3,2,5,5,3,5,5,3,5,5,5,218,226,85,137,180
],[
2,2,3,2,2,2,5,5,3,5,5,5,3,5,5,141,231,84,15,137
],[
2,2,3,2,2,2,5,5,3,5,5,5,3,3,5,11,232,152,98,102
],[
2,2,3,2,5,2,3,3,3,5,5,5,3,3,5,98,200,57,233,2
],[
174,116,176,129,239,180,42,165,11,7,123,20,225,96,30,102,118,68,207,125
],[
242,197,168,25,235,180,138,167,230,19,190,90,27,201,220,125,121,153,236,8
],[
234,85,204,113,216,79,210,196,240,17,177,246,38,78,161,119,249,24,186,6
],[
248,82,161,201,133,105,103,157,217,63,174,171,72,104,14,60,198,153,183,206
],[
171,93,87,102,179,10,62,41,73,244,192,38,5,224,218,119,115,188,25,136
],[
22,141,184,182,172,168,8,28,180,37,21,169,46,145,135,118,162,227,198,87
]
]