aLevelData = [
[
6,2,8,89,137,130,239,207,38,233,59,163,196,4,79,124,59,215,106,170
],[
2,2,2,108,82,15,186,130,131,100,71,120,9,217,19,220,204,9,86,210
],[
2,2,3,235,229,85,91,246,15,55,215,94,132,20,201,41,126,80,219,234
],[
2,2,3,153,39,34,241,52,136,162,191,26,39,21,189,98,206,232,45,147
],[
2,2,3,243,135,96,12,144,218,41,163,47,15,147,141,68,155,207,126,192
],[
2,2,3,123,112,16,227,192,219,105,82,74,248,24,105,212,46,65,210,49
],[
2,2,3,143,250,87,212,79,244,244,150,123,94,49,180,231,6,175,23,105
],[
2,2,3,194,0,217,68,14,187,4,231,246,208,157,216,55,26,225,235,161
],[
2,2,2,51,206,183,191,140,229,74,186,189,47,28,123,25,126,66,16,134
],[
2,3,2,245,228,81,140,202,241,195,171,75,17,188,242,31,220,200,205,207
],[
2,3,2,73,76,31,133,105,105,144,19,85,35,41,54,101,195,30,28,162
],[
2,3,2,121,234,37,126,70,161,231,195,25,130,116,202,57,204,223,237,226
],[
2,3,2,212,252,62,51,83,104,122,72,4,201,56,163,111,87,102,208,255
],[
2,3,2,156,246,72,91,119,213,151,243,103,29,186,217,6,139,203,211,212
],[
51,224,174,54,114,48,213,191,37,119,34,173,24,156,243,183,194,145,129,6
],[
47,124,109,129,61,20,156,77,11,77,69,148,175,55,72,134,39,35,194,158
],[
146,9,222,39,161,38,238,254,72,233,186,153,185,16,23,72,146,15,188,187
],[
85,177,82,197,26,1,202,95,128,107,243,240,233,31,76,204,231,182,23,250
],[
241,24,174,58,91,157,26,70,133,114,226,89,82,63,33,238,219,6,219,202
],[
101,79,145,60,145,130,19,164,211,148,150,50,37,229,6,240,253,105,158,3
]
]