aLevelData = [
[
5,5,3,5,5,5,5,5,5,5,3,5,5,5,5,43,215,229,247,191
],[
4,2,3,5,5,5,5,5,5,5,3,5,5,5,5,98,181,115,199,14
],[
2,2,3,2,3,3,3,3,3,2,3,3,3,3,3,162,33,160,28,244
],[
248,244,216,216,65,118,123,180,158,210,80,184,74,227,22,182,162,39,166,51
],[
229,113,213,190,56,222,156,128,237,10,118,21,4,132,10,154,242,127,10,7
],[
162,202,91,191,186,2,118,102,31,6,14,243,187,171,243,6,126,177,54,123
],[
162,246,142,63,52,234,250,98,208,67,168,110,172,242,22,248,215,85,119,116
],[
195,174,88,78,2,212,131,54,77,40,35,187,202,203,42,27,143,14,240,89
],[
98,42,28,145,194,50,200,137,44,69,224,136,151,8,203,107,65,83,78,245
],[
173,43,173,103,236,241,19,80,29,216,51,167,48,157,48,23,239,114,186,154
],[
62,59,123,73,161,252,177,115,0,146,28,236,167,162,26,167,145,208,17,135
],[
230,49,13,115,194,2,170,169,56,154,53,84,151,157,14,96,235,115,80,141
],[
199,248,180,194,66,117,179,165,64,208,235,104,243,255,196,229,161,194,83,238
],[
167,146,127,222,190,212,98,116,125,83,242,226,31,237,224,32,135,141,192,134
],[
129,89,107,154,75,44,161,39,84,70,243,143,67,66,224,97,59,73,63,46
],[
93,134,221,153,143,217,102,174,124,208,137,117,220,211,87,198,246,158,236,94
],[
99,245,82,51,20,146,162,5,151,99,108,54,149,242,89,219,160,37,15,19
],[
43,39,85,152,218,166,120,147,253,63,237,181,87,54,55,131,35,107,12,241
],[
89,137,179,51,45,129,176,208,216,55,163,248,156,122,110,23,2,58,150,170
],[
103,245,236,82,182,115,108,38,119,179,101,78,9,37,218,206,43,26,40,159
]
]