aLevelData = [
[
2,2,2,2,2,11,2,2,2,2,2,2,2,2,9,2,2,2,2,132
],[
2,2,2,2,2,2,2,2,2,2,2,2,2,2,2,2,2,2,2,182
],[
5,2,5,2,5,5,5,2,5,5,5,2,5,5,5,2,5,2,5,95
],[
5,2,5,2,5,2,5,2,5,2,5,2,5,2,5,2,2,5,2,217
],[
5,5,5,2,5,5,5,2,5,5,5,2,5,5,5,2,2,5,2,118
],[
5,2,5,2,5,2,5,2,5,2,2,2,5,2,2,2,2,5,2,50
],[
5,2,5,2,5,2,5,2,5,2,2,2,5,2,2,2,5,5,5,55
],[
2,2,2,12,2,2,2,2,2,2,2,2,2,10,2,2,2,2,2,173
],[
45,179,2,162,139,36,78,34,33,99,208,28,242,245,76,86,121,248,181,5
],[
238,88,150,155,198,70,176,224,121,230,228,68,135,72,84,115,189,154,198,43
],[
180,156,73,74,156,84,26,44,55,2,200,51,40,86,151,167,110,225,34,193
],[
44,202,69,2,171,194,58,201,161,57,2,37,180,210,7,232,58,21,255,253
],[
67,101,19,251,217,49,65,249,134,110,255,165,23,68,33,144,160,7,252,204
],[
192,106,204,185,38,239,83,28,84,162,195,113,163,7,222,131,136,81,92,57
],[
21,212,141,179,195,189,63,149,110,1,226,163,161,147,234,143,20,218,117,14
],[
115,98,46,49,97,210,113,243,189,30,176,15,36,253,21,20,183,158,104,186
],[
30,150,52,119,205,30,37,78,133,123,181,232,30,189,7,229,133,172,19,116
],[
1,0,4,33,186,208,222,239,123,77,100,167,183,176,57,111,202,113,69,158
],[
130,186,90,207,222,27,24,53,21,127,14,46,218,95,33,26,223,53,50,109
],[
152,52,251,3,65,54,58,180,34,246,18,41,18,127,174,237,58,228,39,199
]
]