aLevelData = [
[
10,2,2,8,2,2,2,2,2,2,172,146,210,106,9,167,75,20,10,230
],[
2,2,2,2,2,2,2,2,2,2,8,176,255,238,124,243,152,63,117,134
],[
2,2,2,2,2,2,3,3,3,3,168,241,251,92,40,166,123,68,127,189
],[
9,2,2,2,2,2,2,2,2,3,37,186,1,200,146,3,181,64,170,121
],[
3,3,3,3,3,3,3,2,2,3,91,120,197,35,173,208,16,136,230,43
],[
2,2,2,2,2,2,2,2,2,3,51,197,129,163,48,222,67,123,142,82
],[
2,2,2,2,2,2,2,2,2,3,123,84,184,242,137,164,160,242,157,101
],[
2,2,2,2,2,2,2,2,2,2,167,65,193,10,193,22,26,183,212,204
],[
2,2,2,2,2,2,2,2,2,2,106,177,98,239,218,20,104,151,247,196
],[
2,2,2,2,3,3,3,3,2,2,134,244,250,165,95,43,76,15,67,96
],[
2,2,2,2,3,2,2,3,2,2,73,124,12,20,69,132,69,178,204,12
],[
2,2,2,2,3,2,2,3,2,2,146,100,46,186,75,43,59,172,107,47
],[
2,2,2,2,3,2,2,3,2,2,76,105,169,84,131,23,228,13,83,239
],[
2,2,2,2,3,2,2,3,2,2,196,117,66,239,159,156,237,206,153,30
],[
2,2,2,2,3,2,2,3,2,2,77,53,16,251,58,44,55,162,45,211
],[
0,79,74,82,64,151,158,18,14,66,165,46,107,88,15,36,41,126,195,209
],[
5,131,37,156,23,55,148,241,108,124,55,241,241,159,250,103,146,232,211,254
],[
164,111,74,178,128,50,56,133,113,101,207,115,209,9,218,167,110,192,70,239
],[
51,224,226,110,4,198,99,145,233,109,171,68,111,63,75,101,75,42,70,120
],[
65,247,24,157,68,215,246,192,223,63,88,16,211,246,181,178,2,109,141,182
]
]