aLevelData = [
[
2,207,109,0,245,56,121,79,238,217,48,145,50,54,225,106,31,70,113,188
],[
2,98,14,161,214,96,117,142,232,213,83,126,186,186,203,217,158,109,219,118
],[
3,164,12,49,24,12,33,64,57,1,133,148,6,132,126,98,170,166,43,100
],[
2,207,250,34,227,98,74,87,22,151,137,64,170,46,9,54,162,244,238,31
],[
97,140,227,74,5,111,11,154,247,50,58,231,192,8,102,161,31,135,88,182
],[
88,175,167,182,206,40,231,54,212,203,30,114,193,100,119,54,66,182,59,254
],[
245,192,252,92,51,63,20,154,45,116,78,160,58,39,226,25,111,236,167,210
],[
113,165,132,98,135,72,39,16,243,227,250,241,131,221,83,81,99,126,236,84
],[
53,177,146,221,99,9,33,175,180,3,175,211,30,139,8,57,220,193,91,162
],[
192,252,50,188,201,15,167,143,248,204,213,25,96,199,142,53,125,93,76,194
],[
198,244,105,0,133,131,146,61,231,86,121,178,79,11,202,168,240,225,97,223
],[
155,50,186,47,213,61,168,112,45,41,74,152,205,71,59,35,78,152,10,184
],[
209,143,234,9,75,23,170,251,32,216,231,7,244,182,128,223,189,155,74,85
],[
29,119,5,121,240,133,143,2,33,207,88,240,193,244,22,111,90,41,186,253
],[
128,126,162,207,170,99,16,113,64,106,219,174,245,78,100,175,87,53,204,103
],[
164,50,100,46,224,14,101,171,36,72,226,248,57,90,250,1,102,62,82,45
],[
133,49,195,65,92,183,79,129,43,223,90,24,130,200,22,185,85,100,64,135
],[
82,124,10,50,114,244,88,99,207,81,46,91,181,120,105,215,251,184,174,54
],[
148,11,161,221,97,153,87,219,73,126,13,201,140,205,26,244,84,213,34,191
],[
142,163,141,66,247,200,55,55,122,92,105,23,185,66,9,128,234,174,13,218
]
]