aLevelData = [
[
2,2,2,2,5,5,2,2,90,11,16,42,12,192,201,179,153,232,40,80
],[
2,2,2,4,2,2,2,2,204,110,121,243,99,105,138,0,194,251,1,81
],[
5,3,3,3,5,5,3,3,233,120,242,125,164,203,177,90,1,22,229,192
],[
2,3,2,2,2,2,2,2,7,153,222,144,165,213,41,245,233,241,97,234
],[
2,3,2,2,2,2,2,2,115,92,71,253,40,180,21,82,43,231,16,234
],[
2,3,2,2,3,2,2,2,9,152,93,37,51,196,21,134,178,165,156,183
],[
2,3,2,2,3,2,2,2,22,214,46,205,175,185,186,204,0,22,244,110
],[
2,3,2,2,3,5,5,3,113,4,166,32,68,13,70,78,202,141,206,224
],[
2,3,3,2,3,2,2,3,215,91,200,5,115,171,168,47,210,51,95,95
],[
2,2,3,2,3,2,2,3,135,141,45,162,244,221,183,219,5,179,89,196
],[
2,2,3,2,3,2,2,3,30,51,189,48,81,115,173,147,213,36,37,195
],[
2,2,3,2,3,2,2,3,179,117,173,0,195,52,229,51,215,54,98,115
],[
2,2,2,2,3,2,2,3,54,250,184,205,76,137,216,69,159,160,157,24
],[
2,2,2,2,3,2,2,3,5,17,161,68,21,103,85,74,219,201,81,51
],[
2,2,2,2,3,2,2,3,208,33,232,209,8,125,0,71,174,181,32,204
],[
6,2,2,2,3,2,2,3,174,78,203,171,177,158,13,142,78,49,83,253
],[
8,2,2,2,3,2,2,3,126,108,128,34,81,112,60,207,224,65,143,194
],[
9,2,2,2,3,2,2,3,131,40,176,39,68,85,23,94,147,201,217,255
],[
10,2,2,2,3,5,5,5,59,115,53,27,148,153,106,197,250,122,204,209
],[
11,2,2,2,2,2,2,2,127,50,23,220,221,221,3,141,175,255,25,25
]
]