aLevelData = [
[
5,5,3,5,5,5,5,5,5,5,3,5,5,5,5,5,5,42,152,126
],[
4,2,3,5,5,5,5,5,5,5,3,5,5,5,5,5,5,110,39,16
],[
2,2,3,2,3,3,3,3,3,2,3,3,3,3,3,5,5,11,36,40
],[
223,100,6,0,30,143,12,150,170,67,38,230,29,5,211,72,253,145,239,245
],[
51,123,204,199,190,22,133,64,168,149,143,206,57,112,145,77,108,10,118,206
],[
159,144,192,151,142,36,31,107,130,59,66,11,198,67,237,252,91,138,76,139
],[
236,91,135,15,4,106,150,110,127,113,87,226,63,28,221,253,32,35,11,235
],[
45,181,98,248,20,29,24,81,215,160,106,15,197,164,51,113,169,24,188,105
],[
65,15,214,91,241,174,38,33,185,73,193,82,101,201,249,196,3,81,118,79
],[
154,33,136,212,25,186,187,126,142,66,172,72,152,43,28,192,31,16,67,10
],[
66,223,102,39,145,61,172,120,125,38,46,125,12,212,77,227,210,227,72,190
],[
28,178,14,19,110,12,80,153,48,8,219,192,164,45,37,243,27,218,37,26
],[
105,229,104,100,150,131,98,67,214,104,2,184,187,47,137,208,170,251,155,111
],[
140,95,150,76,197,123,36,61,106,104,12,181,174,215,78,138,158,244,110,252
],[
15,145,16,244,212,128,197,137,52,64,37,200,155,221,30,181,143,17,139,141
],[
230,175,8,78,54,65,5,121,142,240,26,23,99,165,154,250,205,110,107,69
],[
244,35,21,47,196,73,24,3,233,54,131,107,247,118,194,239,232,110,184,185
],[
204,63,14,155,188,238,202,83,16,193,35,13,210,236,147,41,114,108,47,63
],[
186,52,52,96,5,135,226,159,172,165,141,208,194,169,241,144,1,178,198,134
],[
3,65,148,232,182,226,201,64,10,15,9,112,236,81,197,243,120,168,15,103
]
]