aLevelData = [
[
4,2,5,5,2,2,2,2,51,177,71,197,57,6,82,204,239,188,227,56
],[
2,2,2,2,2,2,5,2,142,123,24,129,59,30,111,254,128,90,217,170
],[
2,2,2,2,2,2,3,3,253,160,16,39,91,68,43,3,130,222,112,59
],[
3,3,3,3,3,3,3,2,12,241,105,253,249,202,58,178,164,171,49,60
],[
2,2,3,2,2,2,2,2,245,41,159,124,217,211,230,24,239,20,212,123
],[
13,2,3,2,2,2,2,2,133,91,47,29,194,120,145,4,36,74,118,139
],[
2,5,3,2,2,2,2,2,46,151,148,98,90,59,107,214,85,133,28,82
],[
2,12,3,2,2,2,2,2,107,222,126,38,64,171,111,136,194,117,104,216
],[
5,2,3,3,3,3,3,3,91,71,85,41,107,88,163,252,245,234,154,78
],[
11,2,3,2,2,2,2,2,153,114,237,214,194,249,143,136,32,194,201,93
],[
2,5,3,2,2,2,2,2,89,45,138,86,251,219,254,191,182,19,97,177
],[
2,10,3,2,2,2,2,2,200,101,22,218,184,141,243,128,71,154,224,196
],[
5,2,2,2,2,2,2,2,164,79,160,36,223,201,238,68,160,98,204,238
],[
2,2,2,2,2,2,2,2,25,214,24,87,57,164,96,164,34,183,247,172
],[
9,5,3,2,2,2,2,2,222,70,72,0,77,249,107,41,98,77,246,48
],[
2,2,3,2,2,2,2,2,143,57,22,100,126,18,222,87,2,172,222,42
],[
5,8,3,2,2,2,2,2,77,194,248,10,99,151,111,251,207,222,65,212
],[
2,2,3,2,2,2,2,2,148,215,183,139,102,188,58,179,26,91,104,67
],[
6,5,3,3,3,3,3,3,92,4,103,153,160,165,121,191,91,52,209,236
],[
114,77,166,78,242,29,133,6,3,126,235,117,23,99,19,182,103,119,13,107
]
]