aLevelData = [
[
2,2,2,5,2,2,2,5,2,2,2,5,128,79,143,119,180,80,243,85
],[
61,145,225,186,191,49,203,226,218,100,228,191,10,197,42,235,204,238,164,224
],[
3,70,232,107,153,27,225,94,105,241,207,134,93,25,143,220,211,133,29,255
],[
70,218,87,226,42,199,4,194,23,150,20,92,42,0,41,92,169,70,87,24
],[
229,125,40,126,101,41,228,75,64,14,15,127,203,67,50,13,116,136,223,214
],[
238,217,239,216,143,68,14,163,246,247,122,13,240,157,7,39,157,235,103,112
],[
206,117,168,72,178,199,254,167,178,177,195,14,153,226,188,190,248,184,158,41
],[
201,87,208,166,82,249,115,104,76,133,160,177,69,98,240,67,67,141,66,24
],[
170,233,184,82,95,215,3,117,46,7,225,212,105,142,227,73,210,56,116,41
],[
187,31,23,119,108,124,240,88,197,190,134,199,37,217,199,138,138,225,77,101
],[
249,215,223,141,32,195,59,95,58,2,18,82,51,226,85,43,12,108,175,112
],[
130,129,83,30,234,41,247,158,96,39,32,246,32,209,161,61,52,30,94,81
],[
80,1,86,204,250,245,225,51,237,217,53,113,192,255,47,132,195,128,81,119
],[
42,210,7,144,109,156,46,202,238,200,214,133,221,218,71,125,88,129,67,249
],[
215,108,139,69,200,95,165,97,118,134,219,251,47,9,135,155,166,224,142,30
],[
150,233,43,101,168,56,238,78,151,174,4,227,146,205,184,210,226,202,58,30
],[
204,228,159,19,185,245,42,127,148,71,202,31,116,168,227,88,123,193,81,39
],[
254,163,171,91,229,163,196,2,85,104,120,33,141,66,165,168,14,189,119,164
],[
255,119,233,183,207,46,136,197,28,29,122,241,212,137,192,200,154,151,184,187
],[
107,96,230,211,129,71,243,160,119,139,246,115,175,24,243,205,241,163,161,22
]
]