aLevelData = [
[
4,2,2,2,2,2,2,223,97,43,8,48,46,193,144,252,225,166,40,159
],[
5,2,5,3,2,2,2,242,194,39,231,139,231,40,211,60,181,94,154,240
],[
187,39,239,32,222,227,132,70,255,6,205,149,216,108,6,231,39,237,119,247
],[
15,50,247,208,187,198,175,133,68,112,32,35,213,193,104,228,13,233,192,165
],[
164,207,74,154,82,96,10,65,236,38,49,148,209,29,162,131,132,195,175,161
],[
154,111,35,30,215,227,134,245,148,36,156,102,99,138,47,167,246,19,14,215
],[
61,252,86,51,207,147,240,140,139,71,91,249,127,1,172,201,9,183,211,187
],[
59,62,31,114,132,95,5,35,141,46,29,145,98,151,109,59,210,58,234,211
],[
24,121,60,243,187,206,194,12,178,98,214,159,204,220,82,175,79,119,82,118
],[
223,88,60,87,162,30,254,20,162,186,151,65,115,129,217,248,21,127,109,207
],[
27,15,23,7,13,169,59,6,12,250,161,7,180,58,117,17,71,186,146,37
],[
7,188,0,188,227,136,186,113,86,188,181,250,141,228,31,92,200,74,228,95
],[
2,16,119,64,212,123,207,167,151,146,176,216,201,232,43,45,177,182,104,196
],[
70,44,163,117,78,9,117,7,195,106,85,163,122,223,94,136,7,196,83,1
],[
219,207,224,148,175,229,34,125,38,50,106,91,173,120,62,40,166,167,161,110
],[
199,175,149,184,188,146,221,71,20,189,7,7,90,152,170,194,130,92,237,146
],[
136,37,72,156,83,72,143,251,223,230,44,251,155,193,171,136,16,79,125,230
],[
196,13,245,162,94,22,151,200,10,244,146,86,31,182,139,241,0,66,156,215
],[
64,237,157,21,9,73,162,250,190,62,196,203,223,93,37,184,45,112,46,15
],[
15,86,27,176,53,14,186,193,123,17,111,162,16,229,124,35,215,239,127,245
]
]