aLevelData = [
[
2,2,2,2,2,11,2,2,2,2,2,2,2,2,9,2,2,110,15,110
],[
2,2,2,2,2,2,2,2,2,2,2,2,2,2,2,2,2,67,219,249
],[
92,171,67,31,18,86,38,16,176,106,91,91,88,21,174,164,240,55,206,246
],[
35,91,103,91,169,236,139,170,201,166,86,161,28,74,210,51,147,150,24,35
],[
187,116,184,210,64,114,91,86,177,114,167,203,130,162,99,238,87,175,220,232
],[
128,54,135,103,191,124,231,243,82,94,177,128,45,139,47,63,136,240,226,186
],[
153,116,107,32,163,230,172,221,47,51,42,110,153,221,181,116,207,168,76,7
],[
86,151,59,76,142,22,134,74,54,121,138,249,50,165,226,156,140,13,136,81
],[
186,225,60,231,31,129,42,239,212,56,199,22,167,39,252,178,100,127,134,154
],[
84,244,157,59,4,110,211,232,71,1,64,114,126,31,220,249,23,12,44,1
],[
84,147,33,200,78,248,61,216,57,45,247,216,233,72,97,167,149,53,8,172
],[
220,168,27,103,5,86,208,76,139,101,4,210,217,33,34,199,82,240,69,230
],[
148,136,161,171,254,95,31,102,112,99,71,143,81,236,99,89,215,239,225,137
],[
130,116,250,137,234,74,145,184,187,249,94,5,254,248,75,188,154,32,30,159
],[
26,97,89,57,176,180,94,111,122,80,215,88,5,33,85,79,16,118,55,70
],[
146,250,206,93,254,229,191,179,197,115,168,123,28,150,6,83,1,231,86,210
],[
120,227,122,96,27,84,95,75,209,13,221,23,222,218,222,21,28,183,195,55
],[
135,64,3,34,255,105,21,133,74,111,145,169,89,15,146,74,204,245,94,166
],[
184,119,73,211,167,131,214,85,224,214,32,240,233,111,120,187,75,68,80,118
],[
149,51,88,29,163,59,230,189,32,236,155,135,74,28,68,35,245,220,254,71
]
]