aLevelData = [
[
12,2,2,2,2,2,2,2,2,78,153,229,233,214,15,148,235,230,226,89
],[
2,2,2,2,2,2,2,2,2,33,239,9,93,229,114,83,71,17,114,6
],[
2,2,3,3,3,3,3,3,3,82,193,41,198,163,91,250,185,217,205,167
],[
11,2,3,2,2,2,2,2,2,233,229,22,196,234,28,8,107,188,138,76
],[
50,242,138,166,90,20,148,122,73,67,85,144,58,27,5,20,52,222,245,225
],[
56,206,103,255,191,218,163,105,100,125,71,20,221,228,223,46,47,79,181,163
],[
34,185,235,230,243,187,198,238,74,174,77,127,107,16,19,170,176,40,81,151
],[
55,237,55,130,216,37,132,4,90,202,85,148,230,177,58,77,187,110,143,242
],[
36,114,10,47,167,118,144,33,128,29,77,25,78,212,3,157,11,253,162,176
],[
65,78,26,84,123,115,109,76,250,251,8,38,170,113,83,121,85,201,135,108
],[
21,255,192,119,15,250,83,110,94,182,97,187,78,162,172,234,203,71,170,108
],[
25,43,216,148,197,245,81,230,219,209,159,145,89,22,209,58,228,39,205,251
],[
186,151,232,172,232,144,180,97,189,117,25,51,126,198,168,68,91,68,43,253
],[
162,86,129,154,51,172,169,233,52,34,28,78,5,231,96,11,118,222,218,190
],[
56,68,228,43,146,148,31,60,85,167,10,70,18,32,212,142,138,7,111,12
],[
102,180,230,111,41,239,240,97,98,85,197,11,38,254,48,220,189,92,230,134
],[
156,102,22,74,147,246,65,118,72,112,76,44,228,165,212,100,12,247,193,52
],[
19,189,30,80,110,233,40,205,104,232,164,42,23,201,118,144,142,162,112,89
],[
84,47,104,208,21,189,141,55,152,70,251,15,241,222,140,147,248,77,241,134
],[
249,254,2,46,173,24,83,161,105,234,8,63,150,140,234,128,97,195,186,240
]
]