aLevelData = [
[
2,2,2,2,2,11,2,2,2,2,2,2,233,169,253,246,29,164,136,32
],[
2,2,2,2,2,2,2,2,2,2,2,2,127,35,96,217,211,229,24,245
],[
5,2,5,2,5,5,5,2,5,5,5,2,239,129,188,228,213,250,18,225
],[
5,2,5,2,5,2,5,2,5,2,5,2,31,147,31,109,160,229,237,252
],[
5,5,5,2,5,5,5,2,5,5,5,2,72,46,140,238,72,236,87,192
],[
5,2,5,2,5,2,5,2,5,2,2,2,119,171,120,132,244,27,175,142
],[
13,101,79,113,96,191,137,42,64,63,236,154,91,236,45,58,153,27,36,10
],[
71,249,24,202,116,100,60,109,155,255,121,203,131,133,110,150,100,93,182,143
],[
75,111,105,249,191,55,229,78,165,23,206,50,97,242,83,165,62,246,179,124
],[
16,185,0,18,24,136,36,59,39,252,33,121,6,205,157,115,22,235,157,162
],[
52,203,145,78,223,255,145,185,157,10,230,154,154,114,204,204,147,23,118,72
],[
242,194,83,81,59,1,144,238,166,51,222,157,14,223,117,70,9,74,88,110
],[
89,72,219,173,131,82,99,98,189,217,110,165,13,218,211,125,176,179,74,83
],[
185,53,46,167,250,250,130,2,39,248,51,44,57,87,156,158,17,128,79,58
],[
94,119,19,58,192,106,41,103,46,138,212,139,149,25,24,40,193,196,193,106
],[
129,52,167,91,6,224,49,86,141,37,24,190,62,152,109,239,83,155,222,117
],[
124,46,53,125,130,8,33,136,43,231,57,103,95,36,62,99,136,138,160,188
],[
63,104,68,85,36,229,133,173,13,148,121,17,100,72,117,16,202,42,211,48
],[
0,8,242,223,8,240,127,172,135,254,243,183,110,114,93,102,217,5,98,90
],[
56,126,130,162,172,128,157,46,180,166,181,134,8,210,245,188,197,193,242,158
]
]