aLevelData = [
[
2,2,2,2,2,2,2,2,2,2,2,2,2,2,2,25,54,102,108,5
],[
2,2,2,2,2,2,2,2,3,3,3,3,3,3,3,235,26,27,216,17
],[
2,2,3,2,3,2,2,2,2,3,2,2,2,2,2,11,97,255,239,179
],[
2,2,3,2,3,2,2,2,2,2,3,2,2,2,2,222,107,68,42,89
],[
2,2,3,2,3,2,2,2,2,2,2,3,2,2,2,149,54,74,88,191
],[
2,2,3,2,2,2,2,2,2,2,2,2,3,2,2,139,18,237,124,27
],[
2,2,3,2,3,3,3,3,3,3,3,3,3,2,2,72,210,114,133,98
],[
2,2,3,2,2,2,2,2,2,2,2,2,2,2,2,184,95,34,167,221
],[
2,2,3,2,3,3,3,3,3,3,3,3,3,3,3,90,55,146,221,92
],[
2,2,3,2,2,2,2,2,2,2,2,2,2,2,2,111,119,202,254,136
],[
2,2,3,3,3,3,3,3,3,3,3,3,3,3,3,104,126,132,76,90
],[
1,2,3,2,2,2,2,2,2,2,2,2,2,2,2,48,27,195,132,70
],[
95,167,8,106,32,24,213,224,102,145,204,23,178,27,34,126,135,192,5,152
],[
41,67,130,83,165,14,166,150,17,108,227,25,21,248,182,121,171,86,135,140
],[
34,32,209,242,105,35,130,236,138,204,165,113,117,221,62,127,255,100,117,176
],[
42,238,247,13,167,248,154,38,153,166,64,99,156,184,253,149,6,185,124,208
],[
109,121,158,125,105,190,101,171,154,55,17,166,237,177,136,203,28,141,251,154
],[
116,114,199,13,219,63,153,40,17,68,214,210,54,177,58,227,141,78,191,126
],[
127,109,192,161,227,30,94,250,124,161,35,253,195,33,229,51,231,159,237,213
],[
19,44,89,153,239,91,191,204,105,246,19,161,181,240,203,201,146,155,64,67
]
]