aLevelData = [
[
12,226,18,218,234,55,198,228,157,231,154,248,236,150,245,245,9,68,33,13
],[
2,48,198,242,211,116,119,169,148,190,43,23,235,19,100,6,144,21,201,212
],[
2,113,205,211,97,4,167,202,44,219,190,240,184,121,90,252,53,100,183,201
],[
11,92,123,9,80,155,138,188,212,114,28,0,92,29,144,133,102,115,111,131
],[
218,14,253,254,61,172,14,72,39,213,27,199,247,190,149,248,197,110,121,180
],[
152,31,37,179,217,231,106,78,8,151,226,137,174,228,132,80,147,196,117,1
],[
48,27,33,43,103,151,139,150,114,216,225,131,26,213,84,52,41,123,39,175
],[
33,151,5,192,46,245,151,61,90,201,86,141,0,79,158,107,131,175,4,232
],[
63,35,234,175,192,91,81,141,50,33,238,49,25,57,127,48,67,139,95,76
],[
250,132,88,245,126,185,185,16,178,205,169,248,21,149,187,194,244,123,195,198
],[
222,32,231,90,89,70,249,225,211,236,4,5,219,186,36,64,145,160,155,161
],[
91,187,34,205,218,120,125,68,29,251,82,229,20,194,59,181,71,133,26,220
],[
199,97,173,240,101,54,98,118,35,78,108,166,232,63,22,111,120,18,87,187
],[
162,164,167,244,188,77,18,199,76,192,139,40,8,50,130,150,1,191,185,160
],[
27,9,83,168,192,34,46,231,213,172,114,177,237,62,106,250,189,10,147,26
],[
209,189,243,205,125,167,172,126,21,28,209,197,96,26,120,46,75,43,17,60
],[
219,141,246,173,101,145,67,0,1,65,231,53,60,69,251,212,13,8,83,48
],[
11,22,83,237,220,201,4,192,241,36,103,118,112,255,10,56,114,100,216,13
],[
111,58,53,160,246,32,75,68,162,156,158,53,73,117,231,32,118,93,31,230
],[
26,211,218,158,126,72,214,217,124,129,212,41,239,60,166,228,104,22,138,37
]
]