aLevelData = [
[
2,2,2,2,2,2,2,2,2,2,2,2,2,2,187,149,229,208,41,191
],[
2,2,13,5,5,2,2,12,5,5,2,3,2,5,76,35,212,18,154,174
],[
2,2,2,5,5,2,2,2,5,5,2,3,2,5,30,184,89,155,19,223
],[
2,2,2,2,2,2,2,2,2,2,2,3,2,2,18,36,156,26,30,14
],[
2,2,2,2,2,2,2,2,2,2,2,3,3,3,246,3,185,115,99,38
],[
2,2,2,2,2,2,2,2,2,2,2,2,2,2,88,197,32,26,61,16
],[
2,2,2,2,2,2,2,2,2,2,2,2,2,3,150,241,72,127,212,211
],[
2,2,2,2,2,2,2,2,2,2,2,2,2,2,16,34,61,229,50,238
],[
2,2,2,2,2,2,2,2,2,2,3,2,2,2,126,111,233,6,196,63
],[
2,2,2,2,2,2,2,2,2,3,3,2,3,2,223,57,43,72,67,203
],[
2,2,2,2,2,2,2,2,3,3,2,9,3,3,121,143,28,120,12,72
],[
2,2,2,2,2,2,2,2,3,2,2,2,3,3,221,182,17,59,57,59
],[
4,2,2,2,2,2,2,3,2,2,2,2,3,2,247,109,56,191,35,253
],[
139,3,230,76,29,18,172,96,234,198,118,139,20,143,138,71,51,112,104,101
],[
237,74,1,103,200,93,36,42,59,12,57,200,11,224,49,188,213,208,189,71
],[
230,192,190,19,83,71,253,23,71,181,29,186,151,85,206,59,156,239,67,80
],[
65,145,229,13,91,143,73,8,57,201,95,187,124,44,237,41,41,124,60,197
],[
253,80,18,143,1,94,223,128,94,248,59,40,113,215,144,150,34,24,20,120
],[
114,132,251,131,84,20,234,21,190,180,174,25,255,72,46,44,83,237,158,253
],[
181,129,246,250,244,101,163,41,9,129,124,83,168,137,247,104,21,127,157,31
]
]