aLevelData = [
[
4,2,2,2,2,2,2,2,2,2,2,2,2,2,2,2,2,10,226,32
],[
5,2,5,3,2,2,2,2,2,2,2,2,2,2,2,2,2,72,148,19
],[
2,5,5,3,3,3,3,3,3,3,3,3,3,3,3,3,3,94,87,82
],[
3,3,5,5,5,5,5,5,5,5,3,2,2,2,2,2,2,94,49,3
],[
2,3,5,5,5,5,5,5,5,5,3,6,2,2,2,2,2,32,188,253
],[
3,3,5,5,5,5,3,3,3,3,3,3,3,3,3,2,3,48,36,80
],[
3,5,5,5,5,5,3,2,2,2,2,2,2,2,2,2,2,167,63,12
],[
3,5,5,3,3,3,3,8,2,2,2,5,5,5,5,5,5,155,251,224
],[
3,5,5,3,2,2,3,3,3,3,2,5,3,3,3,5,3,150,243,75
],[
3,5,5,3,2,2,2,2,2,3,2,5,3,5,5,5,5,39,86,49
],[
3,5,5,3,2,2,3,2,2,3,2,5,3,5,5,5,5,89,227,180
],[
5,5,5,3,2,2,3,2,2,3,2,5,3,5,5,5,5,171,120,43
],[
52,98,237,57,250,124,155,124,141,244,224,232,219,144,186,145,125,19,46,120
],[
61,180,234,164,213,208,41,117,250,220,215,54,153,157,245,241,97,155,64,135
],[
129,211,13,255,179,172,120,31,121,44,189,57,166,108,230,72,33,73,167,60
],[
230,93,134,145,77,46,62,38,143,164,102,77,134,193,78,30,180,140,42,18
],[
135,78,114,205,219,1,136,58,193,6,156,221,127,22,205,101,216,123,144,129
],[
141,128,86,245,35,38,105,237,231,24,23,145,48,225,19,217,228,93,24,163
],[
61,109,207,3,205,239,243,218,192,238,179,170,98,21,88,168,225,106,39,19
],[
83,57,137,197,250,77,105,8,199,102,222,170,30,232,10,84,217,209,66,23
]
]