aLevelData = [
[
4,2,2,2,2,2,2,2,2,2,2,2,2,2,2,216,160,173,141,69
],[
5,2,5,3,2,2,2,2,2,2,2,2,2,2,2,195,76,217,39,10
],[
2,5,5,3,3,3,3,3,3,3,3,3,3,3,3,239,197,36,22,5
],[
3,3,5,5,5,5,5,5,5,5,3,2,2,2,2,21,187,245,177,111
],[
206,153,113,109,94,137,254,241,151,215,115,185,12,82,176,51,67,252,1,146
],[
116,191,251,33,142,91,167,215,123,163,227,44,165,233,4,44,185,183,192,202
],[
171,192,76,118,250,21,193,242,53,156,196,97,190,191,102,161,206,97,73,218
],[
185,22,5,87,115,147,201,149,83,99,70,154,24,220,200,136,42,82,166,114
],[
34,138,221,110,139,113,248,236,234,14,51,70,253,182,223,152,65,127,8,209
],[
182,247,86,10,230,21,49,23,36,111,40,92,18,174,148,226,102,63,120,171
],[
237,76,172,66,208,235,59,149,22,149,9,7,106,217,185,194,30,81,205,74
],[
113,214,15,88,13,240,48,229,212,144,176,133,220,2,253,246,184,29,223,249
],[
250,189,19,96,245,115,55,105,200,122,230,74,152,237,35,13,28,56,251,158
],[
95,205,102,35,193,24,111,139,63,180,148,106,245,223,112,4,225,43,151,167
],[
234,119,194,63,33,30,44,36,70,110,59,54,142,92,99,44,163,117,72,41
],[
237,24,34,144,16,227,102,26,182,107,163,38,142,48,169,80,149,208,241,68
],[
148,122,57,213,233,166,111,73,139,3,208,247,73,177,81,21,82,177,62,203
],[
250,154,33,139,187,141,229,165,122,106,59,22,12,68,61,161,249,19,81,34
],[
128,169,81,30,219,232,233,158,196,49,64,62,55,31,218,129,122,118,189,103
],[
91,86,210,66,185,181,143,197,69,12,211,94,138,79,17,198,43,35,177,214
]
]