aLevelData = [
[
5,5,3,5,5,5,5,111,43,74,101,92,146,209,218,30,41,184,105,231
],[
4,2,3,5,5,5,5,169,221,71,169,149,206,153,131,213,222,54,128,160
],[
2,2,3,2,3,3,3,121,175,128,160,180,141,118,81,40,217,212,171,1
],[
5,2,2,2,3,2,2,226,68,0,82,58,153,39,172,2,5,218,238,103
],[
2,2,2,3,2,2,2,140,93,94,109,184,96,249,236,143,39,8,215,194
],[
2,2,2,3,2,2,5,232,244,196,39,117,91,169,105,26,99,228,255,201
],[
2,2,2,2,2,2,5,79,127,90,116,80,177,99,187,157,168,36,199,197
],[
5,2,2,2,2,2,5,133,197,118,68,169,187,184,85,47,60,57,8,185
],[
2,2,5,5,3,2,5,246,64,148,112,0,215,238,70,17,44,155,127,240
],[
2,2,5,5,3,2,5,55,194,111,43,157,133,133,12,212,145,136,201,136
],[
2,2,3,3,3,2,5,244,33,251,62,48,154,81,56,141,229,134,152,179
],[
2,2,3,2,2,2,5,224,144,200,119,215,27,24,246,74,53,169,224,241
],[
2,2,3,2,2,2,5,75,139,23,254,84,34,121,162,76,206,249,210,228
],[
2,2,3,2,5,2,3,202,245,75,120,85,196,212,65,16,142,195,204,168
],[
2,2,2,2,5,2,3,96,194,170,180,127,211,106,225,253,146,196,76,139
],[
2,2,2,2,5,2,5,186,23,47,142,235,22,192,117,171,189,86,73,170
],[
2,2,3,3,3,2,3,139,206,133,74,235,45,41,94,243,134,10,50,80
],[
2,2,3,5,5,2,3,31,108,205,129,207,210,114,68,170,21,109,78,225
],[
2,3,3,5,5,2,3,180,12,63,227,107,235,213,200,7,116,96,240,120
],[
167,118,231,40,23,231,140,139,53,243,115,248,209,187,135,183,222,246,244,91
]
]