aLevelData = [
[
5,5,5,5,5,2,2,2,2,157,55,231,207,221,82,72,212,148,22,124
],[
5,2,2,2,2,2,2,2,2,251,29,200,196,77,230,105,42,126,106,221
],[
5,2,5,3,3,3,3,3,3,20,43,95,76,26,96,48,201,21,93,173
],[
2,2,5,2,3,2,2,2,2,49,120,154,2,86,228,8,229,93,246,154
],[
2,2,3,2,3,2,2,2,2,20,101,100,4,255,106,72,195,193,104,187
],[
2,2,3,2,3,3,3,3,3,93,85,195,166,234,7,230,213,211,40,42
],[
4,2,3,2,2,2,2,2,2,77,218,6,250,224,90,28,54,254,208,133
],[
2,2,3,2,2,3,3,3,3,212,206,155,183,205,125,0,109,55,215,113
],[
2,2,2,2,2,3,2,2,2,229,174,20,15,76,249,244,109,119,235,14
],[
2,3,2,2,2,3,2,2,2,151,211,134,100,83,159,103,60,166,88,94
],[
2,3,2,2,2,3,2,2,2,43,154,117,92,115,63,85,146,143,240,118
],[
2,3,2,3,3,2,2,3,2,215,11,215,231,74,153,180,0,57,98,217
],[
2,3,2,3,6,2,2,3,3,80,66,154,121,215,184,87,35,117,73,163
],[
138,163,221,207,135,97,192,11,97,111,4,52,75,192,33,237,46,44,223,241
],[
169,101,118,168,87,44,243,248,80,197,221,93,242,168,25,60,225,121,11,116
],[
76,58,254,55,114,192,198,24,101,99,163,100,14,250,105,182,114,7,222,198
],[
51,46,100,130,90,236,216,96,83,133,185,242,57,62,141,187,85,205,128,65
],[
225,14,79,99,17,247,100,237,84,206,67,106,215,153,36,57,74,215,225,227
],[
232,109,19,172,177,227,120,104,250,208,153,144,40,147,169,149,185,68,175,116
],[
132,235,232,139,65,239,102,171,75,209,254,110,165,25,97,203,59,145,137,231
]
]