aLevelData = [
[
10,2,2,8,2,2,2,2,2,2,250,138,174,57,100,112,214,112,236,136
],[
2,2,2,2,2,2,2,2,2,2,182,155,80,241,0,110,0,166,209,102
],[
2,2,2,2,2,2,3,3,3,3,23,166,66,9,144,82,58,111,183,22
],[
9,2,2,2,2,2,2,2,2,3,134,1,221,75,43,129,80,92,250,75
],[
3,3,3,3,3,3,3,2,2,3,139,40,102,218,169,168,147,141,32,210
],[
2,2,2,2,2,2,2,2,2,3,175,171,171,189,133,166,136,5,79,156
],[
2,2,2,2,2,2,2,2,2,3,228,113,204,35,148,211,147,70,5,48
],[
2,2,2,2,2,2,2,2,2,2,167,203,118,33,75,184,100,121,24,21
],[
2,2,2,2,2,2,2,2,2,2,70,40,76,242,123,96,101,172,129,246
],[
2,2,2,2,3,3,3,3,2,2,239,109,103,10,154,242,133,234,143,145
],[
2,2,2,2,3,2,2,3,2,2,106,52,4,122,22,59,14,61,106,172
],[
2,2,2,2,3,2,2,3,2,2,183,140,220,114,81,66,111,214,10,165
],[
2,2,2,2,3,2,2,3,2,2,227,235,192,232,40,41,22,245,25,88
],[
2,2,2,2,3,2,2,3,2,2,199,105,103,176,58,223,211,62,87,113
],[
2,2,2,2,3,2,2,3,2,2,161,137,154,124,73,118,101,164,111,105
],[
2,2,2,2,3,2,2,3,2,2,155,24,21,173,106,23,16,22,104,180
],[
2,2,2,2,3,2,2,3,2,2,184,228,226,214,228,235,112,130,22,241
],[
2,2,2,2,3,2,2,3,2,2,205,93,242,88,230,108,245,253,49,31
],[
3,3,3,3,3,2,2,3,3,2,99,95,64,142,129,4,150,2,5,24
],[
2,2,1,2,2,2,2,2,2,2,185,183,203,88,137,224,201,46,207,236
]
]