aLevelData = [
[
4,2,5,5,2,2,2,2,2,2,2,2,2,2,2,2,2,2,2,2
],[
2,2,2,2,2,2,5,2,2,2,5,2,2,2,5,3,3,3,3,2
],[
2,2,2,2,2,2,3,3,3,3,3,3,3,2,2,2,2,5,2,2
],[
3,3,3,3,3,3,3,2,2,2,2,2,3,2,2,2,2,5,2,2
],[
2,2,3,2,2,2,2,2,2,2,2,2,3,2,2,2,2,3,2,2
],[
13,2,3,2,2,2,2,2,2,3,2,2,3,2,2,2,2,3,2,2
],[
2,5,3,2,2,2,2,2,2,3,2,2,3,2,2,2,2,3,2,2
],[
2,12,3,2,2,2,2,2,2,3,2,2,3,2,2,2,2,3,2,2
],[
5,2,3,3,3,3,3,3,3,3,2,2,3,3,3,3,3,3,2,2
],[
11,2,3,2,2,2,2,2,2,2,2,2,2,2,2,2,2,5,2,2
],[
2,5,3,2,2,2,2,2,2,2,2,2,2,2,2,2,2,5,2,2
],[
2,10,3,2,2,2,2,2,2,2,2,2,2,2,2,2,2,3,2,2
],[
5,2,2,2,2,2,2,2,2,2,2,2,2,2,2,2,2,3,2,2
],[
2,2,2,2,2,2,2,2,2,2,2,2,2,2,2,2,2,3,2,2
],[
9,5,3,2,2,2,2,2,2,2,2,2,2,2,2,2,2,3,2,2
],[
145,47,97,156,167,194,108,104,185,104,40,115,27,247,155,251,36,60,240,203
],[
129,250,111,95,207,48,173,73,106,155,0,212,127,124,54,230,105,155,135,43
],[
58,140,199,111,151,49,225,76,202,128,128,6,18,134,15,179,61,172,228,159
],[
121,58,184,238,104,25,91,131,114,221,165,33,95,3,176,208,37,118,68,131
],[
254,88,147,247,190,0,39,222,100,63,24,61,239,232,130,19,115,143,54,59
]
]