aLevelData = [
[
4,2,2,2,2,2,2,2,2,2,238,82,190,218,216,154,15,177,57,5
],[
5,2,5,3,2,2,2,2,2,2,104,26,221,186,161,163,237,210,197,55
],[
2,5,5,3,3,3,3,3,3,3,112,197,184,58,17,34,29,214,35,132
],[
3,3,5,5,5,5,5,5,5,5,118,143,226,193,141,30,252,100,20,124
],[
2,3,5,5,5,5,5,5,5,5,80,94,136,61,245,248,91,31,126,12
],[
3,3,5,5,5,5,3,3,3,3,81,227,124,117,43,91,69,196,131,197
],[
3,5,5,5,5,5,3,2,2,2,244,52,247,87,177,225,137,27,51,52
],[
3,5,5,3,3,3,3,8,2,2,70,253,130,162,38,35,2,150,52,124
],[
3,5,5,3,2,2,3,3,3,3,173,171,238,156,160,31,239,199,217,133
],[
3,5,5,3,2,2,2,2,2,3,203,75,63,185,59,19,226,25,122,122
],[
3,5,5,3,2,2,3,2,2,3,133,242,238,93,90,57,11,116,12,124
],[
5,5,5,3,2,2,3,2,2,3,117,226,2,23,100,10,227,171,77,165
],[
5,5,5,3,2,2,3,2,2,3,85,204,191,17,11,250,139,236,254,211
],[
5,3,3,3,2,2,3,2,2,3,39,226,250,134,84,195,93,139,255,217
],[
5,3,2,2,2,2,3,2,2,3,28,146,101,120,6,185,123,214,77,1
],[
5,3,3,2,2,2,3,2,5,5,141,29,66,3,37,191,96,223,46,10
],[
140,118,89,252,155,217,192,88,21,0,202,249,56,192,78,103,64,247,251,168
],[
230,10,247,89,39,145,198,253,70,80,110,148,20,106,216,112,111,209,122,68
],[
9,1,51,126,107,238,118,214,57,58,171,39,183,172,210,126,140,222,106,113
],[
198,53,145,179,31,22,108,229,126,87,201,174,193,244,3,13,186,4,38,238
]
]