aLevelData = [
[
6,2,2,2,2,2,2,2,254,103,235,84,172,154,219,41,123,127,118,187
],[
2,2,2,2,2,2,2,2,224,73,116,241,237,76,37,235,27,181,87,77
],[
2,2,2,2,2,2,2,2,70,121,122,219,249,139,2,71,236,82,13,70
],[
3,3,3,3,3,3,3,3,203,90,70,233,57,74,9,43,21,22,200,199
],[
2,2,2,2,2,2,2,2,252,117,173,76,15,150,128,114,246,14,204,175
],[
2,2,2,2,2,2,2,2,37,22,61,6,93,243,77,32,118,181,31,157
],[
2,2,2,2,2,3,2,2,93,36,171,172,89,248,28,217,146,72,118,39
],[
2,2,3,3,3,3,3,3,211,69,124,95,143,40,209,167,34,105,93,86
],[
2,2,2,2,2,2,2,2,90,50,242,7,54,19,48,237,237,247,166,102
],[
2,2,2,2,2,2,2,2,50,87,57,210,183,173,202,165,240,44,19,187
],[
3,3,3,3,3,3,3,3,25,174,210,236,122,238,42,225,234,247,70,37
],[
2,2,2,2,2,2,2,2,146,220,63,127,243,170,64,128,43,155,232,88
],[
2,2,2,2,2,2,2,2,115,140,239,238,237,177,13,47,157,136,23,165
],[
2,2,3,3,3,3,3,3,180,11,108,76,21,42,143,162,18,120,21,254
],[
2,2,3,2,2,2,2,2,118,37,194,34,201,44,239,19,207,205,46,41
],[
82,62,49,98,33,158,232,251,89,42,234,66,227,179,22,166,62,80,122,16
],[
127,80,116,118,150,114,22,173,210,89,207,126,168,58,72,253,176,216,141,22
],[
240,178,109,105,93,122,35,88,159,202,54,93,21,19,157,161,25,214,39,203
],[
133,22,26,22,117,13,26,167,79,30,77,29,1,11,189,105,138,104,254,224
],[
188,79,16,142,64,86,134,206,218,190,232,24,238,237,87,25,68,30,111,9
]
]