aLevelData = [
[
12,2,2,2,2,2,242,175,142,92,158,4,191,121,123,22,209,167,6,122
],[
2,2,2,2,2,2,218,54,156,42,180,36,153,31,73,72,194,34,14,209
],[
2,2,3,3,3,3,224,223,206,239,174,59,169,208,245,231,92,206,246,53
],[
11,2,3,2,2,2,195,231,8,43,156,109,130,215,141,254,219,225,105,183
],[
2,2,3,2,2,2,16,103,175,165,70,4,83,124,177,50,193,140,180,211
],[
2,2,3,2,2,2,32,240,74,10,211,9,164,79,70,43,20,195,231,149
],[
10,2,3,2,2,2,41,192,114,167,28,181,114,79,106,49,5,197,195,61
],[
2,2,3,2,2,2,223,120,35,239,145,72,63,60,11,245,34,14,96,215
],[
2,2,3,2,2,2,24,150,202,208,203,228,238,128,172,181,97,183,148,140
],[
9,2,3,2,2,2,106,48,171,4,10,124,138,100,57,60,156,116,115,147
],[
2,2,3,2,2,2,202,143,115,219,87,250,63,151,8,116,100,169,137,14
],[
2,2,3,2,2,3,131,198,12,61,12,38,51,46,74,128,48,89,160,53
],[
8,2,3,2,2,3,43,89,18,204,227,251,6,158,153,149,76,210,42,153
],[
2,2,3,2,3,3,93,140,123,105,224,98,25,109,115,16,33,100,167,108
],[
2,2,3,2,3,2,94,247,76,156,178,148,240,134,183,121,162,136,165,15
],[
252,105,119,122,96,144,73,110,129,116,5,68,37,84,62,77,42,40,92,102
],[
199,215,250,204,21,170,140,50,206,1,69,17,84,69,56,64,245,29,189,196
],[
109,229,22,233,172,92,82,146,218,156,114,205,153,80,203,170,138,33,171,78
],[
18,113,63,67,94,76,180,18,164,155,157,20,172,155,149,133,144,142,37,218
],[
192,177,232,84,72,109,236,214,86,209,92,244,246,64,92,76,33,103,53,25
]
]