aLevelData = [
[
6,2,8,2,9,2,10,2,11,3,2,2,245,91,154,123,44,140,194,12
],[
2,2,2,2,2,2,2,2,12,3,5,2,159,1,54,121,57,205,73,28
],[
2,2,3,3,3,3,3,3,3,3,2,2,2,164,112,227,55,157,246,62
],[
2,2,3,2,2,2,2,2,2,2,5,2,160,54,240,60,30,153,116,241
],[
2,2,3,2,2,2,2,2,2,2,2,2,132,30,6,26,167,16,83,4
],[
2,2,3,2,3,3,3,3,3,3,2,5,185,180,34,169,210,135,135,28
],[
2,2,3,2,2,2,2,5,5,3,2,2,208,200,89,40,97,54,231,52
],[
2,2,3,5,5,5,2,3,3,3,5,2,94,27,231,106,91,137,175,25
],[
124,228,168,87,138,160,255,234,69,76,157,105,252,208,90,158,92,243,109,47
],[
134,32,39,125,100,105,226,205,60,204,52,166,133,181,104,121,250,197,46,136
],[
238,210,145,0,223,47,42,104,77,45,147,63,204,225,31,225,89,40,200,171
],[
234,233,105,95,73,154,46,202,33,6,72,164,89,77,229,183,162,44,95,68
],[
76,126,179,162,94,3,54,40,229,97,131,77,140,104,184,14,109,154,226,144
],[
39,235,181,7,49,197,129,214,110,79,97,248,1,239,182,158,98,14,211,25
],[
177,27,250,251,75,210,136,121,156,190,108,20,52,252,221,121,28,67,77,165
],[
106,33,152,76,19,135,130,124,1,136,96,126,101,94,21,253,79,174,64,105
],[
124,13,180,158,110,194,41,193,194,205,49,107,191,41,109,10,43,79,0,132
],[
98,251,68,29,169,50,188,154,191,132,74,166,181,143,162,118,0,196,255,169
],[
205,110,21,114,148,239,70,248,240,77,24,253,174,238,231,190,35,160,215,27
],[
195,221,13,248,240,76,31,227,16,138,200,247,226,43,225,0,18,252,140,224
]
]