aLevelData = [
[
5,5,3,5,5,124,104,57,52,104,18,57,130,216,241,71,146,60,77,226
],[
4,2,3,5,5,246,172,104,144,49,113,249,125,201,199,219,102,158,225,7
],[
2,2,3,2,3,181,121,46,192,238,232,219,13,73,74,153,108,161,38,160
],[
5,2,2,2,3,197,140,193,243,157,204,239,230,140,230,41,222,241,16,224
],[
2,2,2,3,2,89,228,80,17,46,108,227,26,21,242,220,204,105,246,13
],[
2,2,2,3,2,193,45,1,42,239,78,219,44,126,39,253,244,215,74,73
],[
2,2,2,2,2,49,254,126,249,131,33,4,214,225,113,31,170,56,48,211
],[
5,2,2,2,2,247,84,11,236,233,4,171,66,138,121,135,60,53,240,252
],[
2,2,5,5,3,147,77,145,159,88,46,150,210,57,100,175,149,0,28,165
],[
2,2,5,5,3,159,92,215,62,174,228,102,98,27,89,18,123,177,43,27
],[
2,2,3,3,3,34,191,63,100,247,108,240,108,208,75,84,128,23,47,192
],[
2,2,3,2,2,47,109,65,142,255,147,79,29,94,139,103,26,219,250,165
],[
2,2,3,2,2,254,150,209,73,216,245,44,12,77,153,123,181,221,145,223
],[
2,2,3,2,5,231,104,205,215,61,240,213,27,153,160,187,200,184,13,77
],[
2,2,2,2,5,190,10,189,144,70,193,230,106,249,40,119,159,221,55,92
],[
2,2,2,2,5,255,208,100,254,221,42,187,10,194,158,49,116,99,97,54
],[
2,2,3,3,3,187,209,142,137,110,240,202,80,239,42,36,104,119,100,62
],[
2,2,3,5,5,250,90,49,178,79,141,70,175,229,101,47,227,194,161,64
],[
158,8,171,205,52,202,27,158,163,30,125,157,117,115,84,210,232,37,95,145
],[
77,79,26,242,174,225,136,130,179,242,48,56,198,87,101,171,118,116,203,129
]
]