aLevelData = [
[
6,2,8,2,9,166,159,236,201,151,238,208,232,24,17,183,136,123,97,161
],[
2,2,2,2,2,120,226,196,242,90,248,137,200,168,227,147,140,244,116,186
],[
2,2,3,3,3,199,116,161,110,55,189,54,157,35,207,199,215,235,82,233
],[
2,2,3,2,2,177,227,31,162,103,97,2,29,197,21,190,162,71,153,82
],[
2,2,3,2,2,198,127,73,123,223,183,85,122,187,216,21,23,146,138,156
],[
230,56,157,143,201,151,168,56,182,93,239,214,187,242,138,55,63,173,196,137
],[
138,71,194,110,136,144,101,78,201,96,112,241,205,209,238,77,127,171,206,156
],[
255,32,209,178,164,186,166,142,66,145,83,47,168,193,214,169,109,27,12,119
],[
237,27,211,19,142,26,107,196,72,197,35,183,100,206,49,82,131,226,225,197
],[
227,218,242,226,222,53,60,46,179,198,151,56,137,170,249,41,177,125,222,157
],[
44,205,237,177,109,207,216,93,95,81,132,5,170,240,106,74,51,139,61,38
],[
225,248,204,56,167,245,43,92,191,97,13,127,51,172,117,178,162,140,142,124
],[
65,241,214,117,32,60,130,16,175,171,31,185,128,24,117,32,78,228,176,212
],[
63,46,194,19,102,72,3,225,140,107,26,87,48,169,33,62,204,36,4,220
],[
90,126,42,14,23,144,88,151,135,95,210,184,185,75,195,1,204,138,222,102
],[
178,213,70,149,52,97,171,135,54,17,182,85,61,234,168,78,46,199,62,70
],[
89,78,215,48,181,34,216,240,109,90,80,106,156,51,216,223,85,1,190,121
],[
231,108,98,36,95,216,223,160,78,37,238,212,204,153,8,102,188,26,203,136
],[
82,161,159,21,211,235,153,220,156,114,160,60,102,155,206,241,200,49,24,45
],[
253,18,50,234,232,40,173,127,85,155,99,114,130,69,20,142,222,103,81,53
]
]