aLevelData = [
[
2,2,2,2,2,2,2,2,2,2,2,2,2,2,2,2,2,2,122,188
],[
108,230,4,118,114,121,160,226,165,181,175,178,133,107,204,223,176,17,164,53
],[
85,104,7,18,236,93,63,107,36,45,160,15,29,205,96,48,216,137,169,31
],[
236,235,237,87,122,222,122,189,98,19,78,38,183,164,44,26,113,248,239,216
],[
98,230,31,153,108,29,194,25,240,195,116,84,137,92,186,141,251,238,148,149
],[
102,98,81,74,192,46,167,94,129,49,3,90,160,222,30,226,191,157,209,58
],[
163,110,42,9,230,208,191,93,240,225,66,240,35,198,86,170,86,77,161,102
],[
133,209,35,249,198,95,198,112,127,22,54,154,215,212,242,199,106,15,164,206
],[
65,0,174,85,1,7,5,76,98,75,66,187,227,161,246,190,189,175,62,205
],[
21,81,152,65,117,59,245,20,125,224,16,233,214,147,253,76,104,236,5,58
],[
205,110,177,228,5,102,37,176,107,22,175,129,231,19,160,56,102,236,91,123
],[
135,12,171,181,151,226,90,93,192,63,255,124,125,255,23,105,81,235,87,215
],[
185,222,65,18,95,39,246,134,144,47,75,129,240,92,30,58,109,52,235,17
],[
113,198,154,24,92,69,155,211,49,247,53,60,143,77,27,10,228,84,65,51
],[
221,76,237,176,33,149,17,128,62,211,216,239,227,74,127,24,81,138,102,169
],[
12,81,103,230,214,173,102,241,221,97,41,72,52,138,106,143,128,130,43,144
],[
244,5,74,128,127,146,85,131,67,20,159,115,74,194,148,221,116,68,73,77
],[
180,23,88,204,124,50,234,166,118,234,21,113,117,19,105,74,171,104,197,98
],[
28,45,111,186,82,18,100,42,83,91,237,168,208,62,115,199,159,140,148,126
],[
108,148,119,43,171,69,92,215,208,146,119,188,195,27,254,4,142,9,129,212
]
]