aLevelData = [
[
5,5,3,5,5,5,5,5,235,189,19,221,139,12,218,177,219,1,141,27
],[
4,2,3,5,5,5,5,5,79,207,234,248,35,80,172,32,159,63,246,59
],[
2,2,3,2,3,3,3,3,154,167,245,215,61,155,194,184,9,40,133,111
],[
27,136,224,47,175,152,139,219,228,141,59,99,191,226,201,81,113,148,144,159
],[
221,146,23,204,85,111,240,47,164,91,223,138,82,81,63,226,35,146,162,142
],[
225,81,184,143,91,176,114,31,174,235,102,140,195,211,118,71,25,127,172,56
],[
197,62,105,85,183,207,191,115,62,213,27,92,207,133,39,33,2,162,238,178
],[
221,171,66,171,85,83,90,113,18,49,192,126,115,185,107,249,210,107,39,138
],[
9,74,62,108,52,144,81,196,185,160,135,49,134,60,234,164,154,248,13,114
],[
199,238,242,167,182,180,44,158,43,139,65,206,138,217,82,231,155,218,254,30
],[
138,146,131,196,50,6,38,30,154,171,214,113,192,31,12,92,150,23,245,106
],[
75,153,211,232,203,107,161,244,137,203,245,215,124,96,43,149,103,113,192,194
],[
94,85,252,150,134,42,212,68,28,202,14,136,185,251,166,127,212,230,113,188
],[
136,203,0,152,151,242,199,201,176,229,126,55,237,220,200,11,160,121,19,8
],[
79,181,191,30,253,27,130,60,171,52,11,103,31,66,229,9,228,48,159,139
],[
146,202,42,37,80,42,130,245,150,114,144,79,56,193,80,85,160,95,47,199
],[
90,59,183,28,215,152,109,209,106,3,250,1,151,136,138,54,141,37,114,127
],[
241,127,21,194,221,212,8,84,41,49,116,199,233,229,188,3,54,53,96,152
],[
50,81,34,83,70,135,103,16,174,183,223,206,56,7,104,9,72,215,48,68
],[
32,248,26,229,94,24,100,69,198,129,134,8,66,4,93,170,39,47,136,91
]
]