aLevelData = [
[
2,2,2,2,2,11,2,2,74,92,70,88,33,121,65,171,152,254,56,121
],[
2,2,2,2,2,2,2,2,90,118,215,201,32,73,50,115,46,54,101,53
],[
5,2,5,2,5,5,5,2,32,253,119,2,230,92,133,157,14,61,28,103
],[
5,2,5,2,5,2,5,2,65,46,230,118,17,17,137,230,242,21,204,116
],[
5,5,5,2,5,5,5,2,133,229,252,72,29,31,142,19,124,7,5,90
],[
5,2,5,2,5,2,5,2,221,125,22,18,56,44,10,108,193,5,101,242
],[
5,2,5,2,5,2,5,2,177,236,197,211,74,176,12,123,21,65,193,103
],[
2,2,2,12,2,2,2,2,111,29,180,56,67,12,225,6,25,13,151,246
],[
2,2,7,2,2,2,2,2,80,144,218,15,167,229,5,73,3,245,180,231
],[
108,48,224,7,88,198,76,120,44,26,32,203,0,116,212,173,162,245,80,116
],[
222,209,82,247,253,184,15,163,140,149,29,203,95,123,144,64,213,220,100,34
],[
92,253,27,245,56,166,166,247,129,30,137,177,107,87,59,205,203,101,203,39
],[
214,52,201,39,43,123,100,77,20,236,208,13,8,174,235,222,117,12,31,142
],[
189,111,138,216,126,137,92,56,23,212,129,254,104,59,129,162,217,22,164,87
],[
157,92,89,226,56,20,216,173,62,13,7,23,94,207,154,15,160,209,127,225
],[
235,237,121,79,202,16,11,228,111,54,151,133,249,150,199,73,242,25,44,139
],[
28,17,37,61,109,40,3,126,88,150,106,111,78,152,250,67,133,29,47,150
],[
248,194,134,0,175,0,226,233,64,164,45,159,150,128,66,165,241,97,11,79
],[
46,65,230,139,73,189,78,2,32,201,183,96,121,162,185,239,71,4,113,107
],[
41,158,37,18,52,195,38,250,242,98,251,167,170,56,187,221,226,68,187,179
]
]