aLevelData = [
[
2,2,2,2,2,2,2,2,2,2,2,2,2,2,2,2,2,188,140,152
],[
2,2,2,2,2,2,2,2,2,2,2,2,2,2,2,2,2,114,154,239
],[
2,2,2,2,2,2,2,2,2,2,2,2,2,2,2,2,2,182,121,153
],[
2,2,2,13,2,2,2,2,2,2,2,2,2,2,2,2,2,238,1,4
],[
2,2,2,2,2,2,2,2,2,2,2,2,2,2,2,2,2,243,48,143
],[
2,2,2,2,2,2,2,2,2,2,2,2,2,2,2,2,2,160,145,71
],[
2,2,2,2,2,2,2,2,2,2,2,2,2,2,2,2,2,187,11,194
],[
2,2,2,2,2,2,2,2,2,1,2,2,2,2,2,2,2,146,119,63
],[
2,2,11,2,2,2,2,2,2,2,2,2,2,2,2,2,2,51,97,227
],[
2,2,2,2,2,2,2,2,2,2,2,2,2,2,2,2,2,171,28,91
],[
2,2,2,2,2,2,2,2,2,2,2,2,2,2,2,2,2,30,196,183
],[
2,2,2,2,2,2,2,2,2,2,2,2,2,2,2,2,2,29,91,188
],[
2,2,2,2,2,2,2,2,2,2,2,2,2,2,2,2,2,246,36,56
],[
2,2,2,2,2,2,2,2,2,2,2,2,2,2,2,2,2,145,117,237
],[
2,9,2,2,2,2,2,2,2,2,2,2,2,2,2,2,2,76,74,174
],[
2,2,2,2,2,2,2,2,2,2,2,2,2,2,2,12,2,90,255,126
],[
2,2,2,2,2,2,2,2,2,2,2,2,2,2,2,2,2,108,88,159
],[
2,2,2,6,2,2,2,2,2,2,2,2,2,2,2,2,2,21,130,191
],[
2,2,2,2,2,2,2,2,2,2,2,2,2,2,2,2,2,176,82,188
],[
2,2,2,2,2,2,2,2,2,2,2,2,2,2,2,2,2,122,131,18
]
]