aLevelData = [
[
2,2,2,2,2,2,2,2,2,6,5,2,2,2,2,2,2,2,7,146
],[
2,3,5,3,5,5,5,3,5,3,5,2,5,3,5,3,5,5,184,163
],[
2,3,2,3,2,2,2,3,5,3,5,2,5,3,5,3,5,5,189,16
],[
2,2,2,2,2,2,2,2,2,2,2,2,5,5,5,5,5,5,159,11
],[
2,3,5,3,5,5,5,3,2,3,5,5,5,3,2,3,5,5,111,119
],[
2,3,5,3,5,5,5,3,2,3,5,5,5,3,2,3,5,5,52,45
],[
2,5,5,5,5,5,5,5,5,5,5,5,5,2,2,5,5,5,167,57
],[
2,3,5,3,5,5,5,3,5,3,5,5,5,3,5,3,5,5,242,41
],[
2,3,5,3,5,5,5,3,5,3,5,5,5,3,5,3,5,5,80,164
],[
2,5,5,5,5,5,5,5,5,5,5,5,5,5,5,5,5,5,190,224
],[
2,3,5,3,2,2,2,3,2,3,2,2,2,3,2,3,5,5,27,182
],[
5,3,5,3,2,2,2,3,2,3,2,2,2,3,2,3,5,5,109,99
],[
5,5,5,5,5,5,5,5,5,5,5,5,5,5,5,5,5,5,34,50
],[
5,3,5,3,5,5,5,3,5,3,5,5,2,3,2,3,5,5,135,170
],[
5,3,5,3,5,5,5,3,5,3,5,5,2,3,2,3,5,5,204,243
],[
1,5,5,5,5,5,5,5,5,5,5,5,5,5,5,5,5,5,74,138
],[
240,129,242,225,61,226,56,20,217,179,25,187,72,119,216,154,144,46,70,212
],[
154,42,65,91,220,30,123,171,53,120,125,184,24,240,235,36,237,97,9,182
],[
180,216,126,8,236,235,88,127,179,77,81,128,46,159,80,225,43,136,51,158
],[
5,7,204,206,200,8,41,213,150,54,25,218,74,17,235,124,90,64,121,192
]
]