aLevelData = [
[
5,5,3,5,5,5,5,5,5,5,3,5,5,5,5,5,5,87,91,90
],[
4,2,3,5,5,5,5,5,5,5,3,5,5,5,5,5,5,105,137,239
],[
2,2,3,2,3,3,3,3,3,2,3,3,3,3,3,5,5,96,79,39
],[
5,2,2,2,3,2,2,2,2,2,5,5,5,5,5,5,5,99,88,177
],[
2,2,2,3,2,2,2,2,2,2,5,5,5,5,5,5,5,107,154,230
],[
2,2,2,3,2,2,5,3,3,2,3,3,3,3,3,5,5,170,211,173
],[
2,2,2,2,2,2,5,5,3,2,2,2,2,2,2,2,2,16,62,33
],[
5,2,2,2,2,2,5,5,3,2,2,2,2,2,2,2,2,225,90,238
],[
2,2,5,5,3,2,5,5,3,2,3,3,3,5,5,3,5,165,215,47
],[
2,2,5,5,3,2,5,5,3,6,3,3,5,5,5,3,5,138,190,3
],[
2,2,3,3,3,2,5,5,3,5,5,3,5,5,5,3,5,131,71,159
],[
2,2,3,2,2,2,5,5,3,5,5,5,3,5,5,3,5,95,183,18
],[
2,2,3,2,2,2,5,5,3,5,5,5,3,3,5,3,5,79,97,189
],[
2,2,3,2,5,2,3,3,3,5,5,5,3,3,5,3,5,35,243,42
],[
2,2,2,2,5,2,3,5,5,5,5,5,5,3,5,3,5,124,212,80
],[
2,2,2,2,5,2,5,5,5,5,5,5,5,5,5,3,5,0,118,180
],[
2,2,3,3,3,2,3,3,5,5,5,5,3,5,3,3,5,140,254,168
],[
2,2,3,5,5,2,3,5,5,5,5,3,5,5,5,3,5,215,52,10
],[
2,3,3,5,5,2,3,5,3,5,5,5,5,5,5,5,5,177,113,132
],[
8,55,163,226,77,135,149,171,87,123,197,50,187,161,159,6,94,153,77,116
]
]