aLevelData = [
[
2,2,2,168,15,38,166,201,170,152,207,26,147,135,66,61,244,70,154,181
],[
2,2,2,84,20,173,74,105,155,6,174,45,189,150,96,52,144,166,209,60
],[
5,3,3,167,16,198,6,148,175,253,100,170,20,19,148,8,122,165,204,211
],[
2,3,2,252,182,22,194,6,80,94,224,10,110,201,141,116,26,73,198,223
],[
2,3,2,211,111,167,137,49,128,46,4,204,202,66,47,89,56,244,101,22
],[
2,3,2,37,4,244,105,110,167,209,195,203,135,138,203,95,12,123,185,141
],[
2,3,2,218,69,255,14,155,124,47,64,254,160,25,193,255,79,51,61,106
],[
2,3,2,184,63,132,154,83,39,224,135,208,44,165,0,77,63,9,52,203
],[
2,3,3,175,54,119,227,5,158,67,181,45,143,125,34,214,7,250,59,26
],[
2,2,3,201,66,248,98,176,148,46,132,68,42,187,47,139,189,3,137,34
],[
2,2,3,76,161,22,139,26,86,220,201,246,69,197,42,190,99,68,101,38
],[
2,2,3,41,59,228,182,140,29,99,18,46,80,186,126,214,213,247,161,30
],[
2,2,2,42,176,137,107,111,152,240,34,201,79,190,25,4,127,207,76,124
],[
2,2,2,36,245,210,61,43,65,15,105,63,126,42,218,224,255,193,9,181
],[
2,2,2,155,220,46,35,245,32,169,30,1,70,161,63,195,203,235,23,90
],[
6,2,2,232,45,196,62,196,67,193,198,233,225,3,237,244,122,65,85,145
],[
8,2,2,97,147,140,167,47,62,143,208,100,206,140,12,81,102,236,182,53
],[
85,145,183,166,233,92,249,50,136,243,31,71,252,193,115,80,15,62,31,33
],[
88,112,161,149,84,178,121,117,185,180,36,156,6,195,78,89,95,74,68,21
],[
152,153,168,54,144,230,104,67,192,145,240,72,19,173,159,124,248,187,120,33
]
]