aLevelData = [
[
6,233,251,179,240,120,214,204,229,27,170,94,77,205,21,218,227,48,193,148
],[
2,187,210,149,36,30,175,45,12,149,248,136,156,68,19,1,19,121,227,129
],[
2,7,133,73,242,7,203,235,247,126,22,52,218,218,48,156,198,238,176,41
],[
3,54,149,19,53,173,153,14,115,168,211,35,45,208,147,115,207,117,66,211
],[
2,169,56,69,33,241,7,37,217,7,79,237,227,253,108,212,175,87,101,28
],[
2,132,15,214,58,21,221,45,55,86,181,25,86,141,144,64,247,172,111,49
],[
187,222,157,153,233,96,53,185,17,146,229,23,239,78,241,116,145,120,123,255
],[
188,214,1,200,141,34,39,119,92,94,183,62,229,104,230,12,170,206,217,4
],[
147,227,103,45,216,19,33,107,32,115,143,174,235,156,189,105,45,186,246,70
],[
59,224,208,24,235,159,105,16,247,214,239,53,163,203,102,14,160,123,165,161
],[
47,47,162,162,138,80,240,228,127,124,134,19,94,217,194,165,21,170,174,14
],[
154,32,129,51,137,114,105,34,15,48,135,0,6,212,59,66,97,154,163,33
],[
203,145,94,71,139,242,150,207,171,177,61,108,89,83,150,232,141,255,248,209
],[
236,215,207,111,237,137,227,248,58,32,221,7,89,33,7,75,139,211,83,124
],[
244,222,159,148,253,23,55,59,247,155,155,131,1,27,131,213,43,118,33,44
],[
219,141,166,128,112,83,7,134,38,35,1,150,57,87,91,236,78,22,107,20
],[
14,109,219,160,20,161,173,28,9,196,125,68,13,135,6,116,89,79,232,95
],[
35,139,169,4,194,68,249,222,19,245,58,91,27,158,63,144,238,20,84,43
],[
207,155,127,169,152,182,6,201,93,62,49,64,76,178,81,174,215,206,1,209
],[
22,95,172,248,102,85,80,187,87,26,129,234,197,34,176,195,68,196,173,104
]
]