aLevelData = [
[
10,169,242,86,221,222,11,39,89,229,207,149,39,120,94,76,16,204,108,70
],[
2,251,196,159,156,105,101,56,156,67,138,246,29,213,216,55,15,26,245,97
],[
2,86,58,245,128,217,81,21,49,213,114,172,190,120,236,94,138,171,203,147
],[
9,176,47,162,39,231,235,136,100,169,132,97,45,148,47,95,123,16,195,200
],[
3,14,50,19,249,92,224,122,171,206,54,183,117,43,41,251,146,84,106,65
],[
2,229,51,141,222,58,238,107,89,207,96,197,124,19,201,42,171,173,196,26
],[
2,117,192,122,107,105,109,22,236,43,154,121,73,199,242,46,46,68,45,160
],[
2,175,125,146,138,232,44,186,176,224,72,150,205,180,145,180,204,241,105,189
],[
2,58,65,229,67,252,74,36,185,61,211,223,195,171,40,66,177,227,192,250
],[
2,69,41,30,144,189,93,245,245,13,42,143,94,109,129,111,81,19,70,54
],[
2,0,66,73,195,215,131,119,158,81,51,82,151,15,61,158,170,43,41,93
],[
2,38,202,86,254,15,240,131,210,192,153,148,191,212,5,147,56,71,83,246
],[
2,108,217,81,32,190,179,147,42,118,77,194,226,182,143,55,20,175,55,200
],[
9,20,122,226,78,207,238,217,182,244,167,123,162,243,160,235,128,17,93,173
],[
146,25,207,253,241,78,120,101,209,165,208,142,6,49,230,87,200,223,74,36
],[
179,99,43,120,17,114,189,199,92,50,221,133,255,239,248,131,93,15,41,123
],[
20,72,161,234,131,16,76,29,138,85,178,143,144,111,27,114,203,83,246,140
],[
187,9,123,68,248,96,144,253,46,224,233,162,102,0,116,130,135,153,244,95
],[
28,155,235,193,87,255,190,144,86,252,20,226,166,126,127,18,6,212,94,18
],[
109,168,2,2,78,53,15,1,26,180,37,67,7,23,192,99,16,250,93,251
]
]