aLevelData = [
[
2,246,137,108,27,120,210,93,33,27,18,109,201,222,212,71,31,114,149,193
],[
2,176,253,124,191,228,24,69,84,142,25,127,43,194,152,247,38,231,44,116
],[
2,68,12,118,164,200,128,97,87,152,156,167,235,227,228,152,7,6,79,23
],[
141,177,226,229,201,69,131,34,239,129,13,16,196,94,160,27,155,55,59,22
],[
131,45,140,200,191,202,6,167,118,229,53,227,172,197,78,166,113,137,11,155
],[
88,198,181,173,43,115,130,17,221,2,34,134,192,208,149,219,248,191,63,178
],[
48,33,62,133,140,217,251,230,222,188,255,11,28,62,9,137,18,74,93,96
],[
84,113,94,56,119,71,95,234,128,10,183,66,157,133,19,4,19,52,17,44
],[
120,169,10,122,34,46,46,46,223,172,215,17,230,204,23,180,14,91,147,252
],[
62,243,149,222,37,216,92,104,43,32,183,1,167,23,210,241,82,225,79,36
],[
252,97,152,42,125,90,116,131,239,212,217,26,26,194,2,15,48,225,192,185
],[
187,227,21,236,211,205,255,119,148,158,146,241,207,49,73,182,0,100,158,44
],[
128,122,216,75,252,190,37,92,38,105,232,0,170,198,84,117,100,148,58,21
],[
208,172,31,31,194,228,146,186,87,50,189,55,43,21,57,151,204,48,39,77
],[
111,56,124,69,226,17,156,36,194,52,43,210,238,84,31,54,59,65,26,64
],[
106,12,248,45,87,108,163,6,114,96,47,106,115,22,35,142,74,12,20,130
],[
85,117,121,182,214,222,186,188,164,17,138,79,33,58,119,149,107,72,191,161
],[
215,150,102,60,155,203,133,229,202,255,229,22,134,31,204,201,113,146,23,59
],[
100,28,137,240,100,3,99,247,209,113,53,111,225,26,243,74,77,30,75,81
],[
74,49,54,104,187,249,206,20,165,183,95,58,227,42,192,42,27,177,228,219
]
]