aLevelData = [
[
2,2,2,2,5,5,2,2,2,2,2,2,2,2,95,131,76,198,140,140
],[
2,2,2,4,2,2,2,2,2,2,2,5,2,2,200,204,69,62,85,122
],[
5,3,3,3,5,5,3,3,3,3,3,3,3,3,122,31,113,37,190,195
],[
2,3,2,2,2,2,2,2,2,3,2,2,2,2,115,152,65,238,29,88
],[
2,3,2,2,2,2,2,2,2,3,2,2,2,2,254,249,116,45,53,119
],[
2,3,2,2,3,2,2,2,2,3,2,2,2,2,207,221,28,24,47,59
],[
2,3,2,2,3,2,2,2,2,3,2,2,2,2,210,205,206,96,148,44
],[
2,3,2,2,3,5,5,3,3,3,3,3,2,2,251,57,51,23,36,66
],[
2,3,3,2,3,2,2,3,2,2,2,3,2,2,197,152,53,144,155,16
],[
2,2,3,2,3,2,2,3,2,1,2,3,2,2,33,21,116,145,189,32
],[
2,2,3,2,3,2,2,3,2,2,2,3,2,2,240,136,213,35,72,159
],[
2,2,3,2,3,2,2,3,2,2,2,3,2,2,122,185,59,225,153,231
],[
76,31,210,162,42,147,134,146,112,196,50,22,142,169,252,136,7,17,140,194
],[
222,67,29,225,74,225,212,73,177,18,80,233,212,223,130,192,72,222,191,159
],[
37,14,19,49,2,3,217,58,32,67,136,28,229,239,208,159,140,166,230,241
],[
28,166,28,236,150,52,180,152,115,63,246,241,77,64,128,234,221,100,222,177
],[
37,237,90,53,238,213,21,230,117,181,87,187,98,230,36,122,249,230,16,52
],[
148,253,84,14,81,32,32,72,8,21,51,119,128,216,170,21,226,62,21,60
],[
109,216,208,175,108,26,145,26,101,188,61,155,148,97,0,128,151,119,156,83
],[
107,94,1,20,151,204,31,197,167,112,248,44,220,213,249,212,34,138,138,85
]
]