aLevelData = [
[
2,2,2,2,2,2,2,2,131,101,203,169,82,60,190,171,249,127,139,189
],[
2,2,2,2,2,2,2,2,154,90,2,123,45,113,135,208,200,23,112,195
],[
2,2,2,2,2,2,2,2,30,193,175,148,71,186,177,8,191,24,134,1
],[
2,2,2,3,3,3,3,3,176,238,65,81,116,195,162,208,85,67,242,173
],[
2,2,2,2,2,2,2,2,152,53,47,1,187,173,105,170,250,131,108,86
],[
2,2,2,2,2,2,2,2,24,3,159,222,91,230,44,214,217,130,97,98
],[
2,2,2,2,2,3,2,2,242,61,87,74,30,71,209,81,233,137,102,195
],[
59,216,227,78,221,111,235,18,57,156,224,251,97,185,7,79,83,94,230,131
],[
124,213,241,83,122,206,102,18,38,84,118,62,210,0,165,87,207,109,115,241
],[
51,235,60,9,216,120,93,149,168,236,152,94,24,115,186,18,243,64,122,149
],[
89,128,165,153,7,141,120,110,217,101,77,27,140,90,123,173,201,11,119,207
],[
95,146,63,155,209,255,248,176,16,6,213,133,137,244,60,253,98,231,36,59
],[
1,63,194,183,207,80,100,145,59,89,157,38,1,186,162,226,172,97,244,85
],[
89,134,63,136,191,152,130,145,108,119,113,101,81,227,24,238,129,53,192,93
],[
54,76,22,194,21,203,138,217,179,130,246,39,87,41,128,70,2,84,193,126
],[
172,163,39,149,209,57,151,231,44,112,87,185,195,203,44,202,35,45,191,43
],[
237,72,69,81,145,87,95,105,90,16,63,235,171,212,13,114,136,42,137,203
],[
87,107,241,75,232,191,37,102,180,71,9,126,98,156,43,249,144,121,166,150
],[
207,180,70,1,239,115,236,165,126,156,52,193,139,141,86,190,175,14,74,192
],[
79,131,48,123,27,103,238,72,218,245,27,119,106,40,28,231,2,230,140,213
]
]