aLevelData = [
[
2,2,2,2,2,2,2,2,2,2,2,201,212,30,179,138,111,240,144,57
],[
2,2,2,2,2,2,2,2,2,2,2,208,203,71,124,15,53,214,169,60
],[
2,2,2,2,2,2,2,2,2,2,2,203,245,231,246,134,74,144,57,62
],[
2,2,2,3,3,3,3,3,3,3,3,224,218,120,108,214,183,236,52,84
],[
2,2,2,2,2,2,2,2,2,2,2,249,43,163,195,186,252,53,62,251
],[
2,2,2,2,2,2,2,2,2,2,2,106,154,67,139,23,185,175,43,211
],[
2,2,2,2,2,3,2,2,3,2,2,246,233,239,109,176,93,231,201,14
],[
2,2,2,3,3,3,3,3,3,3,3,44,255,51,252,33,36,243,112,232
],[
168,34,242,122,232,188,91,220,44,246,221,9,206,209,67,45,159,239,122,19
],[
134,165,81,225,106,83,125,3,82,240,224,101,203,233,11,229,139,44,1,8
],[
83,127,61,235,26,23,247,125,103,102,164,236,255,52,188,93,192,241,191,224
],[
205,74,122,163,235,250,135,102,43,227,19,46,202,93,227,62,85,206,153,67
],[
16,123,52,207,153,157,215,8,201,184,203,162,219,40,198,10,208,252,110,228
],[
17,8,25,184,87,54,215,232,200,29,178,230,99,213,52,163,157,9,42,75
],[
76,77,168,47,197,178,77,3,65,152,200,73,134,196,155,13,195,179,31,211
],[
187,45,201,206,37,29,171,82,83,159,62,140,19,91,94,113,211,18,150,244
],[
8,118,158,124,208,63,34,149,213,123,197,229,117,37,102,99,33,250,162,195
],[
3,136,154,52,228,136,246,78,76,109,42,70,235,61,247,101,55,160,53,184
],[
87,55,209,8,64,46,18,12,30,21,32,222,245,235,198,172,136,124,119,176
],[
122,238,143,98,179,150,220,236,5,16,93,222,15,142,73,35,98,112,83,52
]
]