aLevelData = [
[
2,2,2,2,2,2,2,2,2,2,2,2,2,2,2,2,205,254,96,139
],[
2,2,13,5,5,2,2,12,5,5,2,3,2,5,5,2,130,232,194,65
],[
2,2,2,5,5,2,2,2,5,5,2,3,2,5,5,2,17,107,238,230
],[
2,2,2,2,2,2,2,2,2,2,2,3,2,2,2,2,235,192,130,174
],[
2,2,2,2,2,2,2,2,2,2,2,3,3,3,3,3,70,217,251,52
],[
2,2,2,2,2,2,2,2,2,2,2,2,2,2,6,2,29,82,214,18
],[
2,2,2,2,2,2,2,2,2,2,2,2,2,3,3,3,120,165,245,176
],[
2,2,2,2,2,2,2,2,2,2,2,2,2,2,2,2,237,157,69,89
],[
2,2,2,2,2,2,2,2,2,2,3,2,2,2,2,2,103,13,158,148
],[
38,193,234,177,7,181,138,162,6,133,245,12,1,37,162,158,191,210,41,162
],[
48,72,165,209,246,54,92,108,37,239,162,136,71,98,250,170,164,76,127,147
],[
192,172,130,93,36,120,117,199,97,142,7,206,83,237,145,125,163,37,177,5
],[
143,12,52,16,238,179,58,83,110,152,148,98,33,29,113,201,56,57,58,88
],[
14,110,186,190,104,251,130,90,251,82,140,77,46,204,30,212,34,156,241,213
],[
239,2,147,183,49,193,10,119,196,210,186,248,203,90,137,155,247,218,64,16
],[
6,165,52,108,137,152,39,123,235,5,105,87,175,240,66,57,249,126,149,144
],[
80,170,189,80,162,58,187,141,136,241,147,72,204,7,243,137,41,214,22,174
],[
81,214,232,2,53,203,107,145,128,61,89,59,100,41,11,8,154,246,153,187
],[
164,170,67,170,86,94,15,204,148,240,180,20,93,247,183,253,9,252,212,103
],[
206,231,159,161,137,183,107,199,187,118,107,78,210,108,23,221,171,148,209,94
]
]