aLevelData = [
[
2,2,2,2,2,2,2,2,2,148,160,131,50,209,227,17,199,148,82,214
],[
2,2,2,2,2,2,2,2,2,129,141,50,23,96,77,30,13,134,251,242
],[
2,2,2,2,2,2,2,2,2,60,62,72,232,0,62,164,1,105,41,179
],[
2,2,2,13,2,2,2,2,2,167,72,88,250,144,138,218,223,229,197,185
],[
2,2,2,2,2,2,2,2,2,208,164,17,127,194,67,25,249,221,150,114
],[
2,2,2,2,2,2,2,2,2,59,117,242,43,228,61,147,165,164,183,59
],[
2,2,2,2,2,2,2,2,2,164,251,239,28,167,67,105,248,117,240,88
],[
2,2,2,2,2,2,2,2,2,135,249,23,16,25,79,45,190,124,31,18
],[
2,2,11,2,2,2,2,2,2,87,32,42,77,206,121,34,154,138,165,191
],[
162,23,79,15,9,28,211,14,173,141,162,118,45,33,233,216,169,7,109,236
],[
201,213,185,38,1,193,124,137,19,19,45,192,213,218,240,107,52,222,189,183
],[
121,215,191,49,203,220,250,220,245,30,49,128,106,214,7,70,134,124,100,130
],[
23,58,26,208,28,160,201,98,205,153,0,152,219,158,164,209,248,41,150,130
],[
154,109,144,133,252,68,80,179,102,105,249,180,175,231,182,22,0,209,160,157
],[
218,52,226,218,91,74,26,255,189,240,3,242,31,90,82,160,136,6,221,148
],[
41,238,2,200,226,2,71,187,8,213,62,195,102,151,172,165,129,67,233,99
],[
33,25,138,85,12,79,62,123,21,4,246,18,85,117,73,101,185,115,22,230
],[
189,21,107,125,118,170,165,32,214,241,217,164,44,141,115,211,234,179,29,190
],[
171,38,227,85,116,101,148,52,58,34,107,192,165,247,238,115,20,85,23,116
],[
225,189,178,107,230,50,6,147,64,238,183,17,82,84,235,132,13,38,172,221
]
]