aLevelData = [
[
12,2,2,2,2,2,2,2,2,2,2,32,148,92,11,152,21,102,139,129
],[
2,2,2,2,2,2,2,2,2,2,2,97,170,132,130,213,34,220,125,33
],[
211,83,190,166,161,9,121,35,103,65,115,145,71,100,255,75,63,73,44,114
],[
253,179,61,144,245,27,89,123,176,176,132,125,103,157,206,177,208,138,202,176
],[
56,101,66,109,210,98,41,94,79,64,209,221,174,207,95,205,86,175,123,128
],[
98,90,76,216,60,100,163,173,109,2,118,111,179,202,145,13,84,185,136,21
],[
179,122,240,28,33,229,206,96,245,199,80,172,223,225,187,124,121,51,165,98
],[
31,122,100,168,1,247,198,55,118,114,3,183,148,127,239,248,253,0,116,145
],[
251,235,64,199,208,77,187,176,71,143,60,152,143,248,124,163,73,116,75,180
],[
224,148,129,142,25,213,56,57,235,37,56,168,144,163,179,152,220,167,51,187
],[
206,2,208,22,101,135,166,167,180,202,134,76,57,39,236,224,107,6,49,167
],[
146,94,2,236,219,120,17,232,172,246,10,230,53,19,201,165,72,44,202,254
],[
106,128,225,198,42,52,43,246,177,154,68,9,155,178,186,166,5,241,194,127
],[
231,66,42,121,165,75,143,13,224,241,208,238,146,30,194,236,90,193,38,24
],[
20,23,216,41,173,42,73,30,53,151,46,37,54,147,122,188,69,48,138,22
],[
214,221,160,192,85,44,147,132,114,217,197,142,188,7,84,205,113,204,149,156
],[
148,240,190,162,65,242,226,246,62,76,35,135,210,248,35,188,218,51,187,87
],[
25,129,240,159,208,241,34,190,142,162,135,104,74,134,216,189,175,102,74,113
],[
183,39,192,42,123,75,63,41,74,187,162,45,248,195,143,148,120,94,169,196
],[
173,180,7,201,126,225,230,63,41,248,154,115,217,71,203,197,122,221,221,81
]
]