aLevelData = [
[
2,2,2,135,24,70,14,240,14,22,201,130,81,164,90,94,77,61,41,91
],[
2,2,2,80,133,158,87,144,105,63,203,112,86,24,162,255,168,96,76,193
],[
2,2,2,102,89,14,179,44,120,156,137,104,198,233,58,201,134,62,190,245
],[
2,2,2,24,138,22,123,29,249,142,8,220,199,63,221,229,87,215,128,243
],[
2,2,2,127,157,178,23,38,175,162,19,18,142,96,4,251,221,148,69,228
],[
2,2,2,102,112,143,171,94,227,101,222,234,16,175,208,226,254,165,236,212
],[
2,2,2,145,238,74,76,185,9,128,82,233,237,187,53,203,236,14,135,50
],[
2,2,2,221,9,105,80,122,142,9,41,7,224,104,71,53,253,97,175,69
],[
2,2,2,46,231,21,112,220,142,76,135,165,76,0,215,175,129,167,79,60
],[
2,2,2,54,181,229,127,162,15,53,175,243,195,107,89,75,246,100,250,8
],[
2,2,3,30,16,205,72,113,27,226,172,156,204,112,93,185,45,108,77,123
],[
2,2,2,108,90,192,172,129,100,10,218,17,169,154,77,146,215,55,60,177
],[
2,2,2,252,138,64,240,153,221,8,148,249,34,79,190,192,55,11,216,199
],[
104,231,50,39,54,244,237,148,86,155,25,237,253,215,26,16,91,161,80,243
],[
101,171,247,241,216,80,75,97,123,203,240,109,164,168,146,34,253,121,201,195
],[
136,202,63,99,225,87,20,178,196,124,129,24,206,236,188,0,136,166,28,119
],[
161,37,126,245,123,215,231,122,234,209,107,221,56,193,77,97,108,36,103,138
],[
203,185,204,47,160,53,173,207,57,56,121,41,50,128,72,6,246,93,122,90
],[
130,100,155,139,108,104,138,17,36,166,219,63,123,64,121,96,97,237,144,6
],[
243,238,170,159,181,68,24,73,27,32,147,232,79,155,35,117,46,167,64,153
]
]