aLevelData = [
[
4,2,5,5,2,2,2,2,2,2,2,2,2,2,2,2,2,2,249,35
],[
2,2,2,2,2,2,5,2,2,2,5,2,2,2,5,3,3,3,0,76
],[
2,2,2,2,2,2,3,3,3,3,3,3,3,2,2,2,2,5,243,202
],[
3,3,3,3,3,3,3,2,2,2,2,2,3,2,2,2,2,5,147,64
],[
2,2,3,2,2,2,2,2,2,2,2,2,3,2,2,2,2,3,77,88
],[
13,2,3,2,2,2,2,2,2,3,2,2,3,2,2,2,2,3,82,3
],[
2,5,3,2,2,2,2,2,2,3,2,2,3,2,2,2,2,3,73,216
],[
2,12,3,2,2,2,2,2,2,3,2,2,3,2,2,2,2,3,178,129
],[
5,2,3,3,3,3,3,3,3,3,2,2,3,3,3,3,3,3,47,69
],[
11,2,3,2,2,2,2,2,2,2,2,2,2,2,2,2,2,5,81,54
],[
157,146,228,78,31,237,112,11,255,69,190,104,95,10,9,252,132,52,249,32
],[
117,134,213,84,197,20,244,223,173,3,116,182,94,144,47,159,148,83,235,150
],[
111,197,209,112,127,1,33,190,29,199,35,244,2,198,97,203,18,27,19,227
],[
121,21,219,173,249,59,178,136,130,144,34,42,4,21,183,66,129,144,176,91
],[
102,140,249,4,27,161,94,46,217,245,249,213,188,3,236,227,25,155,86,81
],[
17,42,127,143,102,60,86,38,142,63,30,156,6,138,100,151,233,158,52,70
],[
193,171,140,253,157,86,17,31,100,185,1,65,104,171,105,140,62,66,152,99
],[
206,151,211,70,166,201,74,247,148,69,75,219,115,68,182,162,69,149,177,43
],[
130,156,156,161,176,155,72,235,52,48,99,67,104,31,55,36,237,82,149,106
],[
67,30,11,181,150,200,93,14,219,72,51,205,28,76,16,185,16,128,131,114
]
]