aLevelData = [
[
2,2,2,5,2,2,2,5,2,2,2,5,2,2,2,5,2,2,2,64
],[
2,2,2,2,2,5,2,2,2,5,2,2,2,5,2,2,2,2,2,116
],[
2,2,3,3,3,3,3,3,3,3,3,3,3,3,3,3,2,2,2,140
],[
2,3,2,2,2,2,2,2,2,2,2,2,2,5,2,5,2,2,2,85
],[
2,3,2,2,2,2,2,2,2,2,8,2,2,2,2,2,2,2,2,59
],[
2,2,2,2,2,5,5,5,5,2,2,2,2,5,2,3,3,3,2,120
],[
2,2,3,3,3,3,2,3,2,3,2,2,2,3,2,3,2,2,3,223
],[
2,2,3,2,2,3,2,3,2,3,3,2,2,3,2,3,2,2,3,133
],[
2,2,3,2,2,3,2,3,2,3,2,3,2,3,2,3,2,2,2,120
],[
4,2,3,2,2,3,2,3,2,3,2,3,2,3,2,3,2,2,2,158
],[
2,2,3,3,3,2,2,3,2,3,2,3,2,3,2,3,2,3,3,30
],[
2,2,3,2,3,2,2,3,2,3,2,2,3,3,2,3,2,2,3,251
],[
2,2,3,2,3,2,2,3,2,3,2,2,3,3,2,3,2,2,3,186
],[
2,2,3,2,2,3,2,3,2,3,2,2,2,3,2,3,2,2,3,38
],[
211,42,123,59,215,158,232,222,112,140,44,32,189,174,241,148,84,77,36,4
],[
41,160,249,99,178,84,48,3,72,108,150,8,209,75,206,29,156,15,81,101
],[
140,33,180,180,121,10,42,0,211,137,73,18,136,226,17,129,40,120,42,225
],[
72,158,109,56,36,171,166,177,136,76,152,149,240,31,66,118,238,125,97,174
],[
204,151,54,8,114,196,137,188,139,25,238,161,228,59,71,158,20,113,138,97
],[
98,253,197,84,227,173,95,205,227,173,160,134,134,159,115,76,175,237,107,251
]
]