aLevelData = [
[
4,2,5,5,2,2,2,2,2,2,2,2,2,2,2,2,2,2,2,142
],[
2,2,2,2,2,2,5,2,2,2,5,2,2,2,5,3,3,3,3,203
],[
2,2,2,2,2,2,3,3,3,3,3,3,3,2,2,2,2,5,2,133
],[
53,3,174,89,129,0,77,250,100,67,0,177,21,248,209,174,12,127,48,242
],[
94,112,232,108,74,220,81,98,15,214,199,19,1,50,92,155,220,141,202,22
],[
88,142,172,8,254,106,237,253,57,174,128,108,176,57,81,225,211,135,124,91
],[
180,54,190,243,25,194,40,191,207,148,27,246,65,59,112,85,73,249,247,193
],[
69,129,35,45,110,255,3,190,101,89,116,45,15,180,150,110,163,59,124,143
],[
1,27,40,226,70,210,182,94,157,170,215,67,88,128,129,253,63,202,229,75
],[
39,217,162,160,199,91,56,202,200,35,191,209,27,45,217,34,143,220,229,236
],[
163,135,117,203,152,52,2,164,203,163,223,208,66,143,108,124,133,48,140,79
],[
175,4,89,78,196,207,22,253,69,225,100,199,2,151,185,160,48,36,15,233
],[
187,145,217,148,222,3,59,136,240,61,122,71,129,101,178,206,165,11,199,189
],[
144,103,157,183,99,226,140,12,70,217,14,149,183,157,187,224,33,190,120,141
],[
177,137,235,248,101,207,50,25,102,232,212,168,151,248,247,132,110,113,212,85
],[
3,217,105,112,102,206,109,252,54,71,137,83,111,28,197,171,132,201,65,246
],[
174,111,37,7,131,27,218,245,202,75,123,196,142,174,134,66,113,44,216,48
],[
67,38,216,162,211,255,242,169,5,219,71,46,37,166,162,33,123,89,174,212
],[
32,120,103,161,16,223,207,211,127,191,226,196,113,228,203,66,133,57,88,55
],[
17,141,172,137,116,151,52,64,168,56,220,231,23,1,130,52,176,245,170,235
]
]