aLevelData = [
[
2,2,140,159,193,253,77,127,245,32,228,252,252,209,195,205,129,158,142,21
],[
2,3,233,228,128,55,219,65,11,236,0,76,190,147,7,132,108,200,237,135
],[
2,3,139,55,123,133,218,178,16,243,71,130,160,132,15,251,253,85,39,84
],[
2,2,85,103,219,181,252,83,181,144,108,57,160,53,139,250,77,161,44,167
],[
2,3,214,151,215,57,161,243,205,130,136,58,71,99,54,117,255,64,212,64
],[
2,3,241,177,230,30,99,122,111,15,35,190,92,101,16,111,31,211,219,9
],[
2,5,155,199,15,128,64,249,79,118,119,68,223,178,64,182,103,206,25,227
],[
2,3,243,47,35,126,61,59,128,42,47,197,255,141,164,204,251,166,111,102
],[
2,3,128,97,158,247,176,105,0,166,101,62,228,18,24,135,36,64,2,169
],[
2,5,98,217,128,152,146,146,188,238,184,235,138,58,243,28,144,154,187,76
],[
2,3,170,140,103,5,141,1,242,229,170,179,254,150,85,185,25,0,38,88
],[
5,3,64,188,159,29,161,204,16,40,165,138,184,203,46,223,45,84,30,181
],[
254,38,24,175,150,15,138,23,99,213,235,24,56,18,65,45,240,66,231,217
],[
85,27,141,153,64,29,128,23,1,105,44,160,0,214,223,216,165,66,207,172
],[
118,38,95,137,127,109,158,203,247,135,16,121,32,185,178,47,111,183,56,91
],[
237,116,153,172,221,57,205,200,159,245,213,62,212,212,253,187,195,18,94,128
],[
252,18,166,19,58,170,28,53,142,193,222,21,186,29,109,195,219,118,108,231
],[
76,207,165,179,198,6,77,22,204,169,137,51,70,11,49,17,108,151,211,148
],[
229,101,251,172,48,11,177,204,68,182,68,158,115,121,70,245,148,228,216,3
],[
97,217,40,204,30,155,55,218,124,40,224,50,188,201,22,136,23,231,109,175
]
]