aLevelData = [
[
4,2,2,17,204,224,8,216,61,127,153,29,202,10,161,69,208,188,131,247
],[
2,2,3,237,7,248,220,184,122,95,163,176,232,84,73,115,199,131,151,49
],[
2,3,2,214,190,236,95,3,78,60,176,139,135,89,65,99,160,113,19,215
],[
2,3,2,193,216,191,113,92,8,101,28,193,231,230,137,237,72,83,210,163
],[
2,3,2,179,165,93,191,105,174,4,198,163,79,114,193,27,236,208,76,205
],[
2,3,2,29,162,234,255,166,235,155,127,170,152,177,44,27,27,223,183,117
],[
2,2,3,87,147,171,172,188,133,171,98,179,144,251,94,60,194,67,58,213
],[
2,2,2,175,143,91,159,10,153,39,188,118,75,113,251,153,128,56,183,114
],[
2,2,2,11,146,252,237,250,227,236,181,28,82,97,74,192,126,212,83,192
],[
2,2,3,108,126,53,190,197,188,228,174,62,184,250,148,87,70,6,143,72
],[
2,2,5,12,38,23,56,230,216,131,177,137,13,206,81,102,127,154,194,209
],[
2,2,2,69,117,236,98,164,92,104,155,41,125,56,204,244,65,182,52,87
],[
2,2,3,138,203,105,160,58,97,250,50,244,27,82,219,38,67,223,97,71
],[
2,3,2,4,116,94,93,217,236,78,195,69,17,231,41,197,188,169,220,3
],[
2,2,2,61,181,72,76,252,226,187,68,97,14,107,216,242,178,187,117,187
],[
185,186,119,243,147,236,229,220,133,78,91,235,67,148,71,41,192,181,88,217
],[
69,169,52,91,193,113,106,80,96,89,167,255,94,122,44,248,30,130,127,246
],[
118,184,97,10,77,58,1,246,105,137,111,215,130,72,83,8,155,65,223,66
],[
146,169,2,8,245,165,223,66,23,13,125,40,99,111,192,97,241,87,152,108
],[
87,205,120,64,194,32,10,47,69,226,33,16,112,52,239,157,37,68,120,26
]
]