aLevelData = [
[
5,5,5,5,5,2,2,2,2,2,2,2,2,158,105,115,134,107,83,3
],[
5,2,2,2,2,2,2,2,2,2,2,2,2,45,176,23,66,17,97,38
],[
5,2,5,3,3,3,3,3,3,3,2,2,3,234,209,53,173,140,141,91
],[
2,2,5,2,3,2,2,2,2,2,2,2,3,113,224,237,105,253,90,101
],[
2,2,3,2,3,2,2,2,2,2,2,2,3,149,0,253,183,39,241,116
],[
2,2,3,2,3,3,3,3,3,3,2,2,3,185,46,244,95,88,114,1
],[
4,2,3,2,2,2,2,2,2,3,2,2,3,235,221,171,67,165,111,240
],[
2,2,3,2,2,3,3,3,3,3,2,2,3,190,144,217,114,53,116,142
],[
2,2,2,2,2,3,2,2,2,2,2,2,2,106,75,122,234,80,232,246
],[
2,3,2,2,2,3,2,2,2,3,2,2,3,187,78,222,132,0,244,205
],[
2,3,2,2,2,3,2,2,2,3,2,2,3,86,241,45,68,204,63,114
],[
2,3,2,3,3,2,2,3,2,3,2,2,3,40,69,156,61,90,54,126
],[
2,3,2,3,6,2,2,3,3,3,2,2,3,193,148,121,32,216,148,231
],[
2,3,2,3,8,2,2,3,2,2,2,2,2,202,61,125,40,83,251,122
],[
2,3,2,3,9,2,3,3,2,2,2,2,2,202,228,37,164,145,254,200
],[
38,14,191,30,158,115,97,4,199,166,3,174,86,148,172,154,33,200,141,194
],[
134,60,134,22,11,111,236,41,66,183,138,43,240,217,229,23,109,215,197,45
],[
78,9,240,163,66,111,57,152,58,70,185,73,205,217,93,135,218,154,161,105
],[
111,113,154,62,233,84,58,197,93,24,208,161,55,135,206,7,33,178,207,186
],[
39,137,216,57,24,168,222,54,47,116,137,75,242,103,56,233,91,168,69,145
]
]