aLevelData = [
[
10,2,2,8,2,2,2,2,2,2,2,2,2,2,2,184,107,188,1,59
],[
2,2,2,2,2,2,2,2,2,2,2,2,2,2,2,97,161,62,254,232
],[
2,2,2,2,2,2,3,3,3,3,2,2,2,2,2,222,74,202,242,176
],[
9,2,2,2,2,2,2,2,2,3,2,2,2,2,2,68,209,63,232,131
],[
3,3,3,3,3,3,3,2,2,3,2,2,2,2,2,156,126,133,219,70
],[
2,2,2,2,2,2,2,2,2,3,2,2,2,2,2,181,136,27,232,226
],[
2,2,2,2,2,2,2,2,2,3,3,2,2,2,2,4,218,84,227,117
],[
2,2,2,2,2,2,2,2,2,2,3,2,2,2,2,116,6,147,82,79
],[
87,54,230,99,244,23,91,249,143,111,24,178,212,137,77,204,159,36,203,161
],[
108,25,26,112,15,61,197,96,165,137,249,194,202,120,78,151,12,177,229,82
],[
160,230,179,223,84,252,28,227,197,108,196,70,210,233,162,239,80,67,86,206
],[
255,139,188,32,189,120,193,238,250,9,117,215,108,108,98,16,4,31,29,169
],[
32,85,26,18,2,155,196,221,129,187,205,197,254,224,195,240,154,252,229,113
],[
166,103,52,17,92,201,205,79,204,57,117,165,24,166,118,13,228,118,170,196
],[
9,110,213,78,137,210,55,186,200,205,98,39,249,18,74,135,214,196,155,163
],[
148,148,79,96,22,41,127,64,97,196,121,43,80,36,20,112,136,167,64,7
],[
175,179,225,25,217,84,222,193,67,38,116,21,68,118,209,96,128,164,222,178
],[
95,203,92,155,190,164,50,51,228,168,5,93,183,117,10,77,47,115,24,72
],[
12,183,2,171,196,40,35,47,192,224,58,107,199,213,121,155,187,184,216,159
],[
131,29,175,71,72,221,132,205,228,184,33,163,151,63,234,111,252,242,110,85
]
]