aLevelData = [
[
2,2,2,2,2,11,2,2,2,2,2,2,2,2,9,2,2,2,235,135
],[
2,2,2,2,2,2,2,2,2,2,2,2,2,2,2,2,2,2,105,143
],[
5,2,5,2,5,5,5,2,5,5,5,2,5,5,5,2,5,2,236,215
],[
5,2,5,2,5,2,5,2,5,2,5,2,5,2,5,2,2,5,188,13
],[
5,5,5,2,5,5,5,2,5,5,5,2,5,5,5,2,2,5,77,99
],[
5,2,5,2,5,2,5,2,5,2,2,2,5,2,2,2,2,5,80,233
],[
5,2,5,2,5,2,5,2,5,2,2,2,5,2,2,2,5,5,49,141
],[
2,2,2,12,2,2,2,2,2,2,2,2,2,10,2,2,2,2,143,52
],[
2,2,7,2,2,2,2,2,8,2,2,2,2,2,2,2,7,2,118,142
],[
2,2,7,2,5,5,5,2,5,5,5,2,5,5,2,2,7,2,94,144
],[
2,2,7,2,5,2,2,2,2,5,2,2,5,2,5,2,7,2,68,187
],[
2,2,7,2,5,5,5,2,2,5,2,2,5,2,5,2,7,2,80,149
],[
2,2,7,2,5,2,2,2,2,5,2,2,5,2,5,2,7,2,230,6
],[
2,2,7,2,5,5,5,2,5,5,5,2,5,5,2,2,7,2,26,115
],[
2,2,2,2,2,2,2,2,2,2,2,2,2,2,2,2,2,2,217,199
],[
72,216,35,189,46,20,230,79,32,123,53,24,230,10,38,163,106,78,41,115
],[
180,130,152,71,24,248,143,156,174,186,253,114,3,112,251,83,14,132,93,146
],[
102,133,135,209,178,201,131,197,96,87,80,62,154,3,124,97,117,219,245,56
],[
108,194,28,110,14,91,27,83,243,41,120,38,244,244,235,148,155,110,109,124
],[
217,22,146,245,247,93,24,146,207,7,192,229,60,213,92,65,207,97,42,196
]
]