aLevelData = [
[
2,2,2,2,2,2,2,2,2,2,2,2,2,2,2,2,16,40,36,20
],[
2,2,2,2,2,2,2,2,3,3,3,3,3,3,3,3,139,132,235,112
],[
2,2,3,2,3,2,2,2,2,3,2,2,2,2,2,2,162,248,163,78
],[
2,2,3,2,3,2,2,2,2,2,3,2,2,2,2,2,53,246,197,210
],[
2,2,3,2,3,2,2,2,2,2,2,3,2,2,2,2,40,224,251,146
],[
2,2,3,2,2,2,2,2,2,2,2,2,3,2,2,3,9,30,223,74
],[
2,2,3,2,3,3,3,3,3,3,3,3,3,2,2,2,243,111,6,208
],[
2,2,3,2,2,2,2,2,2,2,2,2,2,2,2,2,178,124,61,74
],[
2,2,3,2,3,3,3,3,3,3,3,3,3,3,3,3,39,179,18,158
],[
2,2,3,2,2,2,2,2,2,2,2,2,2,2,2,2,238,82,151,42
],[
2,2,3,3,3,3,3,3,3,3,3,3,3,3,3,3,63,194,98,182
],[
1,2,3,2,2,2,2,2,2,2,2,2,2,2,2,2,18,39,216,166
],[
2,2,3,5,5,2,2,2,5,5,5,5,5,5,5,5,135,53,172,116
],[
2,2,3,2,2,5,5,5,5,5,2,2,2,2,2,2,132,69,162,94
],[
160,168,153,92,64,59,200,85,255,59,72,146,84,91,210,115,111,20,203,97
],[
99,61,125,3,138,219,168,181,37,58,57,54,68,61,89,160,230,242,169,158
],[
96,105,204,217,3,199,39,179,249,150,228,56,112,95,61,81,251,123,247,59
],[
52,38,44,56,167,213,78,133,235,202,105,139,18,229,168,89,68,189,27,82
],[
166,239,183,35,128,182,159,249,160,188,162,240,249,48,4,206,144,25,129,241
],[
153,234,143,134,220,86,228,252,94,101,56,184,62,200,76,11,221,106,43,97
]
]