aLevelData = [
[
4,2,5,5,2,2,2,2,2,2,2,2,2,2,2,2,2,232,210,226
],[
2,2,2,2,2,2,5,2,2,2,5,2,2,2,5,3,3,186,198,215
],[
2,2,2,2,2,2,3,3,3,3,3,3,3,2,2,2,2,53,216,110
],[
31,221,156,36,45,99,68,200,180,184,196,5,254,17,84,204,142,244,42,1
],[
5,147,137,116,66,90,250,18,205,196,218,93,118,114,20,25,57,126,48,72
],[
101,13,141,89,254,35,234,157,95,188,43,250,35,24,90,227,70,86,237,135
],[
136,68,71,73,18,118,129,113,92,149,105,33,78,250,203,138,166,123,240,95
],[
153,133,101,138,189,108,253,31,38,254,25,142,207,94,39,28,60,16,105,148
],[
94,80,248,57,183,168,8,0,191,193,109,252,133,122,95,26,153,55,122,14
],[
42,123,8,141,108,186,131,189,60,104,86,234,7,86,228,122,232,62,203,35
],[
16,157,106,91,107,192,161,16,129,34,215,154,154,245,66,238,37,255,98,20
],[
90,167,207,219,31,80,53,203,40,229,157,91,99,181,238,100,147,130,179,214
],[
58,212,30,170,189,147,77,23,195,213,205,9,222,245,93,207,109,229,244,19
],[
193,197,5,16,126,180,1,255,68,230,30,210,143,246,87,37,220,126,179,114
],[
14,230,203,132,15,121,134,46,186,190,40,60,249,5,139,170,42,64,171,20
],[
200,20,105,110,71,48,136,245,63,222,252,101,205,215,100,109,55,92,213,96
],[
206,130,217,45,25,206,183,145,47,1,245,139,101,53,28,17,41,41,187,1
],[
46,218,174,90,202,83,160,172,156,197,207,205,113,218,15,206,104,71,18,45
],[
85,161,230,76,100,113,191,34,255,138,247,49,241,154,83,184,203,0,136,41
],[
134,221,254,221,107,110,211,7,48,153,35,231,100,197,135,64,13,239,219,11
]
]