aLevelData = [
[
2,2,3,3,3,3,3,3,3,3,3,3,3,3,108,78,120,121,44,95
],[
2,2,2,2,2,2,2,2,2,2,2,2,2,2,146,133,52,2,187,25
],[
3,2,3,3,3,3,3,3,3,3,3,2,3,3,145,221,142,172,238,195
],[
2,2,2,2,2,2,2,2,2,2,2,2,2,2,41,59,101,51,153,236
],[
3,2,3,3,3,3,3,3,3,3,3,3,3,2,149,33,146,240,245,249
],[
2,2,3,2,2,2,2,2,2,2,2,2,3,2,99,173,103,226,42,29
],[
3,2,3,2,2,3,3,3,3,3,3,3,3,2,17,64,68,113,104,124
],[
2,2,3,2,2,3,2,2,2,2,2,3,3,2,8,251,141,7,181,74
],[
2,3,3,2,2,3,3,3,3,2,2,2,2,2,221,156,168,151,196,198
],[
2,2,2,2,2,2,2,2,2,3,2,3,2,2,211,96,209,163,106,82
],[
3,3,3,3,2,2,2,2,2,3,2,3,2,2,16,231,223,108,148,35
],[
8,2,6,3,2,3,3,3,3,3,2,3,2,2,17,98,83,72,193,63
],[
55,103,69,79,113,186,128,60,17,232,17,119,211,133,203,217,60,216,101,139
],[
230,226,115,35,25,155,149,15,154,127,239,55,200,73,217,222,228,255,215,201
],[
177,46,203,164,61,119,105,161,254,74,236,98,32,242,7,25,30,210,31,238
],[
144,238,183,161,68,173,44,112,143,221,162,59,229,247,62,230,168,164,150,255
],[
62,129,101,160,102,31,132,151,204,79,21,197,219,156,1,196,210,24,166,205
],[
26,92,201,216,215,202,210,4,189,21,56,58,36,4,58,13,95,114,208,229
],[
74,154,225,93,35,145,182,233,155,20,175,188,44,132,52,233,172,47,239,200
],[
35,209,56,155,218,91,209,113,180,242,212,75,193,59,233,126,17,214,188,88
]
]