aLevelData = [
[
2,2,2,2,5,5,2,2,2,2,2,2,2,2,2,2,2,107,201,3
],[
2,2,2,4,2,2,2,2,2,2,2,5,2,2,2,5,2,195,228,82
],[
5,3,3,3,5,5,3,3,3,3,3,3,3,3,3,3,3,200,144,108
],[
2,3,2,2,2,2,2,2,2,3,2,2,2,2,3,2,2,47,18,87
],[
2,3,2,2,2,2,2,2,2,3,2,2,2,2,3,2,2,106,124,149
],[
2,3,2,2,3,2,2,2,2,3,2,2,2,2,3,2,2,203,85,35
],[
2,3,2,2,3,2,2,2,2,3,2,2,2,2,3,2,2,170,179,108
],[
2,3,2,2,3,5,5,3,3,3,3,3,2,2,3,2,2,183,162,235
],[
2,3,3,2,3,2,2,3,2,2,2,3,2,2,3,2,5,167,160,90
],[
2,2,3,2,3,2,2,3,2,1,2,3,2,2,3,2,5,171,237,121
],[
2,2,3,2,3,2,2,3,2,2,2,3,2,2,3,2,5,15,11,135
],[
2,2,3,2,3,2,2,3,2,2,2,3,2,2,3,2,5,182,116,199
],[
2,2,2,2,3,2,2,3,2,2,2,3,2,2,2,2,5,213,138,2
],[
2,2,2,2,3,2,2,3,2,2,2,3,2,2,2,2,2,64,63,8
],[
2,2,2,2,3,2,2,3,2,2,2,3,2,2,3,2,2,144,196,111
],[
6,2,2,2,3,2,2,3,5,5,5,3,2,2,3,2,2,136,35,15
],[
8,2,2,2,3,2,2,3,5,5,5,3,2,2,3,2,2,189,76,7
],[
9,2,2,2,3,2,2,3,5,5,5,3,2,2,3,3,3,18,235,99
],[
10,2,2,2,3,5,5,5,2,2,2,2,2,2,2,2,2,31,243,19
],[
11,2,2,2,2,2,2,2,2,2,2,2,2,2,2,2,2,206,121,84
]
]