aLevelData = [
[
2,2,2,2,105,120,8,76,26,145,116,38,112,36,66,102,235,57,171,118
],[
2,3,5,3,35,159,146,181,196,222,175,18,215,109,236,217,67,37,15,204
],[
2,3,2,3,147,246,154,118,249,217,239,188,147,5,184,181,238,102,134,188
],[
2,2,2,2,201,75,184,195,27,95,159,234,87,218,224,80,238,248,25,40
],[
2,3,5,3,21,171,199,16,202,140,103,159,17,24,219,61,132,25,16,56
],[
2,3,5,3,10,98,222,20,231,191,47,34,245,44,100,84,48,69,244,79
],[
2,5,5,5,120,254,86,194,147,148,34,246,114,196,115,167,181,58,143,19
],[
2,3,5,3,113,76,202,80,48,232,167,226,57,203,65,141,18,244,233,104
],[
2,3,5,3,68,89,17,51,94,216,105,234,60,112,71,154,137,177,76,116
],[
2,5,5,5,131,113,69,32,254,193,79,84,172,32,63,164,155,238,64,156
],[
2,3,5,3,255,35,190,12,50,64,131,163,249,134,32,191,9,102,143,132
],[
5,3,5,3,202,58,22,44,90,50,110,157,213,145,37,65,212,25,65,18
],[
5,5,5,5,51,195,38,244,24,180,186,72,48,109,198,190,60,66,160,106
],[
5,3,5,3,205,13,7,27,75,35,78,232,60,135,189,11,195,94,52,243
],[
5,3,5,3,103,163,17,148,22,28,84,2,106,141,1,62,43,43,198,79
],[
1,5,5,5,20,83,222,149,218,124,53,91,106,107,205,171,114,166,96,102
],[
5,3,2,3,36,42,71,148,55,96,154,248,46,78,153,231,220,10,74,91
],[
40,117,100,68,14,37,108,30,230,163,30,200,233,215,14,148,241,192,143,155
],[
128,105,212,83,4,24,85,99,89,200,116,181,144,217,97,205,239,7,59,90
],[
56,153,120,11,47,218,134,164,86,205,178,81,251,29,74,58,116,83,254,87
]
]