aLevelData = [
[
6,2,8,2,9,2,2,119,230,99,1,152,115,47,130,165,220,133,13,151
],[
135,65,227,64,78,232,61,129,220,131,213,190,90,174,167,143,76,236,249,184
],[
181,61,153,92,130,243,102,109,37,193,17,103,129,21,37,62,6,167,69,148
],[
29,82,181,48,198,36,29,172,127,177,137,109,105,172,179,217,166,184,133,195
],[
5,123,218,42,225,244,133,36,70,15,148,21,86,119,214,36,235,172,154,240
],[
126,85,186,126,72,215,216,119,166,38,232,144,194,220,238,73,112,136,9,218
],[
86,72,177,106,80,154,61,131,19,111,168,195,16,129,148,212,155,231,143,158
],[
76,230,150,186,165,11,215,42,246,118,187,72,126,121,36,253,211,98,244,51
],[
132,148,206,141,252,221,32,85,169,3,97,182,94,160,151,43,246,48,29,55
],[
59,105,163,87,6,203,118,53,167,119,2,30,134,68,149,182,11,16,101,234
],[
188,84,213,39,165,251,244,201,253,117,70,215,6,7,200,237,53,101,46,121
],[
147,130,111,42,99,167,131,166,5,195,107,124,26,2,115,89,233,160,180,126
],[
2,0,220,113,32,248,50,243,84,111,212,51,96,43,67,65,97,228,34,197
],[
178,157,59,241,12,52,195,180,242,55,223,49,76,249,103,111,82,229,233,82
],[
171,19,241,202,214,25,135,74,202,36,250,124,217,71,220,51,218,18,78,161
],[
135,103,126,202,36,137,109,56,98,118,246,240,130,119,12,166,189,245,67,45
],[
228,142,145,49,68,104,86,40,204,197,155,134,114,216,151,48,210,216,120,52
],[
24,82,96,183,33,195,173,47,221,102,125,210,248,75,113,77,185,169,178,186
],[
42,117,50,204,121,51,53,77,158,13,15,203,62,34,47,142,207,32,92,205
],[
254,21,63,33,77,130,34,57,1,178,247,208,59,73,156,220,101,32,93,8
]
]