aLevelData = [
[
2,2,2,2,2,2,2,2,2,6,5,1,158,47,244,43,33,225,107,92
],[
2,3,5,3,5,5,5,3,5,3,5,11,231,77,28,217,154,28,56,43
],[
2,3,2,3,2,2,2,3,5,3,5,233,156,175,27,88,208,207,206,73
],[
2,2,2,2,2,2,2,2,2,2,2,36,156,72,122,236,113,133,208,13
],[
2,3,5,3,5,5,5,3,2,3,5,234,197,83,250,0,39,121,227,118
],[
2,3,5,3,5,5,5,3,2,3,5,121,167,41,117,79,245,20,115,82
],[
2,5,5,5,5,5,5,5,5,5,5,50,200,89,219,40,117,228,193,32
],[
2,3,5,3,5,5,5,3,5,3,5,207,75,111,169,190,35,57,150,86
],[
2,3,5,3,5,5,5,3,5,3,5,128,240,70,9,94,179,40,27,63
],[
2,5,5,5,5,5,5,5,5,5,5,9,125,87,21,45,96,1,97,169
],[
2,3,5,3,2,2,2,3,2,3,2,4,11,157,38,62,139,216,131,67
],[
5,3,5,3,2,2,2,3,2,3,2,109,160,36,178,101,36,141,213,40
],[
5,5,5,5,5,5,5,5,5,5,5,154,47,36,220,223,129,10,205,93
],[
5,3,5,3,5,5,5,3,5,3,5,83,236,97,50,96,104,78,143,34
],[
218,10,93,234,37,132,39,47,176,17,52,38,174,169,243,148,163,83,157,225
],[
35,222,21,109,221,210,19,39,217,166,129,91,254,51,37,203,215,105,129,2
],[
151,65,247,229,90,242,49,139,173,104,192,78,81,242,3,34,60,59,75,38
],[
225,123,60,121,177,238,119,79,226,134,118,68,111,221,182,240,96,109,28,187
],[
75,3,146,242,27,113,241,27,16,131,35,134,7,53,137,37,252,35,154,157
],[
205,65,205,157,64,204,185,111,72,129,123,205,132,12,89,245,9,195,165,0
]
]