aLevelData = [
[
12,2,2,2,2,2,2,2,2,2,2,2,2,2,2,183,38,99,130,78
],[
2,2,2,2,2,2,2,2,2,2,2,2,13,2,2,94,255,25,131,14
],[
2,2,3,3,3,3,3,3,3,3,2,3,3,3,2,67,149,128,8,199
],[
11,2,3,2,2,2,2,2,2,3,2,3,2,3,2,245,213,233,193,113
],[
2,2,3,2,2,2,2,2,2,3,2,3,2,3,2,109,67,142,186,193
],[
2,2,3,2,2,2,2,2,2,3,2,3,2,3,2,251,142,130,75,239
],[
10,2,3,2,2,2,2,2,2,2,2,2,2,2,2,53,63,62,220,95
],[
2,2,3,2,2,2,2,2,3,3,3,3,3,2,2,44,116,128,228,145
],[
2,2,3,2,2,2,2,3,2,2,2,2,1,3,2,168,251,109,69,229
],[
9,2,3,2,2,2,2,3,2,2,2,2,2,2,3,123,134,113,62,24
],[
2,2,3,2,2,2,3,2,2,2,2,2,2,2,2,244,150,192,253,72
],[
2,2,3,2,2,3,2,2,2,2,2,2,2,2,2,210,165,201,180,95
],[
8,2,3,2,2,3,2,2,2,2,2,2,2,2,2,202,53,30,92,100
],[
2,2,3,2,3,3,2,2,2,2,2,2,2,2,2,246,115,208,238,229
],[
2,2,3,2,3,2,2,2,2,2,2,2,2,2,2,62,236,102,93,121
],[
6,2,3,2,3,2,2,2,2,2,2,2,2,2,3,144,184,228,162,17
],[
2,2,3,3,3,2,2,2,2,2,2,3,3,3,2,123,14,18,58,219
],[
2,2,2,2,2,2,2,3,3,3,3,2,2,2,2,159,139,144,214,240
],[
16,218,172,148,249,225,144,58,70,117,164,213,52,176,36,251,14,127,225,139
],[
70,93,242,147,196,98,166,113,126,125,189,56,73,254,215,85,238,87,44,114
]
]