aLevelData = [
[
6,2,8,2,9,2,10,2,11,3,186,26,67,158,248,214,231,103,194,79
],[
2,2,2,2,2,2,2,2,12,3,63,87,70,4,156,14,246,177,153,74
],[
2,2,3,3,3,3,3,3,3,3,234,35,161,91,127,74,177,215,69,144
],[
95,142,24,105,28,192,140,43,182,142,143,33,33,175,73,218,118,100,71,199
],[
60,174,217,6,231,190,184,120,158,173,236,25,65,109,237,145,171,0,9,6
],[
52,231,5,53,122,222,7,193,98,198,180,202,89,227,149,194,224,71,191,124
],[
71,142,179,134,184,204,131,185,120,196,54,14,106,91,110,180,213,76,72,95
],[
102,28,132,226,121,81,230,0,148,223,219,127,52,227,96,127,205,147,32,10
],[
12,117,220,236,95,208,16,197,183,97,212,92,141,78,0,54,35,96,147,104
],[
12,108,86,169,238,18,188,171,135,170,13,172,238,124,195,72,27,47,53,145
],[
170,133,114,97,220,69,112,239,223,120,102,161,79,215,118,33,252,133,143,179
],[
238,250,146,198,166,63,179,200,167,97,35,63,53,32,236,22,93,231,28,52
],[
53,1,37,84,101,9,132,16,230,162,161,62,10,105,246,128,189,40,116,23
],[
10,77,34,248,225,154,8,34,23,29,75,46,174,99,153,40,87,233,199,157
],[
53,211,185,245,228,224,131,3,186,158,205,219,76,218,124,228,52,91,143,46
],[
18,208,70,5,209,6,138,198,44,94,137,241,112,127,161,128,131,72,127,119
],[
37,8,136,189,118,242,119,42,184,203,72,225,87,230,86,224,38,82,192,213
],[
236,82,16,51,31,13,31,134,239,135,51,4,135,208,107,100,143,124,93,243
],[
245,82,253,228,237,73,193,231,54,176,2,254,159,172,166,140,203,231,252,175
],[
49,135,231,208,102,93,63,121,159,95,116,102,114,89,116,222,220,223,207,68
]
]