aLevelData = [
[
4,2,2,2,2,2,2,2,2,2,2,2,2,2,2,33,26,212,167,84
],[
5,2,5,3,2,2,2,2,2,2,2,2,2,2,2,76,26,124,37,44
],[
2,5,5,3,3,3,3,3,3,3,3,3,3,3,3,189,10,86,72,161
],[
3,3,5,5,5,5,5,5,5,5,3,2,2,2,2,246,10,2,48,81
],[
2,3,5,5,5,5,5,5,5,5,3,6,2,2,2,31,147,79,189,189
],[
3,3,5,5,5,5,3,3,3,3,3,3,3,3,3,80,145,210,47,43
],[
3,5,5,5,5,5,3,2,2,2,2,2,2,2,2,171,192,242,124,41
],[
53,12,2,95,129,159,36,161,248,190,125,183,151,127,152,139,235,82,248,37
],[
47,145,92,217,181,88,65,191,135,150,167,100,77,100,24,191,113,150,231,103
],[
130,144,182,3,214,92,58,1,116,249,67,139,48,245,246,182,24,62,93,253
],[
15,53,35,239,184,4,152,36,150,49,251,117,113,116,249,108,251,198,113,250
],[
179,187,122,104,10,17,167,144,196,137,138,77,162,245,118,48,62,147,137,117
],[
54,153,234,53,140,17,80,221,77,231,196,222,113,65,167,166,3,14,246,208
],[
130,226,205,151,134,1,42,145,166,186,244,154,154,246,60,13,157,16,194,59
],[
21,231,187,21,118,50,209,44,100,20,108,220,24,241,48,195,4,127,199,120
],[
186,32,224,122,10,111,119,103,106,24,87,111,156,238,222,7,138,55,1,226
],[
117,74,143,29,78,93,186,186,100,152,211,79,64,110,85,255,205,44,37,170
],[
189,210,24,97,39,35,182,29,117,248,62,176,125,217,234,251,238,206,115,98
],[
238,115,216,125,1,75,92,16,45,86,205,62,92,230,12,249,1,174,202,189
],[
254,28,144,126,198,233,2,223,190,238,100,164,234,57,93,106,197,96,251,149
]
]