aLevelData = [
[
4,2,2,2,2,2,2,2,2,2,8,2,2,2,2,233,205,41,175,57
],[
2,2,3,2,9,2,2,2,2,2,2,2,2,3,2,120,152,83,194,197
],[
2,3,2,2,2,2,3,2,2,3,2,3,2,2,3,57,20,210,217,113
],[
2,3,2,2,2,3,2,2,3,2,2,2,3,2,2,84,150,62,109,31
],[
2,3,2,2,3,2,2,3,2,2,2,2,2,3,2,59,125,99,94,84
],[
2,3,2,3,2,2,3,2,2,3,2,3,2,2,3,239,27,78,124,208
],[
2,2,3,2,2,3,2,2,3,2,2,2,3,2,2,175,49,60,149,143
],[
2,2,2,2,3,2,2,3,2,2,2,2,2,3,2,68,47,127,199,240
],[
2,2,2,3,2,2,3,2,2,3,2,3,2,2,3,99,113,133,68,3
],[
2,2,3,2,2,3,2,2,3,2,2,2,3,2,2,255,213,163,51,199
],[
2,2,5,2,3,2,2,3,2,2,2,2,2,3,5,176,186,60,4,53
],[
2,2,2,3,2,2,3,2,2,3,2,3,2,2,3,181,233,96,54,179
],[
2,2,3,2,5,3,2,2,3,2,2,2,3,5,2,49,10,246,119,21
],[
2,3,2,2,3,5,2,3,2,2,2,2,2,3,2,9,49,96,204,208
],[
2,2,2,3,2,2,3,2,2,3,2,3,2,2,3,93,155,30,18,48
],[
151,14,215,98,185,187,208,180,82,136,231,49,206,123,27,180,46,227,139,170
],[
184,62,208,25,236,89,144,226,187,185,80,67,244,58,138,159,255,246,0,130
],[
205,104,79,224,15,210,199,157,166,219,122,82,91,125,147,79,209,30,234,220
],[
183,253,213,197,66,208,64,21,219,172,0,33,21,36,100,200,225,181,13,250
],[
5,98,0,119,202,155,250,217,245,99,4,213,249,178,70,190,107,24,32,74
]
]