aLevelData = [
[
6,2,173,163,189,44,148,111,23,37,220,68,207,150,250,213,157,237,247,22
],[
2,2,117,217,22,77,80,0,183,108,47,241,123,158,93,89,169,32,245,121
],[
2,2,209,82,165,215,175,14,177,52,81,56,59,191,124,150,193,136,77,226
],[
2,2,231,55,28,30,119,254,165,40,166,204,106,142,153,196,83,163,39,237
],[
2,2,152,211,225,43,224,51,79,110,171,92,125,41,237,122,182,6,251,160
],[
2,2,144,216,171,95,41,208,183,150,175,245,99,139,38,206,96,59,101,97
],[
2,2,239,239,98,98,74,16,176,164,63,60,70,211,30,153,130,101,213,106
],[
2,2,110,206,90,224,65,243,73,50,41,226,207,240,71,192,198,148,251,2
],[
2,2,33,90,99,225,139,81,30,7,75,178,86,143,107,113,253,44,25,19
],[
2,3,86,168,77,191,184,145,172,151,143,47,173,73,163,184,250,224,157,199
],[
2,3,25,225,199,11,75,147,19,60,180,158,95,84,189,215,247,251,183,91
],[
2,3,91,67,193,219,67,149,235,54,225,236,155,77,102,64,48,19,199,70
],[
2,3,230,227,193,86,249,23,27,172,14,214,43,212,206,45,155,96,212,97
],[
109,220,201,132,61,4,205,71,198,52,25,15,168,31,227,75,105,196,130,4
],[
185,158,211,181,250,27,219,94,255,80,174,212,20,235,143,91,63,105,88,118
],[
198,137,29,254,241,0,12,114,17,110,151,142,193,145,214,31,108,184,38,21
],[
16,123,23,218,65,170,133,226,112,131,4,132,109,40,130,8,43,80,39,1
],[
196,60,128,221,188,237,221,186,138,148,247,123,84,74,214,27,251,1,242,66
],[
87,186,153,22,196,249,144,84,221,118,253,159,135,22,132,24,50,25,177,46
],[
91,149,150,184,85,35,181,65,74,216,32,162,125,119,222,215,209,228,145,11
]
]