aLevelData = [
[
4,2,2,122,188,37,72,248,13,15,57,89,143,217,44,208,123,106,185,166
],[
2,2,3,192,133,233,211,72,252,151,207,125,33,28,166,12,126,43,75,232
],[
198,249,46,147,11,161,16,153,48,200,22,93,162,124,29,23,67,98,78,30
],[
167,17,242,99,131,185,135,62,98,8,19,110,154,78,184,91,127,223,137,157
],[
214,185,156,194,141,102,96,76,169,36,49,250,127,68,42,73,39,208,59,57
],[
46,112,123,84,139,142,191,237,212,185,107,166,178,71,136,53,147,63,23,103
],[
158,118,165,100,236,247,32,54,245,168,233,133,72,43,42,164,128,3,106,210
],[
115,248,95,185,172,188,3,59,28,206,234,110,12,159,210,229,86,244,124,50
],[
213,139,186,168,26,1,202,102,96,243,226,145,194,100,12,224,172,94,52,94
],[
144,220,127,107,218,232,223,4,37,1,229,69,175,191,214,44,10,186,0,160
],[
21,167,78,178,43,196,27,34,154,119,68,37,87,49,129,101,240,153,245,74
],[
193,231,3,120,107,141,100,153,130,29,118,92,134,103,215,189,21,225,51,136
],[
94,77,90,24,217,149,150,101,54,250,59,62,147,109,127,210,241,61,140,117
],[
233,243,212,161,155,123,165,59,232,132,253,24,225,40,159,192,126,208,102,114
],[
148,82,218,104,1,93,1,91,41,23,120,74,167,4,193,120,60,42,223,180
],[
11,115,32,220,9,82,59,164,175,169,154,148,242,235,249,80,116,126,48,28
],[
252,99,77,159,36,24,230,231,81,189,174,174,232,119,69,220,191,18,85,77
],[
210,234,218,211,56,11,193,127,85,151,181,28,80,104,54,253,199,247,235,249
],[
194,124,57,179,230,87,20,31,236,175,21,65,81,89,205,56,78,251,90,124
],[
10,113,55,100,15,111,89,235,250,104,119,179,119,175,169,74,109,221,52,173
]
]