aLevelData = [
[
12,2,2,2,2,2,2,2,2,2,2,2,187,166,189,101,87,174,81,227
],[
2,2,2,2,2,2,2,2,2,2,2,2,111,244,24,255,0,207,30,108
],[
2,2,3,3,3,3,3,3,3,3,2,3,134,28,219,137,111,224,80,42
],[
208,47,82,155,87,76,37,226,129,17,76,69,12,145,160,12,176,253,160,136
],[
10,196,8,84,217,254,165,219,108,11,103,26,91,119,184,168,118,33,12,243
],[
251,157,185,204,12,214,10,38,95,248,142,26,56,141,182,47,148,230,159,217
],[
167,188,45,63,137,23,89,65,45,111,204,186,146,17,172,2,61,197,182,184
],[
230,174,141,190,114,113,81,132,33,154,116,138,9,59,201,32,195,213,222,113
],[
100,124,140,191,174,55,204,240,136,166,204,74,172,231,67,123,160,185,1,220
],[
231,226,202,246,120,207,100,70,111,123,239,61,3,146,117,139,184,213,194,157
],[
213,192,118,100,25,106,88,89,170,174,237,190,78,136,74,38,221,193,38,55
],[
247,207,51,175,242,247,175,165,22,180,53,18,13,92,218,143,149,1,117,96
],[
120,149,62,178,190,82,155,33,33,89,54,125,193,154,83,206,25,243,97,149
],[
50,156,206,85,22,194,32,82,136,114,66,153,242,185,27,64,159,10,101,239
],[
42,223,189,160,55,163,246,162,96,208,179,228,115,85,53,112,218,58,113,54
],[
90,134,102,11,1,97,173,241,89,118,82,153,226,155,226,38,191,180,197,52
],[
176,212,206,25,64,166,17,106,64,12,245,194,115,5,138,190,139,212,28,76
],[
84,95,8,38,48,213,206,153,195,147,104,139,239,73,218,188,3,88,11,76
],[
47,127,211,126,60,183,85,187,121,91,143,218,249,140,47,158,251,212,168,128
],[
170,9,134,175,7,117,254,86,35,51,202,29,145,220,52,242,27,100,112,9
]
]