aLevelData = [
[
2,2,2,2,2,2,2,2,2,6,5,2,2,2,73,184,5,0,89,161
],[
2,3,5,3,5,5,5,3,5,3,5,2,5,3,63,185,61,13,247,220
],[
2,3,2,3,2,2,2,3,5,3,5,2,5,3,48,87,237,186,152,94
],[
2,2,2,2,2,2,2,2,2,2,2,2,5,5,86,68,233,217,220,11
],[
2,3,5,3,5,5,5,3,2,3,5,5,5,3,199,235,231,107,107,248
],[
2,3,5,3,5,5,5,3,2,3,5,5,5,3,27,2,71,182,34,103
],[
2,5,5,5,5,5,5,5,5,5,5,5,5,2,237,135,171,25,45,6
],[
2,3,5,3,5,5,5,3,5,3,5,5,5,3,178,182,125,223,2,110
],[
2,3,5,3,5,5,5,3,5,3,5,5,5,3,159,229,249,182,125,94
],[
2,5,5,5,5,5,5,5,5,5,5,5,5,5,140,65,88,161,138,44
],[
2,3,5,3,2,2,2,3,2,3,2,2,2,3,33,228,37,121,39,79
],[
5,3,5,3,2,2,2,3,2,3,2,2,2,3,174,190,243,85,160,30
],[
5,5,5,5,5,5,5,5,5,5,5,5,5,5,112,67,224,121,80,25
],[
5,3,5,3,5,5,5,3,5,3,5,5,2,3,67,224,170,154,81,76
],[
5,3,5,3,5,5,5,3,5,3,5,5,2,3,232,159,73,143,224,176
],[
1,5,5,5,5,5,5,5,5,5,5,5,5,5,101,138,65,213,94,161
],[
5,3,2,3,2,2,2,3,2,3,2,2,2,3,49,170,51,108,52,178
],[
2,3,2,3,2,2,2,3,2,3,2,2,2,3,39,175,80,237,8,141
],[
2,3,2,3,3,2,3,3,2,3,3,2,3,3,111,173,183,248,4,165
],[
2,2,2,2,2,2,2,2,2,2,2,2,2,2,229,108,241,67,27,221
]
]