aLevelData = [
[
2,2,2,2,24,158,183,160,186,156,91,30,68,52,48,5,156,70,231,83
],[
2,2,13,5,151,229,154,203,189,9,175,72,76,132,0,82,128,56,56,239
],[
2,2,2,5,18,134,128,187,254,10,92,59,138,133,207,111,132,26,198,166
],[
2,2,2,2,203,190,180,150,17,234,121,172,222,146,136,161,216,91,73,78
],[
2,2,2,2,67,9,188,193,196,54,96,144,106,74,83,109,238,167,186,251
],[
2,2,2,2,58,36,99,225,41,189,169,28,142,137,152,153,119,236,82,3
],[
2,2,2,2,179,13,177,218,145,138,46,197,235,107,2,41,99,85,139,250
],[
2,2,2,2,237,0,240,209,142,235,8,63,99,79,120,98,228,81,28,181
],[
2,2,2,2,106,123,169,44,239,109,144,129,21,208,37,200,106,140,0,74
],[
2,2,2,2,235,59,163,144,199,221,94,190,101,205,112,35,167,244,111,13
],[
2,2,2,2,113,60,234,226,101,71,76,108,241,98,3,117,140,180,226,148
],[
2,2,2,2,60,187,196,70,92,250,115,64,156,235,200,4,73,59,19,179
],[
4,2,2,2,207,54,188,34,124,129,43,47,134,7,230,86,80,53,249,127
],[
2,2,2,2,233,106,155,26,213,169,14,110,17,146,199,46,81,144,207,78
],[
2,2,2,3,140,83,105,20,186,129,245,114,221,168,20,147,62,120,13,180
],[
2,2,2,3,249,47,112,53,187,84,249,240,203,168,182,201,71,90,108,134
],[
2,2,2,5,177,122,56,226,170,176,114,220,252,46,214,85,222,227,230,218
],[
3,3,3,3,116,241,138,191,150,98,250,109,210,22,221,252,180,0,179,5
],[
2,1,2,2,68,147,112,177,209,118,105,22,237,127,116,196,185,223,75,154
],[
2,2,2,2,99,154,50,223,236,59,218,142,47,197,132,240,31,236,105,112
]
]