aLevelData = [
[
2,2,2,2,2,2,240,198,161,102,198,138,198,235,154,37,239,191,119,197
],[
2,2,13,5,5,2,168,11,112,130,182,80,146,135,170,172,23,115,182,89
],[
2,2,2,5,5,2,220,255,192,118,22,224,181,10,64,239,32,70,88,135
],[
2,2,2,2,2,2,251,10,74,46,196,171,173,120,212,244,173,41,237,106
],[
2,2,2,2,2,2,72,154,18,212,190,94,155,251,66,36,136,175,246,223
],[
2,2,2,2,2,2,22,10,22,37,144,249,115,213,104,247,36,253,134,28
],[
2,2,2,2,2,2,120,251,224,87,47,226,75,248,233,31,144,113,222,92
],[
2,2,2,2,2,2,195,93,208,164,208,193,62,200,87,146,219,2,186,120
],[
2,2,2,2,2,2,62,217,116,210,219,68,172,250,50,18,9,202,70,137
],[
201,95,81,78,13,28,182,133,119,242,55,56,247,223,104,253,226,181,99,211
],[
69,29,190,78,120,219,186,244,246,84,189,230,107,77,3,195,15,245,144,201
],[
51,38,105,61,25,232,3,13,9,55,252,181,161,6,9,95,109,131,48,78
],[
184,157,55,124,161,195,92,130,113,239,70,185,43,228,60,159,101,180,149,124
],[
87,132,111,69,50,147,164,192,179,121,250,233,247,173,154,149,145,74,196,85
],[
218,19,192,157,136,180,24,37,130,75,4,144,243,38,38,76,157,206,119,185
],[
113,69,130,141,92,141,208,119,99,105,163,2,242,104,231,189,113,30,101,153
],[
25,181,58,146,6,165,135,145,141,191,107,145,207,112,46,1,142,68,191,106
],[
64,169,97,82,98,246,161,96,15,171,139,193,209,250,29,201,183,135,252,222
],[
168,109,102,146,246,129,104,15,54,218,81,184,80,145,102,13,210,197,215,207
],[
138,226,242,101,83,35,151,127,47,86,236,249,150,224,81,2,14,0,151,125
]
]