aLevelData = [
[
5,182,40,102,93,13,47,103,87,108,114,194,27,224,22,22,158,29,78,218
],[
74,115,128,241,70,253,163,126,248,28,236,249,200,35,169,131,39,84,109,118
],[
208,12,109,65,78,58,42,115,191,21,80,21,215,15,222,61,40,4,136,224
],[
160,184,90,232,83,128,157,134,122,63,254,202,188,148,237,113,173,82,68,254
],[
149,49,41,12,114,195,53,226,64,169,214,72,119,6,241,153,214,52,204,26
],[
95,182,44,138,163,110,186,250,63,16,171,223,167,215,160,102,34,119,203,7
],[
22,82,84,93,134,238,251,53,217,167,254,229,221,161,61,223,11,1,156,133
],[
13,93,169,63,125,112,127,203,240,19,234,213,51,105,203,200,212,89,190,227
],[
228,65,251,143,252,232,122,240,126,181,91,186,29,31,132,70,160,101,140,229
],[
226,127,216,116,30,84,3,48,105,45,131,204,128,106,138,193,196,116,43,230
],[
131,242,190,64,121,64,133,27,151,28,144,89,3,163,221,11,95,125,196,62
],[
78,84,146,23,52,138,117,35,62,43,152,232,163,32,142,192,41,166,244,231
],[
234,255,82,210,88,103,67,194,127,74,214,154,138,180,51,237,137,9,130,92
],[
113,246,8,31,100,167,147,225,51,59,25,209,34,117,156,246,235,180,80,194
],[
5,37,0,235,37,55,174,118,6,79,122,21,102,190,197,178,81,240,149,76
],[
161,229,59,2,198,229,52,109,195,112,78,51,121,117,11,217,40,196,74,217
],[
51,196,36,245,35,105,21,202,239,97,92,168,123,142,164,161,94,185,227,224
],[
232,133,131,61,100,161,192,14,154,66,81,63,152,209,74,165,178,224,65,143
],[
200,99,175,158,199,29,154,215,114,88,113,247,99,217,56,6,76,19,228,47
],[
131,155,9,207,190,220,178,204,27,12,144,40,99,95,88,214,143,122,102,204
]
]