aLevelData = [
[
4,2,5,5,2,2,2,2,2,2,2,2,2,2,2,2,2,71,249,32
],[
2,2,2,2,2,2,5,2,2,2,5,2,2,2,5,3,3,101,30,73
],[
2,2,2,2,2,2,3,3,3,3,3,3,3,2,2,2,2,242,232,226
],[
3,3,3,3,3,3,3,2,2,2,2,2,3,2,2,2,2,83,19,9
],[
2,2,3,2,2,2,2,2,2,2,2,2,3,2,2,2,2,49,141,47
],[
13,2,3,2,2,2,2,2,2,3,2,2,3,2,2,2,2,148,58,185
],[
2,5,3,2,2,2,2,2,2,3,2,2,3,2,2,2,2,22,228,117
],[
2,12,3,2,2,2,2,2,2,3,2,2,3,2,2,2,2,193,18,241
],[
5,2,3,3,3,3,3,3,3,3,2,2,3,3,3,3,3,146,230,119
],[
11,2,3,2,2,2,2,2,2,2,2,2,2,2,2,2,2,138,175,25
],[
2,5,3,2,2,2,2,2,2,2,2,2,2,2,2,2,2,123,222,205
],[
169,72,65,133,31,80,45,247,103,225,135,4,48,249,36,189,148,91,140,26
],[
252,226,254,240,62,22,180,29,9,253,103,5,131,52,22,67,48,61,4,152
],[
22,27,0,39,31,28,232,229,190,247,112,75,213,22,32,78,215,53,156,144
],[
42,44,40,216,207,9,107,192,68,98,115,173,169,234,250,4,35,65,232,155
],[
126,17,25,110,22,86,95,148,247,253,203,113,67,177,40,44,212,242,201,99
],[
35,103,133,30,104,117,255,2,3,16,43,200,27,209,13,237,133,73,196,170
],[
231,150,200,38,29,51,112,235,219,21,183,150,148,243,63,211,155,229,150,137
],[
137,48,185,82,222,96,214,46,235,152,86,120,239,39,27,25,128,91,6,251
],[
44,154,189,193,97,174,171,181,138,97,72,1,123,74,154,35,15,230,252,155
]
]