aLevelData = [
[
5,5,5,5,5,2,2,2,2,2,2,2,2,2,2,2,2,214,128,151
],[
5,2,2,2,2,2,2,2,2,2,2,2,2,2,2,2,2,255,237,39
],[
5,2,5,3,3,3,3,3,3,3,2,2,3,3,3,3,3,25,83,169
],[
2,2,5,2,3,2,2,2,2,2,2,2,3,2,2,2,2,10,110,155
],[
2,2,3,2,3,2,2,2,2,2,2,2,3,2,2,2,2,54,112,77
],[
2,2,3,2,3,3,3,3,3,3,2,2,3,5,5,5,5,9,15,191
],[
4,2,3,2,2,2,2,2,2,3,2,2,3,2,2,2,2,23,196,204
],[
2,2,3,2,2,3,3,3,3,3,2,2,3,3,3,2,2,250,83,142
],[
2,2,2,2,2,3,2,2,2,2,2,2,2,2,3,2,2,58,136,90
],[
2,3,2,2,2,3,2,2,2,3,2,2,3,3,3,2,2,165,177,55
],[
2,3,2,2,2,3,2,2,2,3,2,2,3,5,5,5,5,83,230,162
],[
2,3,2,3,3,2,2,3,2,3,2,2,3,2,2,2,2,128,98,56
],[
2,3,2,3,6,2,2,3,3,3,2,2,3,3,3,3,2,112,13,29
],[
2,3,2,3,8,2,2,3,2,2,2,2,2,2,3,2,2,40,129,120
],[
2,3,2,3,9,2,3,3,2,2,2,2,2,2,3,2,3,64,209,148
],[
86,161,255,85,116,102,148,46,96,117,42,97,43,44,249,84,110,83,251,43
],[
139,78,79,156,53,151,220,255,51,108,54,165,96,197,197,107,247,137,36,143
],[
13,1,199,194,95,141,225,126,78,150,132,153,40,195,10,27,169,112,181,77
],[
194,92,146,18,152,161,163,122,208,234,60,149,10,224,174,133,171,229,35,215
],[
224,5,201,20,224,41,51,146,113,142,252,144,173,118,173,130,6,30,224,170
]
]