aLevelData = [
[
4,2,2,2,2,2,2,2,2,2,2,62,95,33,153,104,3,17,124,232
],[
5,2,5,3,2,2,2,2,2,2,2,74,37,190,229,78,100,95,42,63
],[
2,5,5,3,3,3,3,3,3,3,3,142,43,42,86,70,71,65,11,118
],[
3,3,5,5,5,5,5,5,5,5,3,11,61,136,240,15,29,93,81,137
],[
25,117,43,214,226,73,99,86,42,83,215,125,103,198,68,39,212,124,104,44
],[
185,48,99,53,237,237,99,206,153,198,128,188,62,200,229,144,250,45,49,124
],[
7,210,29,102,132,236,94,59,120,246,205,134,20,238,197,65,56,192,204,234
],[
57,3,118,218,226,227,135,211,184,94,88,216,130,180,124,65,9,24,162,14
],[
29,172,189,124,216,172,99,214,39,233,115,142,133,122,251,140,10,174,89,198
],[
165,69,160,17,166,223,61,54,127,180,218,73,203,134,130,54,143,212,6,157
],[
192,81,160,224,6,148,215,122,192,17,162,146,72,72,208,207,120,60,167,111
],[
109,39,204,147,138,108,99,221,192,205,118,61,13,222,155,8,67,185,209,75
],[
11,244,172,94,41,208,178,188,2,179,4,17,91,217,65,149,99,70,167,153
],[
244,255,123,95,22,121,171,47,197,82,179,167,244,63,189,83,209,70,12,126
],[
75,45,154,71,209,50,0,247,93,252,151,145,178,210,221,171,226,11,26,125
],[
18,197,67,56,129,218,30,153,199,16,167,189,91,144,179,55,88,154,211,96
],[
129,118,123,238,130,174,99,200,121,122,46,25,180,124,74,163,188,173,23,87
],[
147,152,75,34,59,198,149,9,119,121,128,120,214,157,155,215,236,251,215,95
],[
227,176,48,44,51,221,143,147,173,161,239,181,190,68,191,84,242,181,136,230
],[
183,55,208,232,100,87,62,117,121,33,255,23,40,147,103,221,21,82,220,174
]
]