aLevelData = [
[
2,2,2,2,2,2,2,2,2,6,154,206,101,184,107,123,60,215,94,240
],[
2,3,5,3,5,5,5,3,5,3,55,34,16,103,115,205,49,219,206,208
],[
2,3,2,3,2,2,2,3,5,3,44,30,169,152,10,38,236,252,147,167
],[
2,2,2,2,2,2,2,2,2,2,75,114,183,232,200,131,45,207,121,124
],[
2,3,5,3,5,5,5,3,2,3,90,61,140,103,116,162,136,57,231,200
],[
2,3,5,3,5,5,5,3,2,3,213,77,248,243,127,17,168,44,55,0
],[
2,5,5,5,5,5,5,5,5,5,219,218,155,208,185,146,183,236,85,48
],[
2,3,5,3,5,5,5,3,5,3,203,36,140,39,78,163,49,21,52,34
],[
2,3,5,3,5,5,5,3,5,3,103,155,109,92,77,107,174,194,225,162
],[
2,5,5,5,5,5,5,5,5,5,115,111,30,89,69,94,104,118,56,219
],[
42,200,185,55,190,84,134,192,141,233,254,240,119,251,155,229,117,174,189,17
],[
124,48,169,51,165,76,209,134,140,60,86,56,245,191,203,29,182,108,60,165
],[
209,70,110,12,224,144,105,208,182,227,52,104,67,125,224,51,184,220,199,175
],[
236,140,22,235,254,61,137,63,61,24,118,58,68,83,13,220,105,3,222,5
],[
89,50,156,46,252,50,32,87,159,48,176,64,81,12,130,220,141,105,124,3
],[
26,0,62,103,48,57,98,201,220,252,2,109,165,196,123,203,112,246,113,135
],[
161,114,20,163,131,103,161,244,234,107,43,210,23,203,155,20,219,31,246,60
],[
0,34,222,238,228,193,92,167,103,114,220,171,7,199,121,63,74,67,123,25
],[
93,108,30,21,250,33,150,41,142,46,79,155,156,30,121,113,92,81,196,42
],[
169,78,104,171,26,89,105,124,110,73,25,52,45,148,222,50,140,172,53,142
]
]