aLevelData = [
[
2,2,2,2,2,2,2,2,2,6,5,2,2,141,227,69,37,226,66,76
],[
2,3,5,3,5,5,5,3,5,3,5,2,5,221,142,0,8,6,64,162
],[
2,3,2,3,2,2,2,3,5,3,5,2,5,59,101,122,49,23,118,149
],[
2,2,2,2,2,2,2,2,2,2,2,2,5,50,94,3,6,216,200,246
],[
2,3,5,3,5,5,5,3,2,3,5,5,5,223,119,165,108,153,60,195
],[
2,3,5,3,5,5,5,3,2,3,5,5,5,10,16,28,146,148,207,10
],[
2,5,5,5,5,5,5,5,5,5,5,5,5,134,187,142,109,189,55,249
],[
2,3,5,3,5,5,5,3,5,3,5,5,5,209,226,22,179,220,81,84
],[
2,3,5,3,5,5,5,3,5,3,5,5,5,155,132,123,171,78,128,140
],[
172,237,252,76,15,32,145,67,72,90,116,33,91,95,238,93,240,4,12,27
],[
170,54,151,83,181,62,70,48,158,67,51,182,104,17,140,168,220,25,139,169
],[
32,184,168,161,139,188,13,98,184,36,74,140,217,39,74,173,78,120,133,173
],[
119,201,120,106,198,142,82,159,24,3,241,10,69,112,12,206,245,171,178,22
],[
182,223,243,251,76,141,221,168,72,208,170,187,221,229,55,239,238,234,184,248
],[
107,230,171,175,222,10,10,111,65,55,197,191,19,192,111,49,171,112,55,138
],[
203,207,27,34,120,161,88,142,9,176,37,125,127,203,160,224,20,15,9,78
],[
23,101,46,166,246,76,38,246,157,217,66,155,254,251,65,170,241,4,195,143
],[
63,101,1,244,249,185,186,229,15,6,113,49,29,63,213,19,136,13,129,17
],[
202,206,229,37,10,223,132,27,240,22,97,58,183,147,179,38,132,185,224,5
],[
246,119,169,225,254,204,162,77,241,138,230,76,219,90,8,110,23,0,77,60
]
]