aLevelData = [
[
12,2,2,2,2,2,2,2,2,2,2,2,16,172,65,53,114,222,226,237
],[
186,246,6,125,87,123,168,67,61,91,142,63,128,48,123,117,33,193,167,147
],[
40,204,108,212,242,3,66,36,205,84,237,133,194,109,245,177,178,128,87,1
],[
165,67,122,141,94,60,100,149,51,59,46,32,27,40,181,226,9,254,147,99
],[
120,24,78,94,71,172,206,103,200,149,21,209,20,85,42,207,161,90,86,217
],[
22,128,147,82,93,216,66,103,250,168,28,58,156,178,107,64,242,185,122,231
],[
192,66,74,125,50,152,134,77,112,18,185,11,114,152,191,114,22,100,122,43
],[
112,6,198,241,97,171,174,243,107,158,224,121,195,15,94,203,168,20,119,79
],[
244,237,246,241,241,140,153,199,109,85,196,245,17,34,119,207,238,138,126,62
],[
89,99,231,101,249,133,185,132,30,209,227,28,84,114,115,84,57,99,8,155
],[
139,49,138,143,133,3,24,29,108,215,66,234,101,14,121,242,137,43,195,112
],[
59,216,180,253,185,42,153,251,242,37,246,52,152,131,51,191,117,177,146,36
],[
2,27,100,191,54,169,125,106,156,137,229,86,168,48,208,58,75,155,208,176
],[
197,219,74,219,187,208,39,78,137,53,203,41,217,220,75,133,117,59,218,19
],[
89,40,133,255,13,225,33,27,49,79,129,57,89,140,236,216,28,162,205,4
],[
104,150,173,119,24,165,95,4,201,205,122,54,233,143,13,52,16,244,141,231
],[
148,206,18,95,88,64,195,115,228,128,143,168,187,220,31,85,232,251,8,4
],[
219,102,68,26,115,70,227,187,92,112,254,232,155,158,237,234,103,255,185,244
],[
59,243,212,4,41,15,8,10,113,104,174,76,82,14,32,9,32,214,113,92
],[
151,93,91,100,111,73,120,162,48,210,181,162,72,130,5,222,91,56,82,223
]
]