aLevelData = [
[
6,2,8,2,9,2,10,2,11,3,2,2,227,164,232,242,254,81,41,158
],[
2,2,2,2,2,2,2,2,12,3,5,2,247,181,80,109,247,162,249,97
],[
2,2,3,3,3,3,3,3,3,3,2,2,145,183,86,177,173,133,199,14
],[
2,2,3,2,2,2,2,2,2,2,5,2,196,241,171,42,83,217,119,123
],[
2,2,3,2,2,2,2,2,2,2,2,2,137,251,5,61,67,18,46,182
],[
2,2,3,2,3,3,3,3,3,3,2,5,59,65,154,189,124,181,215,125
],[
2,2,3,2,2,2,2,5,5,3,2,2,26,135,169,119,31,223,161,198
],[
2,2,3,5,5,5,2,3,3,3,5,2,200,95,241,167,242,191,127,56
],[
2,2,2,2,2,2,2,2,2,2,2,2,207,180,56,128,221,23,167,176
],[
2,3,2,2,3,1,3,2,2,2,2,2,25,67,198,168,112,191,20,189
],[
2,3,2,2,3,2,3,2,2,2,2,5,118,29,231,186,90,33,4,36
],[
2,3,2,3,2,2,2,3,2,2,2,2,26,38,109,195,243,190,122,93
],[
2,3,2,3,2,2,2,3,3,3,2,2,28,153,43,197,179,168,189,21
],[
2,3,2,3,2,2,2,3,2,2,5,2,248,129,123,55,185,6,215,170
],[
2,3,2,3,2,2,3,3,2,2,2,2,13,65,185,130,69,147,23,177
],[
2,3,2,3,2,2,3,3,2,2,2,5,32,14,198,134,62,31,144,115
],[
2,3,2,3,2,2,3,3,2,2,2,2,215,112,134,19,173,12,151,107
],[
63,197,98,113,64,211,73,202,71,189,199,216,200,125,3,244,67,223,165,248
],[
187,42,232,1,106,2,240,115,179,141,95,61,88,213,35,94,237,109,145,168
],[
141,88,184,195,203,38,239,118,235,96,177,34,83,38,171,143,60,23,18,235
]
]