aLevelData = [
[
2,2,2,2,2,2,2,2,2,6,5,140,13,31,22,218,0,236,1,104
],[
2,3,5,3,5,5,5,3,5,3,5,174,28,2,240,181,101,74,239,116
],[
2,3,2,3,2,2,2,3,5,3,5,61,197,178,203,146,251,180,33,188
],[
2,2,2,2,2,2,2,2,2,2,2,52,39,172,176,223,209,236,118,52
],[
2,3,5,3,5,5,5,3,2,3,5,25,121,221,25,98,255,109,66,151
],[
2,3,5,3,5,5,5,3,2,3,5,135,157,157,7,248,70,237,116,221
],[
2,5,5,5,5,5,5,5,5,5,5,88,180,102,104,204,87,197,183,217
],[
2,3,5,3,5,5,5,3,5,3,5,125,167,87,107,184,103,7,209,103
],[
2,3,5,3,5,5,5,3,5,3,5,247,190,181,219,119,239,82,184,6
],[
2,5,5,5,5,5,5,5,5,5,5,11,225,158,216,72,84,9,136,161
],[
2,3,5,3,2,2,2,3,2,3,2,71,118,176,29,52,200,184,85,230
],[
233,235,48,48,180,208,242,222,19,183,117,236,100,146,181,246,34,6,147,240
],[
193,194,210,23,217,16,102,39,135,169,238,207,17,206,127,98,200,148,163,207
],[
51,128,161,211,105,83,255,109,191,39,70,147,163,187,5,35,200,12,24,28
],[
132,37,42,14,118,55,121,207,107,236,217,112,130,249,252,111,143,243,240,46
],[
190,99,233,164,121,28,65,83,139,204,189,122,133,210,18,139,96,79,168,223
],[
101,128,157,169,74,75,13,41,158,23,145,34,103,225,5,141,9,140,143,143
],[
105,121,220,169,83,88,173,47,25,62,147,251,125,247,246,98,209,157,92,103
],[
93,105,232,47,1,202,33,181,28,180,246,191,172,59,254,17,182,96,4,224
],[
232,43,194,137,125,250,237,131,97,24,114,146,149,145,0,62,214,69,198,132
]
]