aLevelData = [
[
4,2,2,2,2,2,2,2,2,2,8,2,2,2,2,3,28,251,87,204
],[
2,2,3,2,9,2,2,2,2,2,2,2,2,3,2,2,130,19,120,111
],[
2,3,2,2,2,2,3,2,2,3,2,3,2,2,3,2,196,4,185,171
],[
2,3,2,2,2,3,2,2,3,2,2,2,3,2,2,3,84,205,48,14
],[
2,3,2,2,3,2,2,3,2,2,2,2,2,3,2,2,17,34,210,137
],[
2,3,2,3,2,2,3,2,2,3,2,3,2,2,3,2,188,14,137,47
],[
2,2,3,2,2,3,2,2,3,2,2,2,3,2,2,3,171,221,135,58
],[
193,57,217,79,157,147,63,3,18,197,59,157,215,245,104,29,128,188,13,126
],[
173,135,242,57,130,62,114,10,87,36,210,246,176,255,209,141,111,120,128,109
],[
72,196,84,7,118,132,122,166,172,234,106,173,79,30,191,31,226,224,70,101
],[
194,110,85,76,19,168,94,78,250,114,195,18,12,90,236,54,7,123,152,75
],[
192,160,112,33,93,173,226,69,196,59,44,201,84,131,183,67,210,125,167,24
],[
166,73,176,251,71,205,43,176,244,160,105,22,165,38,71,100,65,253,2,179
],[
17,152,77,189,117,42,161,228,213,198,213,118,219,196,238,47,223,102,56,255
],[
163,188,150,14,65,196,22,254,97,214,200,112,175,63,209,201,141,45,187,54
],[
4,203,15,237,1,172,38,182,190,109,60,170,126,150,198,59,125,194,5,117
],[
39,0,220,132,136,120,223,117,4,82,172,65,72,211,126,7,128,201,255,153
],[
202,42,94,58,235,248,162,166,66,103,62,83,250,66,229,247,131,139,159,74
],[
66,98,29,13,135,39,73,75,192,227,34,223,237,228,199,54,84,168,209,86
],[
118,253,230,31,65,101,140,209,135,191,58,207,175,36,181,163,171,16,154,65
]
]