aLevelData = [
[
2,2,3,3,3,3,3,3,157,154,154,33,165,189,183,119,221,165,147,103
],[
2,2,2,2,2,2,2,2,190,51,154,128,40,22,207,138,86,238,96,198
],[
3,2,3,3,3,3,3,3,16,177,126,119,34,78,107,160,14,145,213,16
],[
2,2,2,2,2,2,2,2,254,71,98,156,252,162,140,172,101,223,175,249
],[
3,2,3,3,3,3,3,3,155,37,96,148,251,177,1,43,15,48,146,136
],[
2,2,3,2,2,2,2,2,4,108,202,90,94,43,103,56,234,84,194,227
],[
3,2,3,2,2,3,3,3,244,84,166,203,187,192,98,213,34,60,29,92
],[
168,155,106,118,154,72,29,120,136,228,92,188,245,48,249,161,82,46,255,212
],[
46,131,138,206,167,32,220,158,36,33,174,233,70,245,196,47,27,192,196,79
],[
149,253,72,78,59,104,50,84,31,27,64,247,16,247,224,188,16,69,69,219
],[
9,157,186,67,187,7,54,222,249,97,49,22,21,1,183,152,153,155,187,88
],[
55,100,173,213,3,119,79,158,224,120,196,21,56,120,233,115,241,25,233,12
],[
156,243,12,213,239,54,208,35,117,144,59,181,132,81,111,245,112,205,127,123
],[
254,1,129,211,27,122,229,128,206,115,5,64,108,62,252,146,11,229,188,118
],[
56,16,91,116,237,41,174,223,189,191,25,91,82,40,165,157,25,107,83,114
],[
60,93,177,3,209,9,170,87,81,85,162,25,75,227,195,156,89,54,145,28
],[
84,22,197,71,196,53,88,251,154,18,222,82,34,30,21,220,51,30,190,43
],[
169,208,171,149,20,209,26,53,178,190,65,51,155,153,42,69,60,111,193,118
],[
6,56,44,39,103,255,90,83,250,67,223,23,251,156,255,113,253,162,8,72
],[
223,10,230,172,252,18,241,96,162,32,9,149,198,165,229,249,245,72,168,240
]
]