aLevelData = [
[
2,2,3,3,3,3,7,77,134,173,243,95,23,231,187,226,57,193,179,175
],[
2,2,2,2,2,2,242,119,49,146,109,213,229,78,242,87,105,226,22,143
],[
3,2,3,3,3,3,25,11,47,199,37,10,11,232,229,167,226,154,108,118
],[
2,2,2,2,2,2,136,173,95,89,231,184,8,70,173,255,166,75,66,154
],[
3,2,3,3,3,3,7,207,253,212,89,26,151,210,62,24,224,117,30,89
],[
2,2,3,2,2,2,176,128,193,93,33,254,29,15,251,222,108,143,112,225
],[
3,2,3,2,2,3,130,52,10,182,94,210,225,99,255,56,17,230,121,253
],[
2,2,3,2,2,3,107,28,71,125,107,227,227,30,106,123,148,216,21,51
],[
2,3,3,2,2,3,135,244,30,65,34,19,50,241,149,115,42,2,178,110
],[
2,2,2,2,2,2,133,76,254,67,22,167,8,25,250,9,249,65,205,238
],[
3,3,3,3,2,2,109,188,29,253,129,253,31,232,45,239,161,148,213,58
],[
8,2,6,3,2,3,64,122,26,195,219,77,246,113,72,220,8,55,69,59
],[
2,2,2,3,2,3,44,79,177,29,79,195,252,133,130,50,220,158,76,209
],[
2,2,2,2,2,3,65,230,69,176,140,146,224,63,251,47,137,16,104,133
],[
2,2,2,2,2,3,240,222,52,192,164,207,126,210,227,246,152,19,177,28
],[
9,2,12,3,2,2,187,42,39,192,249,49,14,92,116,20,172,234,206,58
],[
222,167,224,104,103,23,175,226,136,73,155,211,209,92,218,238,54,66,37,86
],[
101,196,177,187,87,198,97,198,37,205,58,184,30,190,23,78,22,233,158,231
],[
0,69,114,232,192,253,170,96,58,44,131,232,175,229,81,206,73,119,188,114
],[
244,239,40,239,112,222,117,254,164,92,233,24,54,76,106,219,88,226,241,175
]
]