aLevelData = [
[
2,2,2,2,2,2,2,2,2,2,2,2,2,2,2,57,122,187,221,245
],[
2,2,13,5,5,2,2,12,5,5,2,3,2,5,5,165,91,216,182,138
],[
2,2,2,5,5,2,2,2,5,5,2,3,2,5,5,114,124,74,145,91
],[
2,2,2,2,2,2,2,2,2,2,2,3,2,2,2,14,242,195,132,143
],[
2,2,2,2,2,2,2,2,2,2,2,3,3,3,3,184,212,104,227,2
],[
2,2,2,2,2,2,2,2,2,2,2,2,2,2,6,97,189,50,104,118
],[
2,2,2,2,2,2,2,2,2,2,2,2,2,3,3,238,143,195,83,203
],[
2,2,2,2,2,2,2,2,2,2,2,2,2,2,2,215,134,112,128,220
],[
2,2,2,2,2,2,2,2,2,2,3,2,2,2,2,82,190,195,195,196
],[
2,2,2,2,2,2,2,2,2,3,3,2,3,2,2,48,82,171,146,122
],[
2,2,2,2,2,2,2,2,3,3,2,9,3,3,2,157,144,214,25,191
],[
2,2,2,2,2,2,2,2,3,2,2,2,3,3,2,110,169,147,179,169
],[
4,2,2,2,2,2,2,3,2,2,2,2,3,2,2,244,0,197,172,131
],[
201,70,208,91,176,132,128,78,16,250,156,204,102,195,26,252,17,85,243,11
],[
86,107,61,197,167,67,148,98,37,10,191,162,99,149,145,28,109,81,12,210
],[
9,125,205,10,60,150,164,89,16,19,130,1,149,83,152,125,38,212,189,89
],[
237,165,16,71,170,30,223,112,175,206,200,8,47,181,30,37,185,179,143,209
],[
0,65,3,93,221,95,198,249,151,205,234,130,97,126,231,155,36,74,133,255
],[
127,227,252,22,13,10,89,198,230,3,35,139,104,70,63,202,55,119,17,98
],[
130,152,228,133,136,126,140,198,91,129,73,114,228,120,239,36,40,229,68,148
]
]