aLevelData = [
[
4,2,2,2,2,2,2,2,2,2,2,2,2,2,2,2,2,2,2,96
],[
5,2,5,3,2,2,2,2,2,2,2,2,2,2,2,2,2,2,2,247
],[
2,5,5,3,3,3,3,3,3,3,3,3,3,3,3,3,3,3,2,79
],[
3,3,5,5,5,5,5,5,5,5,3,2,2,2,2,2,2,2,2,91
],[
2,3,5,5,5,5,5,5,5,5,3,6,2,2,2,2,2,2,2,168
],[
3,3,5,5,5,5,3,3,3,3,3,3,3,3,3,2,3,3,3,94
],[
3,5,5,5,5,5,3,2,2,2,2,2,2,2,2,2,2,2,2,153
],[
3,5,5,3,3,3,3,8,2,2,2,5,5,5,5,5,5,5,5,70
],[
3,5,5,3,2,2,3,3,3,3,2,5,3,3,3,5,3,3,3,212
],[
3,5,5,3,2,2,2,2,2,3,2,5,3,5,5,5,5,5,5,94
],[
3,5,5,3,2,2,3,2,2,3,2,5,3,5,5,5,5,5,5,82
],[
5,5,5,3,2,2,3,2,2,3,2,5,3,5,5,5,5,5,5,43
],[
5,5,5,3,2,2,3,2,2,3,2,5,3,3,3,5,5,5,5,50
],[
5,3,3,3,2,2,3,2,2,3,2,5,2,2,3,3,3,3,3,86
],[
5,3,2,2,2,2,3,2,2,3,2,5,2,2,2,2,2,2,2,114
],[
5,3,3,2,2,2,3,2,5,5,5,5,2,2,2,2,2,2,2,246
],[
5,5,3,3,2,2,3,2,5,3,5,5,3,3,3,3,3,3,2,150
],[
28,132,210,10,229,252,52,194,101,203,28,78,55,49,152,19,126,210,137,252
],[
205,13,169,109,68,137,205,121,252,16,104,84,166,161,81,11,110,192,198,114
],[
38,17,176,94,160,37,40,21,91,148,59,3,98,76,234,175,114,40,117,237
]
]