aLevelData = [
[
4,2,5,114,192,83,22,138,105,200,169,54,110,221,63,58,84,147,34,194
],[
2,2,2,104,149,160,246,1,110,108,206,5,250,65,40,174,26,200,24,142
],[
2,2,2,172,188,127,209,187,76,223,195,242,193,109,146,87,96,104,84,54
],[
3,3,3,146,170,75,90,66,125,104,131,135,175,15,21,131,233,26,14,139
],[
2,2,3,60,32,58,135,253,247,170,156,211,119,98,9,14,129,82,79,58
],[
13,2,3,64,136,149,244,175,163,74,253,92,139,12,141,107,95,201,234,221
],[
2,5,3,175,36,56,19,236,26,147,141,28,229,91,248,210,32,207,104,94
],[
2,12,3,45,222,226,65,212,57,29,228,44,173,137,137,191,176,145,129,233
],[
5,2,3,58,29,159,129,214,92,238,187,248,192,159,77,145,74,69,209,225
],[
11,2,3,7,69,107,140,219,135,171,241,125,114,181,183,195,24,159,168,32
],[
2,5,3,173,26,195,107,62,85,140,225,159,30,167,110,166,75,165,40,150
],[
2,10,3,88,30,28,222,81,0,78,4,242,38,251,220,14,45,33,253,45
],[
5,2,2,131,66,117,121,192,100,188,219,58,92,231,97,211,76,30,227,22
],[
2,2,2,107,80,230,131,4,37,192,38,194,53,253,111,42,119,2,61,105
],[
9,5,3,252,240,60,80,221,203,113,157,114,220,19,124,196,83,157,77,69
],[
2,2,3,49,33,168,191,101,223,158,139,53,22,66,3,224,26,105,57,130
],[
167,173,234,55,117,184,173,131,12,191,112,242,218,76,37,251,131,65,185,42
],[
120,26,70,127,203,114,137,17,66,200,150,246,170,132,202,103,109,53,2,32
],[
103,29,10,6,246,239,89,12,80,215,251,87,26,187,206,161,54,193,241,219
],[
220,17,122,22,236,220,103,163,130,157,216,121,203,158,123,216,24,190,71,44
]
]