aLevelData = [
[
2,2,2,2,2,11,2,2,2,2,2,71,24,167,98,172,74,44,196,246
],[
2,2,2,2,2,2,2,2,2,2,2,95,85,82,112,198,230,145,27,202
],[
5,2,5,2,5,5,5,2,5,5,5,11,206,162,185,235,96,144,70,129
],[
5,2,5,2,5,2,5,2,5,2,5,45,193,44,167,112,22,20,116,185
],[
5,5,5,2,5,5,5,2,5,5,5,109,185,200,53,209,74,37,47,237
],[
5,2,5,2,5,2,5,2,5,2,2,16,193,215,199,80,217,66,171,115
],[
5,2,5,2,5,2,5,2,5,2,2,71,179,100,100,87,25,179,58,215
],[
216,249,23,109,204,55,79,46,139,56,205,107,235,13,179,206,197,186,65,166
],[
248,47,248,128,176,122,255,247,232,58,197,205,45,87,232,58,165,240,86,131
],[
81,149,178,207,143,183,249,55,227,92,101,28,246,23,145,189,223,56,223,8
],[
162,64,23,177,246,152,80,130,76,130,20,242,12,79,191,248,34,211,40,33
],[
185,22,131,225,70,76,134,38,201,7,203,51,80,172,118,172,188,35,23,237
],[
199,211,210,160,70,206,189,143,172,72,137,182,208,78,101,157,240,181,31,229
],[
245,80,140,32,248,102,43,230,6,98,5,37,32,205,215,184,134,122,115,59
],[
54,0,100,30,175,109,209,249,250,57,164,31,235,121,234,118,165,85,125,134
],[
92,188,225,207,95,87,109,96,85,187,171,165,198,226,1,129,222,220,144,156
],[
110,194,92,255,52,236,173,222,92,99,182,180,70,153,117,150,138,88,218,192
],[
58,249,43,117,103,214,167,6,230,2,106,48,83,55,144,170,87,15,157,255
],[
39,119,29,154,77,97,135,31,171,186,103,2,189,156,188,82,30,196,159,213
],[
78,70,38,90,178,127,136,75,220,76,130,130,13,121,249,93,248,125,224,21
]
]