aLevelData = [
[
4,2,2,2,2,2,2,2,2,2,2,2,2,2,2,2,2,2,247,28
],[
5,2,5,3,2,2,2,2,2,2,2,2,2,2,2,2,2,2,111,99
],[
2,5,5,3,3,3,3,3,3,3,3,3,3,3,3,3,3,3,47,128
],[
3,3,5,5,5,5,5,5,5,5,3,2,2,2,2,2,2,2,97,111
],[
2,3,5,5,5,5,5,5,5,5,3,6,2,2,2,2,2,2,160,172
],[
3,3,5,5,5,5,3,3,3,3,3,3,3,3,3,2,3,3,156,191
],[
3,5,5,5,5,5,3,2,2,2,2,2,2,2,2,2,2,2,239,69
],[
3,5,5,3,3,3,3,8,2,2,2,5,5,5,5,5,5,5,130,58
],[
3,5,5,3,2,2,3,3,3,3,2,5,3,3,3,5,3,3,54,137
],[
3,5,5,3,2,2,2,2,2,3,2,5,3,5,5,5,5,5,168,51
],[
77,133,56,61,72,136,147,64,64,215,58,204,87,162,238,174,246,55,22,193
],[
89,118,98,7,78,133,174,248,57,197,41,26,92,4,182,210,85,244,146,122
],[
232,219,55,179,255,141,129,253,239,152,16,133,253,190,237,61,33,168,112,50
],[
10,216,97,27,97,224,93,45,82,209,123,55,73,247,48,234,249,195,112,120
],[
163,9,22,98,149,108,134,138,241,22,145,144,175,172,153,91,229,128,245,246
],[
70,9,150,158,233,145,235,25,77,46,3,73,153,243,242,0,40,103,117,22
],[
68,54,217,185,50,39,24,5,112,78,70,212,58,131,43,216,82,19,50,231
],[
1,181,130,149,89,191,106,8,190,153,2,8,165,114,15,86,154,51,40,63
],[
136,177,23,112,53,39,130,12,12,227,203,252,31,63,52,135,108,211,71,34
],[
95,233,117,137,153,49,253,14,240,183,15,49,183,17,49,114,63,221,227,99
]
]