aLevelData = [
[
2,2,2,5,2,2,2,145,69,19,30,14,184,57,111,15,22,61,68,46
],[
2,2,2,2,2,5,2,29,57,91,0,162,251,96,82,203,100,190,178,126
],[
14,180,50,25,49,171,104,100,200,199,185,196,239,188,216,177,144,227,137,105
],[
62,141,171,230,97,151,117,14,148,62,0,43,75,53,5,154,185,245,233,199
],[
241,85,246,89,75,90,236,169,9,80,184,121,58,25,131,227,223,198,238,143
],[
77,100,156,41,210,24,242,18,155,111,26,86,213,239,78,223,19,242,83,232
],[
240,180,67,180,245,170,144,127,189,21,70,181,86,216,144,98,235,134,126,233
],[
160,192,5,250,190,190,72,190,16,43,21,84,141,54,179,129,54,230,219,163
],[
66,173,4,231,121,65,228,188,222,167,51,136,144,144,178,153,242,233,108,94
],[
10,174,59,215,39,255,143,74,199,117,107,56,183,182,176,143,124,71,158,33
],[
242,162,152,85,51,137,39,28,186,153,66,39,201,34,205,88,7,54,95,118
],[
110,0,72,36,100,87,211,20,40,147,200,120,112,160,53,185,81,81,110,108
],[
94,246,83,130,20,48,209,190,118,4,172,109,244,47,123,81,145,185,244,222
],[
69,205,105,169,160,200,147,29,177,144,143,111,38,39,38,213,180,128,81,243
],[
186,145,252,150,33,169,11,165,134,4,155,85,155,157,138,155,202,67,57,231
],[
28,239,144,15,90,85,67,137,114,185,84,222,27,4,218,91,188,23,0,10
],[
138,95,80,225,241,169,50,56,54,56,175,129,90,21,123,51,65,167,51,7
],[
20,131,227,103,227,133,203,35,143,32,99,103,231,242,156,234,17,156,105,103
],[
44,208,126,81,51,172,87,195,36,70,125,182,98,136,5,118,88,62,89,87
],[
96,109,59,163,227,230,6,216,193,28,55,16,243,51,45,193,111,89,45,166
]
]