aLevelData = [
[
5,5,3,5,5,186,177,146,208,233,215,77,89,96,119,155,36,26,53,226
],[
4,2,3,5,5,20,63,38,46,16,235,135,27,86,49,175,246,17,96,66
],[
2,2,3,2,3,31,45,132,168,177,106,48,189,101,175,123,202,180,162,73
],[
5,2,2,2,3,181,60,117,204,116,101,2,74,199,68,27,32,39,192,27
],[
2,2,2,3,2,7,249,243,193,150,8,211,63,8,50,17,141,64,98,65
],[
2,2,2,3,2,3,10,190,60,39,164,33,194,196,125,203,100,60,60,87
],[
2,2,2,2,2,161,30,4,238,80,251,246,187,62,118,248,158,23,155,181
],[
5,2,2,2,2,37,138,114,229,184,168,211,207,19,141,123,12,250,67,96
],[
2,2,5,5,3,141,39,227,66,224,136,253,131,174,167,58,56,137,106,64
],[
2,2,5,5,3,128,228,252,214,21,99,11,73,32,86,52,14,82,128,187
],[
2,2,3,3,3,168,48,28,128,205,174,34,46,196,0,198,182,17,173,65
],[
2,2,3,2,2,252,84,229,213,207,111,20,11,31,231,183,64,106,141,111
],[
2,2,3,2,2,95,120,93,83,240,72,166,139,82,74,107,27,68,207,9
],[
2,2,3,2,5,252,171,189,27,113,143,135,155,152,102,92,74,63,149,159
],[
81,250,52,152,40,114,17,105,183,0,248,67,187,123,50,217,108,78,76,21
],[
93,205,26,10,163,201,250,43,57,97,93,186,163,28,132,131,210,53,136,201
],[
72,54,157,129,124,200,151,190,128,202,174,109,225,160,126,66,207,206,82,242
],[
125,197,161,163,203,252,217,160,35,67,92,82,160,85,200,108,118,172,124,101
],[
142,153,88,43,112,147,195,22,102,208,243,26,222,18,105,66,17,196,186,89
],[
226,69,149,234,9,132,2,108,112,205,232,182,221,226,210,185,210,78,242,109
]
]