aLevelData = [
[
10,2,168,10,144,107,72,89,89,43,241,221,147,115,122,98,228,30,223,68
],[
2,2,76,255,54,143,181,36,229,101,203,91,19,160,13,246,92,185,36,204
],[
2,2,201,233,116,128,255,141,242,6,182,207,53,98,109,131,207,179,92,79
],[
9,2,221,113,171,15,221,243,225,119,192,52,159,250,64,214,142,235,116,103
],[
3,3,150,227,162,228,81,98,84,123,191,185,174,149,59,39,254,20,173,66
],[
2,2,149,217,2,152,214,138,217,151,140,146,127,170,129,105,30,165,76,21
],[
2,2,49,99,106,241,59,173,144,173,185,94,64,150,85,197,155,23,92,75
],[
2,2,118,128,114,86,175,7,133,109,193,13,255,156,151,162,64,26,158,74
],[
2,2,75,41,30,1,191,62,202,126,10,98,150,181,217,216,200,159,210,0
],[
2,2,82,61,134,123,95,219,161,144,44,146,100,206,25,16,86,243,0,156
],[
2,2,54,13,197,84,51,223,46,185,96,134,245,110,98,93,28,61,107,29
],[
2,2,129,91,109,73,178,237,135,201,2,202,196,212,221,131,4,20,88,161
],[
58,5,12,45,216,159,37,118,136,52,182,14,29,155,80,22,201,142,210,187
],[
144,81,130,1,252,148,93,192,19,155,172,235,134,156,216,24,43,105,127,61
],[
173,78,199,184,131,61,243,147,30,40,52,5,103,175,193,60,104,251,41,89
],[
73,234,232,189,127,108,57,131,64,45,44,77,58,116,248,68,132,75,146,90
],[
213,224,127,211,244,43,230,3,111,209,233,89,144,72,53,156,141,60,216,117
],[
255,50,84,46,149,108,241,185,10,12,87,244,84,124,91,43,31,12,26,222
],[
121,221,68,197,207,255,187,18,24,214,93,246,80,194,29,102,40,254,89,31
],[
252,201,104,232,5,196,114,23,208,156,132,86,238,232,227,167,238,85,161,166
]
]