aLevelData = [
[
5,5,3,5,5,5,5,5,5,5,3,5,5,5,5,5,5,5,5,5
],[
4,2,3,5,5,5,5,5,5,5,3,5,5,5,5,5,5,5,5,5
],[
2,2,3,2,3,3,3,3,3,2,3,3,3,3,3,5,5,3,5,5
],[
5,2,2,2,3,2,2,2,2,2,5,5,5,5,5,5,5,3,5,5
],[
3,25,248,169,151,248,196,70,252,83,87,227,101,159,31,198,74,131,249,234
],[
14,233,243,176,222,86,86,209,220,118,228,151,125,252,94,77,47,169,73,244
],[
64,169,242,55,251,38,176,161,20,24,105,14,70,90,87,95,58,3,12,114
],[
171,243,180,82,200,172,155,170,217,100,239,128,38,88,198,31,20,98,98,85
],[
146,206,180,223,179,106,32,34,156,220,128,28,161,56,107,153,171,210,183,170
],[
221,81,60,83,119,5,219,132,250,123,192,74,141,78,227,71,159,63,213,96
],[
206,136,185,181,7,110,144,214,239,22,187,52,130,153,186,213,250,90,58,76
],[
243,152,79,233,204,63,254,45,80,4,254,128,150,176,191,38,37,188,172,112
],[
92,31,174,47,18,100,241,110,121,255,234,97,72,225,153,152,25,74,11,120
],[
15,223,36,236,189,252,155,88,67,75,70,207,186,150,152,133,211,217,104,135
],[
186,156,243,169,65,127,37,192,58,23,20,18,36,248,206,11,11,19,84,50
],[
169,67,230,91,209,34,129,29,14,33,167,134,135,216,94,14,37,154,123,202
],[
248,77,32,226,215,120,132,69,71,158,242,155,159,203,21,124,105,108,114,223
],[
10,99,54,213,166,91,50,119,62,89,36,28,27,148,56,208,112,135,206,2
],[
59,68,126,125,108,11,89,154,73,27,114,179,17,200,158,218,223,206,119,203
],[
210,229,167,32,107,150,99,196,54,76,53,170,173,174,255,191,89,44,61,29
]
]