aLevelData = [
[
2,2,89,222,224,152,230,139,29,83,158,232,184,173,77,226,249,159,156,203
],[
2,2,249,174,136,0,179,180,18,201,94,226,56,128,251,6,37,246,42,10
],[
2,2,165,18,65,189,219,187,159,215,54,248,62,55,161,86,136,110,250,139
],[
2,2,108,129,198,88,176,235,35,180,137,226,253,38,105,219,133,115,24,80
],[
2,2,223,121,6,193,27,91,224,249,103,222,97,146,131,19,107,187,117,55
],[
2,2,86,57,125,215,136,172,75,55,69,20,112,245,201,147,19,234,148,117
],[
2,2,229,81,6,109,87,43,43,33,10,226,216,233,134,44,247,212,48,50
],[
2,2,31,237,118,242,104,188,77,225,125,15,221,213,242,250,122,35,216,28
],[
2,2,215,4,143,36,118,62,220,148,99,0,59,197,34,13,119,43,230,28
],[
2,2,119,219,4,127,91,74,166,4,200,88,196,25,127,141,80,51,53,162
],[
2,2,177,112,159,67,115,123,204,19,61,176,183,241,3,128,29,122,124,23
],[
2,2,140,206,215,61,189,151,170,122,35,72,43,126,196,163,162,191,72,126
],[
2,2,30,100,79,198,103,98,8,196,53,229,0,159,159,241,55,35,214,73
],[
2,2,121,192,19,144,235,214,206,174,229,48,49,117,255,206,204,133,111,231
],[
2,9,138,108,146,46,228,18,200,85,84,85,133,207,13,240,165,219,233,161
],[
2,2,0,190,163,139,63,79,70,217,238,185,229,164,210,125,141,22,124,182
],[
2,2,120,208,30,161,131,138,158,92,226,249,233,238,19,246,138,136,16,220
],[
2,2,123,11,201,50,58,201,209,138,32,144,88,168,239,229,89,231,170,141
],[
2,2,20,217,169,82,191,46,236,3,121,215,176,189,127,107,64,105,162,201
],[
2,2,14,134,249,255,2,41,211,106,18,65,239,31,19,32,240,138,206,55
]
]