aLevelData = [
[
2,2,2,2,5,198,145,62,255,145,198,24,66,148,158,48,93,90,70,140
],[
140,66,111,170,166,213,81,114,69,87,239,105,39,156,157,39,212,30,192,11
],[
129,76,214,45,53,36,182,148,42,3,24,170,118,188,87,236,234,232,118,230
],[
59,126,98,95,95,164,118,209,58,196,68,28,122,225,147,122,192,44,164,182
],[
0,210,186,153,42,25,216,166,10,171,205,7,109,49,110,198,133,36,35,64
],[
142,224,165,215,178,251,5,232,42,212,241,253,167,111,51,67,240,128,122,62
],[
204,197,93,187,34,153,157,6,95,199,170,94,24,156,105,166,241,64,53,93
],[
189,70,36,208,230,129,139,142,15,25,196,29,249,223,46,235,163,222,118,135
],[
182,50,21,17,31,30,26,240,254,88,42,194,191,167,197,153,134,176,202,100
],[
209,13,62,171,89,160,73,128,57,39,129,178,81,16,108,67,237,142,63,28
],[
162,236,236,0,121,34,92,191,80,166,249,172,124,132,112,80,179,177,181,96
],[
42,156,71,237,250,7,181,219,200,21,97,148,165,164,132,253,51,220,114,170
],[
9,8,32,78,89,165,227,117,208,185,122,117,190,103,79,161,119,191,250,193
],[
249,219,7,191,207,39,249,163,53,0,142,193,124,129,69,49,176,153,30,128
],[
121,97,161,165,63,173,33,55,145,226,66,221,200,7,185,5,231,30,83,217
],[
198,180,57,110,112,183,114,63,201,136,169,219,116,81,49,218,243,153,70,21
],[
16,21,150,23,124,193,0,206,183,48,155,134,47,32,250,25,172,82,174,95
],[
235,153,13,236,137,48,50,251,36,80,69,165,188,2,253,87,95,51,98,130
],[
5,6,216,148,185,110,89,40,249,251,2,121,96,244,209,29,130,167,173,240
],[
24,253,166,78,93,81,127,133,183,130,105,137,154,71,18,234,169,195,222,4
]
]