aLevelData = [
[
2,2,2,2,2,2,2,207,200,61,51,3,105,231,205,166,109,85,87,206
],[
2,2,2,2,2,2,2,227,104,251,142,225,243,16,109,35,203,228,23,246
],[
2,2,2,2,2,2,2,34,185,83,84,16,13,53,81,115,31,149,182,249
],[
2,2,2,13,2,2,2,174,192,235,123,4,108,26,141,51,242,145,83,159
],[
2,2,2,2,2,2,2,183,104,150,188,235,100,22,25,119,28,34,158,48
],[
2,2,2,2,2,2,2,90,103,18,81,196,6,223,40,188,233,26,15,132
],[
2,2,2,2,2,2,2,86,190,158,166,196,56,31,147,238,41,66,138,39
],[
2,2,2,2,2,2,2,103,19,187,237,69,40,173,192,20,31,221,53,233
],[
2,2,11,2,2,2,2,72,168,70,161,158,106,236,35,252,232,240,229,141
],[
2,2,2,2,2,2,2,235,253,178,133,46,251,170,14,122,152,138,133,16
],[
2,2,2,2,2,2,2,39,45,231,71,174,83,134,118,58,162,1,20,118
],[
2,2,2,2,2,2,2,234,114,30,124,173,233,185,235,223,26,25,58,234
],[
82,161,76,245,176,76,68,102,145,75,154,165,76,240,111,35,32,202,29,156
],[
106,18,19,153,27,69,224,56,106,19,141,47,198,120,48,15,15,41,190,198
],[
5,49,33,104,1,220,138,47,227,212,9,192,75,138,91,175,12,215,3,70
],[
221,228,156,130,82,71,109,95,11,110,62,85,44,65,106,35,12,3,54,203
],[
50,121,97,222,125,79,252,249,162,183,124,144,220,83,14,234,222,85,42,109
],[
13,229,107,28,236,195,158,94,215,45,25,1,245,3,78,126,104,41,159,127
],[
198,45,116,158,205,41,139,112,82,235,144,194,123,84,238,34,46,254,228,162
],[
201,33,219,216,20,184,247,41,116,223,236,72,97,128,19,249,25,46,189,27
]
]