aLevelData = [
[
2,2,2,2,2,11,2,2,2,2,2,2,2,2,9,2,2,2,65,219
],[
2,2,2,2,2,2,2,2,2,2,2,2,2,2,2,2,2,2,220,161
],[
5,2,5,2,5,5,5,2,5,5,5,2,5,5,5,2,5,2,107,111
],[
5,2,5,2,5,2,5,2,5,2,5,2,5,2,5,2,2,5,44,200
],[
5,5,5,2,5,5,5,2,5,5,5,2,5,5,5,2,2,5,233,90
],[
5,2,5,2,5,2,5,2,5,2,2,2,5,2,2,2,2,5,120,251
],[
5,2,5,2,5,2,5,2,5,2,2,2,5,2,2,2,5,5,77,121
],[
2,2,2,12,2,2,2,2,2,2,2,2,2,10,2,2,2,2,124,19
],[
216,152,29,113,61,45,78,74,168,71,52,67,255,193,136,62,104,187,62,115
],[
11,74,100,194,25,111,76,71,13,70,237,48,50,128,135,203,101,19,134,227
],[
28,48,169,77,167,118,99,190,182,101,130,224,28,21,14,164,210,40,116,217
],[
63,253,227,254,182,38,247,84,65,29,149,56,157,50,22,176,133,200,167,68
],[
52,193,239,15,37,55,243,21,29,109,55,215,107,5,38,37,110,115,180,52
],[
89,177,66,240,51,52,194,147,34,32,27,119,232,184,207,40,174,24,219,190
],[
1,38,223,106,26,198,126,78,98,77,8,146,53,57,86,180,230,31,246,31
],[
4,228,137,0,220,48,104,85,63,32,142,70,134,59,178,185,210,168,179,33
],[
153,158,57,150,94,27,154,43,191,217,250,124,181,126,183,134,24,18,4,188
],[
97,183,211,87,180,148,249,237,30,19,140,69,27,76,144,106,91,193,211,254
],[
197,75,22,209,189,84,109,178,162,71,233,133,155,69,115,150,148,26,251,45
],[
131,111,211,99,240,64,85,51,180,145,204,212,1,93,146,70,162,208,117,44
]
]