aLevelData = [
[
2,2,2,2,5,59,35,240,240,233,128,236,1,226,81,129,106,112,140,93
],[
2,2,2,4,2,112,213,62,232,41,220,208,121,225,180,137,201,188,254,85
],[
5,3,3,3,5,168,157,37,197,238,71,238,86,181,194,80,246,197,1,133
],[
2,3,2,2,2,196,80,193,97,24,224,180,227,195,141,223,10,152,115,64
],[
2,3,2,2,2,233,43,99,181,254,216,217,25,192,7,46,176,119,175,15
],[
2,3,2,2,3,197,80,25,46,145,177,231,55,95,202,84,6,238,109,189
],[
2,3,2,2,3,23,23,31,97,62,175,111,101,152,175,134,27,193,146,0
],[
2,3,2,2,3,131,71,255,250,18,95,168,108,179,215,114,186,12,76,214
],[
2,3,3,2,3,133,2,157,135,199,127,159,85,31,114,19,81,105,24,213
],[
2,2,3,2,3,50,146,123,86,247,170,56,75,206,59,132,167,53,218,113
],[
2,2,3,2,3,199,95,251,110,237,217,10,13,240,109,183,10,50,71,145
],[
2,2,3,2,3,136,209,86,214,157,34,245,137,17,91,203,198,99,143,239
],[
2,2,2,2,3,83,13,224,80,119,9,240,85,15,148,152,192,222,50,221
],[
2,2,2,2,3,216,37,242,31,199,115,243,148,65,191,39,245,102,180,87
],[
2,2,2,2,3,119,234,76,104,253,115,160,220,140,66,255,156,255,22,61
],[
6,2,2,2,3,244,252,77,77,223,38,77,18,133,148,34,115,2,131,104
],[
8,2,2,2,3,174,105,71,108,238,8,136,142,31,238,170,234,1,171,141
],[
9,2,2,2,3,55,123,87,119,238,51,214,78,175,91,89,11,226,206,40
],[
107,154,91,160,231,190,96,119,231,106,155,72,51,147,62,75,170,234,65,99
],[
54,3,252,95,255,183,245,121,223,199,247,35,23,193,100,4,64,40,203,61
]
]