aLevelData = [
[
2,2,3,3,3,72,6,173,254,108,114,27,226,121,95,90,82,224,70,143
],[
2,2,2,2,2,50,4,209,80,16,75,154,89,6,116,54,128,226,43,114
],[
3,2,3,3,3,235,133,218,220,128,137,195,134,157,39,76,6,9,87,153
],[
193,43,56,96,106,122,179,249,197,53,91,181,177,84,152,113,101,190,5,107
],[
250,188,22,84,42,174,254,166,87,253,208,55,206,80,228,15,78,3,124,118
],[
196,213,167,82,89,224,102,176,174,207,14,161,102,75,237,71,230,182,48,47
],[
88,28,4,225,246,102,252,182,133,209,179,234,31,159,178,242,54,13,148,16
],[
214,132,104,36,42,19,86,197,66,29,134,144,19,79,61,192,192,213,73,0
],[
24,206,160,125,95,253,68,62,81,193,105,184,100,71,218,157,78,254,153,246
],[
199,75,197,113,144,127,193,252,180,6,147,146,14,224,138,85,11,86,36,222
],[
177,229,46,209,224,127,45,180,216,243,253,1,252,169,184,121,214,146,218,188
],[
90,95,162,23,111,241,187,157,171,17,27,121,94,98,44,130,211,147,41,16
],[
210,217,203,14,105,157,38,81,237,114,205,40,59,73,61,53,67,232,121,123
],[
200,152,241,183,97,30,168,244,196,237,150,90,67,154,76,71,151,144,214,161
],[
221,5,229,106,222,45,46,148,147,173,13,23,233,82,110,66,193,3,237,78
],[
59,244,60,57,52,29,197,210,13,235,145,16,174,53,105,167,203,113,59,221
],[
102,40,191,154,150,167,89,191,134,248,66,185,192,16,227,86,172,74,129,215
],[
83,20,31,70,105,232,160,10,139,127,45,184,197,65,214,44,87,255,124,217
],[
185,228,238,93,220,169,82,88,179,9,199,127,242,117,72,236,22,8,211,184
],[
165,189,203,204,183,224,156,244,181,194,157,54,97,177,58,97,22,39,82,232
]
]