aLevelData = [
[
6,219,150,162,185,240,71,254,151,190,232,62,171,71,63,163,128,248,215,25
],[
2,165,57,72,105,11,67,184,176,174,49,162,16,119,90,214,165,97,223,193
],[
2,187,220,128,239,62,111,180,206,113,160,248,181,227,24,103,36,160,3,139
],[
2,78,164,182,115,212,149,148,5,212,177,50,150,34,5,185,184,213,223,140
],[
2,83,6,135,43,248,212,42,88,113,171,23,120,157,199,46,59,123,243,148
],[
2,127,132,151,172,114,62,241,67,247,14,163,11,76,77,110,75,233,159,61
],[
2,212,171,128,101,55,49,32,43,53,135,113,135,119,1,126,39,128,106,254
],[
2,183,223,94,41,96,169,245,202,142,38,162,150,247,203,90,188,217,104,248
],[
2,189,130,163,224,126,22,165,226,156,141,19,98,255,251,64,182,178,20,161
],[
2,208,241,239,129,29,132,10,245,172,76,143,19,147,28,213,95,143,202,42
],[
2,134,234,133,208,79,162,104,69,206,199,80,199,219,37,235,24,194,35,18
],[
2,127,60,235,89,15,158,203,228,43,81,219,124,74,130,225,225,248,26,113
],[
2,98,30,241,89,172,130,62,60,224,145,83,124,232,93,135,93,10,226,115
],[
2,104,189,141,97,14,188,255,1,142,90,14,94,25,21,12,17,51,109,76
],[
2,180,92,247,227,154,240,173,172,189,76,136,143,248,50,81,2,119,111,180
],[
2,207,107,186,150,24,2,224,168,153,150,30,60,46,37,206,88,149,1,71
],[
9,116,200,254,250,158,151,241,69,146,123,69,137,69,40,45,61,33,238,15
],[
68,77,232,226,193,47,119,219,44,47,238,72,166,190,143,188,137,151,183,108
],[
68,69,85,217,102,230,160,175,248,46,10,237,16,175,111,71,163,87,147,201
],[
155,58,203,188,41,145,250,205,93,3,191,108,244,36,237,115,113,60,60,8
]
]