aLevelData = [
[
5,5,5,168,112,47,29,132,173,66,197,42,31,3,122,96,193,147,171,100
],[
5,2,2,42,58,82,221,179,252,50,18,220,109,92,90,236,198,248,211,216
],[
5,2,5,55,66,87,102,127,211,172,146,187,34,251,49,123,74,132,212,27
],[
2,2,5,14,143,239,81,26,166,59,2,139,1,88,90,178,66,183,27,21
],[
2,2,3,99,183,53,183,236,14,152,154,105,107,70,129,27,90,172,250,238
],[
2,2,3,103,50,156,171,134,17,142,111,178,100,73,92,213,131,158,142,232
],[
4,2,3,140,250,80,91,66,233,144,183,27,217,145,130,148,33,224,99,200
],[
2,2,3,65,137,134,65,107,138,66,14,67,136,249,21,228,193,64,171,35
],[
2,2,2,66,64,98,23,90,92,34,217,78,21,124,136,78,42,58,144,168
],[
2,3,2,3,59,44,60,79,126,42,48,237,124,239,229,8,187,186,41,135
],[
2,3,2,160,45,174,164,133,9,186,218,11,57,33,5,177,18,113,197,166
],[
2,3,2,217,108,35,220,133,187,119,94,199,224,137,227,72,109,246,163,50
],[
2,3,2,115,213,105,241,62,155,234,59,63,60,85,77,74,147,43,120,2
],[
2,3,2,4,81,221,145,96,100,117,156,8,76,84,117,86,20,46,147,56
],[
248,26,64,30,192,150,146,23,77,203,156,54,114,19,229,59,5,185,26,111
],[
53,0,255,208,29,102,171,110,154,41,245,21,90,11,42,44,54,82,1,221
],[
194,20,208,119,34,177,255,16,31,161,189,110,122,112,243,40,127,6,118,8
],[
222,44,129,180,183,76,98,141,244,120,115,216,219,174,76,28,227,91,55,202
],[
199,29,229,35,218,205,95,87,154,189,62,234,135,62,31,92,54,102,82,9
],[
161,16,210,78,193,35,122,237,95,24,117,179,39,182,247,88,254,32,42,166
]
]