aLevelData = [
[
4,2,5,5,2,2,2,2,2,2,2,2,2,2,2,2,2,112,39,219
],[
2,2,2,2,2,2,5,2,2,2,5,2,2,2,5,3,3,161,92,251
],[
2,2,2,2,2,2,3,3,3,3,3,3,3,2,2,2,2,224,86,47
],[
3,3,3,3,3,3,3,2,2,2,2,2,3,2,2,2,2,231,37,165
],[
2,2,3,2,2,2,2,2,2,2,2,2,3,2,2,2,2,42,126,10
],[
13,2,3,2,2,2,2,2,2,3,2,2,3,2,2,2,2,60,211,123
],[
2,5,3,2,2,2,2,2,2,3,2,2,3,2,2,2,2,105,95,235
],[
237,38,48,161,151,8,45,5,150,199,250,191,68,102,97,1,93,194,151,186
],[
96,108,192,13,56,180,182,1,28,6,6,122,180,122,60,104,125,166,97,62
],[
110,183,193,166,220,192,242,114,155,81,17,214,102,76,79,213,128,244,172,250
],[
156,71,3,72,251,142,71,115,212,50,12,81,248,209,73,139,182,145,92,152
],[
252,180,78,236,192,109,89,108,158,242,167,38,195,211,93,63,9,138,216,44
],[
99,83,54,37,124,62,25,215,155,130,167,90,202,20,214,98,55,120,230,185
],[
218,216,47,237,88,83,28,70,40,151,120,250,244,178,232,164,66,37,185,243
],[
83,58,220,159,75,152,47,162,147,21,255,164,124,203,202,183,37,110,73,68
],[
158,221,173,69,77,246,42,181,145,175,178,69,166,98,3,81,201,105,227,18
],[
156,235,170,21,203,245,2,236,240,205,235,35,180,131,2,118,55,200,2,64
],[
179,3,139,55,92,162,34,87,138,174,122,28,25,163,241,244,16,126,94,244
],[
130,23,10,202,178,177,252,243,122,208,122,46,238,75,204,48,60,161,67,153
],[
215,144,122,39,212,228,220,41,148,142,102,55,163,245,174,33,224,145,37,37
]
]