aLevelData = [
[
2,2,2,27,251,63,183,177,14,198,34,176,144,7,82,143,235,79,170,49
],[
2,3,5,70,189,37,185,7,174,244,159,150,121,105,4,100,93,19,66,45
],[
2,3,2,183,43,200,122,120,46,37,105,215,204,98,176,67,1,149,224,156
],[
130,179,231,162,90,166,217,174,213,159,240,160,157,174,209,24,35,144,16,233
],[
64,200,247,202,29,241,131,79,80,82,176,24,71,179,246,73,234,111,20,57
],[
124,203,12,111,194,134,111,202,104,177,218,255,160,193,193,73,12,227,107,91
],[
222,143,62,154,62,96,61,137,236,35,207,132,38,46,194,178,204,243,143,53
],[
194,212,224,163,150,57,79,186,98,224,113,79,244,117,19,136,45,99,195,75
],[
167,233,147,246,154,112,25,81,1,28,186,193,248,161,41,190,105,88,42,134
],[
231,146,156,19,218,44,182,75,221,99,145,120,100,234,230,247,162,58,26,52
],[
170,42,119,214,212,191,189,54,98,69,217,22,99,158,244,144,216,219,175,76
],[
22,9,173,246,107,77,83,239,4,52,203,67,14,68,79,220,28,215,164,245
],[
201,41,228,209,158,175,129,172,54,170,135,242,159,253,33,175,4,59,95,70
],[
137,5,54,103,119,147,201,59,153,144,230,225,230,43,212,30,95,107,76,80
],[
59,194,197,164,66,230,245,137,119,220,148,101,249,85,99,134,43,62,109,91
],[
19,147,140,228,0,116,48,103,112,122,92,101,48,75,241,204,197,108,47,110
],[
11,87,121,178,28,206,88,137,115,110,195,164,82,135,158,229,96,43,128,19
],[
151,133,185,209,93,108,148,209,241,56,217,69,9,213,150,150,186,22,31,89
],[
151,75,84,127,29,21,34,203,79,121,77,138,157,52,108,126,10,78,53,27
],[
142,242,250,246,185,125,116,122,154,213,192,220,223,252,167,82,61,229,34,128
]
]