aLevelData = [
[
2,2,129,40,158,230,65,10,214,235,112,5,134,56,178,4,127,170,131,92
],[
2,2,82,224,19,82,192,230,84,222,114,16,81,174,235,41,193,110,186,205
],[
2,2,220,71,244,20,109,165,225,113,41,62,246,217,63,80,3,39,48,41
],[
2,3,174,191,225,237,32,113,239,148,254,161,66,50,155,165,229,123,108,111
],[
2,3,20,134,188,108,151,209,160,171,79,134,46,66,15,252,234,238,173,129
],[
129,249,88,87,186,97,43,252,169,54,3,174,38,68,142,47,125,242,165,198
],[
103,106,220,134,57,250,87,210,92,186,223,33,253,112,52,255,5,176,165,85
],[
76,72,223,233,9,219,3,40,142,203,251,36,50,92,13,217,142,23,176,180
],[
236,109,159,86,252,157,45,149,201,216,216,195,236,162,32,51,255,123,154,250
],[
85,191,64,243,232,203,11,6,147,97,196,169,130,78,23,166,230,73,233,31
],[
237,31,235,208,241,13,111,149,240,109,123,44,60,150,28,59,115,253,253,149
],[
178,160,56,185,6,164,108,156,35,60,16,168,89,206,7,4,195,81,116,22
],[
194,250,207,70,169,23,57,5,186,59,12,14,82,155,183,236,96,184,201,189
],[
27,62,75,53,245,44,83,230,202,54,214,190,94,104,190,209,6,11,60,88
],[
165,204,96,250,218,27,231,75,120,210,84,147,55,23,66,208,169,131,248,254
],[
111,132,62,149,172,255,111,84,186,58,208,61,28,250,32,225,180,232,112,221
],[
54,57,53,165,221,142,156,128,93,25,29,212,24,2,83,164,148,9,11,87
],[
45,108,155,187,7,11,117,73,71,202,251,171,131,55,149,123,118,109,1,78
],[
249,56,235,241,47,121,190,242,255,204,185,98,199,105,69,218,78,72,134,188
],[
251,137,48,187,69,18,156,158,107,122,27,64,101,38,138,220,26,177,38,135
]
]