aLevelData = [
[
2,2,2,2,2,93,211,111,84,99,46,88,234,238,231,95,125,133,121,229
],[
2,2,13,5,5,119,52,207,250,56,50,86,34,195,193,86,89,183,86,130
],[
2,2,2,5,5,86,130,250,206,13,209,240,128,119,74,152,138,149,126,147
],[
2,2,2,2,2,23,179,25,40,100,234,92,230,209,232,206,139,56,244,46
],[
2,2,2,2,2,37,125,44,171,119,102,17,88,158,173,70,218,245,84,149
],[
99,53,57,51,229,225,234,69,127,225,186,162,60,108,21,219,252,44,16,121
],[
178,157,68,133,208,183,221,78,0,204,238,102,21,179,8,238,65,38,10,19
],[
136,105,58,217,116,44,149,24,11,179,100,195,254,52,16,112,35,129,55,21
],[
37,230,255,16,123,85,171,107,150,192,108,93,95,199,121,20,224,147,97,177
],[
65,2,160,149,247,4,113,219,56,69,228,37,178,12,48,156,124,99,74,50
],[
77,120,183,43,236,67,158,219,231,105,33,177,136,96,237,116,5,212,16,205
],[
247,74,12,6,13,4,41,17,2,36,15,204,204,20,147,131,23,36,210,182
],[
241,117,124,29,199,23,115,234,144,110,149,78,72,218,213,62,160,150,145,119
],[
244,225,32,192,125,92,170,111,200,180,60,46,102,128,27,255,230,109,89,126
],[
0,152,167,102,19,59,106,87,210,140,17,215,57,226,165,150,199,26,161,246
],[
231,57,5,202,175,82,166,94,204,171,200,185,189,27,238,30,64,182,241,217
],[
10,173,80,56,187,111,199,215,17,20,35,32,92,252,84,19,50,179,196,67
],[
99,24,231,33,47,191,20,125,183,147,147,74,178,192,247,162,97,208,173,10
],[
197,19,214,246,15,69,82,144,88,107,29,181,146,254,223,64,191,75,190,140
],[
97,26,119,52,49,142,173,29,19,76,129,183,74,223,98,127,232,92,38,201
]
]