aLevelData = [
[
2,2,2,2,238,132,67,240,220,46,37,238,53,108,212,222,174,104,234,196
],[
2,2,2,4,199,246,246,191,184,188,22,71,168,150,200,179,33,57,253,254
],[
5,3,3,3,193,22,111,202,50,129,53,165,92,18,148,140,216,75,25,173
],[
2,3,2,2,168,124,228,113,38,228,71,186,59,25,144,106,209,170,34,36
],[
2,3,2,2,139,2,203,86,179,143,81,119,116,36,78,141,73,156,62,243
],[
2,3,2,2,181,193,215,89,53,108,153,12,115,237,165,120,188,172,210,235
],[
2,3,2,2,180,17,254,155,72,162,162,235,229,107,169,234,231,163,131,28
],[
2,3,2,2,85,140,117,126,203,155,51,196,183,217,176,229,200,137,53,217
],[
164,11,177,161,218,0,80,137,23,175,78,170,156,168,14,178,239,166,102,232
],[
209,186,61,106,113,166,89,185,223,135,114,120,195,184,139,113,79,242,130,217
],[
114,184,229,213,79,242,7,61,237,216,83,159,48,17,225,135,8,28,71,253
],[
232,240,178,80,122,223,53,18,145,192,96,100,95,77,21,116,232,202,151,67
],[
182,232,228,172,206,232,69,162,228,3,35,185,203,10,28,231,47,74,86,140
],[
134,178,19,177,68,56,134,141,78,120,230,78,178,158,192,22,149,135,145,67
],[
109,35,148,243,112,30,217,199,75,191,151,232,24,16,195,72,138,63,225,43
],[
107,68,27,229,73,196,144,229,108,53,238,242,11,68,67,181,191,115,16,120
],[
55,7,160,45,46,33,151,178,154,43,206,83,38,117,94,145,227,32,251,33
],[
58,60,132,56,38,45,215,6,160,83,234,128,90,234,24,99,175,46,184,118
],[
218,195,244,15,103,85,217,216,232,124,170,211,233,226,122,156,38,167,249,239
],[
251,4,143,105,27,47,167,147,133,127,78,28,180,209,252,102,22,42,177,69
]
]