aLevelData = [
[
6,2,8,82,114,58,156,180,95,122,8,46,248,214,189,247,44,211,59,90
],[
2,2,2,163,199,145,2,244,62,43,116,25,157,236,221,32,5,125,14,34
],[
2,2,3,122,228,197,121,69,88,46,46,150,83,169,177,110,234,206,205,188
],[
90,174,218,199,227,92,53,203,217,173,237,231,248,59,191,54,248,176,69,61
],[
97,65,106,133,161,120,33,136,91,55,87,210,3,250,37,96,168,92,75,76
],[
16,221,218,172,10,226,48,183,0,253,41,41,204,111,148,233,204,235,228,233
],[
57,157,40,78,180,107,62,210,34,123,67,102,186,245,77,27,92,10,93,66
],[
37,53,143,210,64,192,148,11,255,139,98,89,42,9,42,123,151,139,139,228
],[
250,193,5,98,255,125,176,253,150,187,46,34,142,223,222,1,102,61,82,51
],[
96,222,4,160,214,129,68,160,209,225,117,96,216,54,121,136,6,254,106,26
],[
96,253,139,157,101,131,126,124,230,237,183,169,23,110,48,133,231,16,94,4
],[
141,245,101,12,99,227,136,31,248,0,227,58,96,217,92,253,207,169,215,11
],[
103,217,169,180,77,195,79,210,2,187,97,240,241,80,193,178,68,207,24,113
],[
252,9,131,37,65,86,137,136,246,218,81,120,145,7,17,157,42,99,202,77
],[
209,140,51,172,37,121,242,24,35,2,18,196,59,163,178,162,169,125,250,135
],[
2,157,84,138,13,129,216,173,213,216,7,191,252,138,189,128,82,248,97,7
],[
166,133,95,97,221,85,216,123,65,85,152,65,27,123,72,8,131,79,228,41
],[
119,170,112,239,43,189,231,180,160,86,117,70,120,95,229,144,9,167,93,118
],[
176,230,73,0,103,251,149,187,154,119,31,92,55,95,108,167,5,46,154,143
],[
54,26,149,159,63,152,142,152,231,34,169,92,158,56,246,10,17,165,163,107
]
]