aLevelData = [
[
2,2,2,166,227,240,109,57,128,89,179,38,182,253,56,134,15,203,127,218
],[
2,3,5,210,128,163,231,133,27,245,196,177,145,231,49,229,195,41,42,253
],[
2,3,2,173,17,188,164,224,64,24,24,50,131,230,46,180,247,219,149,228
],[
2,2,2,113,142,94,36,28,135,188,107,100,153,9,59,19,115,10,211,186
],[
2,3,5,113,116,165,83,184,175,10,36,129,217,53,231,181,14,101,39,187
],[
2,3,5,231,95,237,141,64,28,156,18,63,191,26,168,146,202,48,255,247
],[
2,5,5,144,52,46,2,238,229,0,27,54,150,143,198,108,143,21,39,181
],[
2,3,5,176,254,197,12,87,66,142,55,132,241,27,249,59,16,54,138,42
],[
2,3,5,163,153,68,140,11,249,159,77,146,67,95,111,69,38,12,172,2
],[
2,5,5,209,163,93,209,254,139,154,119,47,202,163,73,55,121,126,63,253
],[
2,3,5,117,226,73,125,88,84,230,15,168,144,242,236,78,42,191,238,73
],[
5,3,5,117,104,151,163,164,98,85,164,47,84,4,71,121,41,181,234,175
],[
5,5,5,99,174,73,243,178,178,173,186,197,130,97,114,96,163,102,105,175
],[
5,3,5,98,103,234,218,22,239,169,217,165,218,96,138,73,10,187,0,148
],[
5,3,5,91,114,30,178,216,180,101,239,47,204,11,120,98,255,77,102,192
],[
1,5,5,179,6,248,20,215,127,32,28,126,137,66,60,205,201,56,116,24
],[
5,3,2,84,153,144,72,124,59,158,128,233,246,165,0,235,171,148,73,14
],[
2,3,2,133,121,129,239,127,243,26,79,39,234,175,102,161,125,46,121,238
],[
2,3,2,60,60,175,111,152,213,33,164,151,51,48,58,205,242,27,69,135
],[
113,209,202,73,123,3,128,123,39,126,215,95,252,184,58,70,89,168,145,4
]
]