aLevelData = [
[
4,121,172,242,243,34,236,190,41,243,103,197,231,128,173,106,214,94,82,254
],[
2,207,146,148,216,158,74,62,168,6,203,205,8,6,171,208,84,91,64,149
],[
2,188,70,88,1,151,143,42,192,250,202,141,159,138,217,104,53,142,178,106
],[
2,201,73,99,251,112,134,83,114,118,116,202,136,255,180,179,12,238,177,161
],[
2,217,6,48,17,6,79,40,239,92,188,211,91,13,10,5,172,162,235,189
],[
2,181,54,100,249,72,226,116,207,249,120,246,186,36,116,200,50,50,47,45
],[
2,127,23,86,112,206,31,155,203,133,235,170,134,212,182,95,99,140,222,54
],[
2,58,53,159,3,225,91,33,227,78,40,181,114,0,56,91,62,155,168,137
],[
2,124,210,112,39,250,137,243,222,85,59,213,146,108,154,13,45,20,118,59
],[
2,159,14,224,59,35,54,143,250,195,252,131,136,30,24,231,111,105,122,60
],[
2,68,180,128,180,123,110,108,220,127,44,21,126,3,166,221,198,146,2,226
],[
2,163,110,86,121,112,151,104,216,212,42,184,18,231,236,192,73,150,39,122
],[
2,30,72,181,35,109,194,90,63,56,71,87,221,224,4,59,28,155,172,253
],[
2,238,34,96,72,28,170,209,22,138,22,168,128,189,107,38,212,154,132,7
],[
2,233,112,7,173,175,57,151,122,10,29,75,126,225,56,95,82,114,157,42
],[
2,67,232,155,80,179,47,63,57,189,7,25,194,24,87,67,50,62,196,160
],[
2,111,205,131,98,114,45,107,207,248,115,79,68,122,133,138,122,96,127,219
],[
2,8,114,86,116,41,143,188,77,192,161,67,190,153,208,196,77,242,246,2
],[
197,58,83,139,136,24,131,223,37,175,172,212,45,33,252,57,67,81,83,186
],[
115,238,60,3,197,173,34,41,17,213,193,69,20,1,218,98,196,33,43,153
]
]