aLevelData = [
[
4,2,2,2,2,2,2,2,2,2,190,155,1,201,178,166,111,26,52,0
],[
5,2,5,3,2,2,2,2,2,2,3,183,145,145,150,106,119,34,95,217
],[
2,5,5,3,3,3,3,3,3,3,6,29,175,102,42,148,223,83,41,133
],[
135,42,120,93,241,92,211,186,206,40,140,117,39,190,36,224,150,165,24,76
],[
181,90,253,207,215,58,207,68,246,161,135,146,237,84,235,50,231,28,170,235
],[
24,180,168,224,171,229,151,205,251,240,199,142,5,44,63,225,30,240,12,108
],[
225,179,217,2,108,114,192,34,204,83,96,192,181,135,48,72,118,116,18,225
],[
45,20,44,239,55,152,243,219,235,82,136,22,136,209,72,91,107,78,159,53
],[
134,71,28,194,13,105,203,182,114,179,191,162,148,217,238,119,52,230,66,70
],[
168,38,236,73,211,67,252,39,84,174,46,116,254,64,7,119,136,34,33,49
],[
134,234,196,154,152,6,181,46,226,94,83,168,188,53,223,14,170,80,28,237
],[
142,91,24,230,28,136,73,105,143,121,219,193,154,96,73,81,162,101,43,29
],[
42,72,79,140,143,71,10,108,245,66,208,54,129,29,3,147,201,102,9,32
],[
136,55,161,110,151,94,119,78,24,188,246,75,244,235,93,119,137,36,21,107
],[
156,95,66,137,149,187,152,132,235,33,111,35,221,36,26,65,99,44,117,25
],[
100,212,190,192,41,144,166,243,18,147,167,19,135,240,151,110,50,255,126,192
],[
107,2,165,250,244,8,239,65,231,18,108,58,236,117,44,133,175,127,81,135
],[
146,93,104,109,159,60,250,109,192,175,93,79,50,81,208,45,55,171,200,119
],[
11,88,132,57,26,102,231,161,112,0,135,188,113,74,2,128,202,141,145,15
],[
167,148,223,58,39,86,27,68,12,213,75,233,184,69,228,159,85,113,152,28
]
]