aLevelData = [
[
2,2,3,3,3,15,8,195,18,84,236,56,143,140,122,44,21,13,0,197
],[
2,2,2,2,2,7,61,150,203,220,76,2,255,32,35,216,174,187,151,230
],[
3,2,3,3,3,133,118,227,206,167,187,85,245,253,156,71,156,205,24,81
],[
2,2,2,2,2,77,143,153,189,121,252,192,59,95,103,101,214,47,80,218
],[
3,2,3,3,3,39,112,55,112,201,159,174,61,13,25,178,28,238,59,59
],[
2,2,3,2,2,244,71,199,18,62,67,137,227,193,21,59,147,160,234,167
],[
3,2,3,2,2,211,151,28,11,246,130,169,193,255,31,227,31,255,20,105
],[
2,2,3,2,2,157,158,52,85,53,247,254,183,16,169,102,67,94,42,217
],[
2,3,3,2,2,70,134,95,123,223,127,106,179,107,125,196,233,65,209,139
],[
2,2,2,2,2,142,160,10,29,93,229,97,229,225,1,84,117,56,43,144
],[
3,3,3,3,2,213,22,210,20,27,13,214,148,60,11,247,27,34,36,142
],[
8,2,6,3,2,245,255,145,123,204,224,249,94,17,133,240,10,158,112,190
],[
2,2,2,3,2,54,153,60,97,118,155,48,213,106,17,20,146,53,227,67
],[
2,2,2,2,2,87,49,84,2,38,226,42,16,143,40,14,127,50,184,53
],[
193,128,204,64,6,193,26,97,198,91,3,192,153,81,14,29,79,10,148,182
],[
61,84,189,107,213,168,171,32,122,176,244,99,146,6,86,78,220,63,166,175
],[
3,40,10,103,116,79,104,16,109,197,30,227,87,35,244,216,86,203,78,14
],[
30,112,167,110,8,217,58,140,101,225,2,205,18,195,229,207,77,148,45,5
],[
198,17,55,162,249,155,111,185,188,128,124,162,20,124,183,159,77,128,226,191
],[
74,177,23,3,25,180,254,192,202,41,67,68,130,117,71,188,203,197,22,86
]
]