aLevelData = [
[
2,2,2,2,2,2,2,2,2,2,2,2,2,192,183,193,8,111,47,3
],[
2,2,2,2,2,2,2,2,3,3,3,3,3,130,131,175,141,255,246,215
],[
2,2,3,2,3,2,2,2,2,3,2,2,2,210,58,107,80,37,71,110
],[
2,2,3,2,3,2,2,2,2,2,3,2,2,2,30,111,252,135,64,59
],[
2,2,3,2,3,2,2,2,2,2,2,3,2,70,223,216,207,178,101,40
],[
2,2,3,2,2,2,2,2,2,2,2,2,3,121,35,1,197,138,122,160
],[
2,2,3,2,3,3,3,3,3,3,3,3,3,62,101,93,225,254,213,55
],[
2,2,3,2,2,2,2,2,2,2,2,2,2,17,116,164,127,90,113,105
],[
2,2,3,2,3,3,3,3,3,3,3,3,3,62,55,209,161,203,43,93
],[
2,2,3,2,2,2,2,2,2,2,2,2,2,1,217,179,240,11,180,121
],[
2,2,3,3,3,3,3,3,3,3,3,3,3,217,224,200,202,129,85,99
],[
1,2,3,2,2,2,2,2,2,2,2,2,2,74,78,72,188,231,198,53
],[
51,11,248,4,218,22,23,37,53,11,105,223,62,137,95,229,172,254,6,43
],[
117,23,158,247,146,123,135,59,2,184,101,34,17,125,124,233,218,11,92,240
],[
11,230,195,17,232,208,191,48,147,247,19,19,138,110,220,116,113,218,116,85
],[
18,110,151,148,162,25,196,191,69,253,230,41,213,36,52,62,223,110,86,19
],[
239,206,201,66,14,182,132,244,136,208,220,63,243,239,165,179,108,69,154,47
],[
36,214,255,249,28,44,132,14,44,77,109,183,74,234,240,93,9,217,222,158
],[
96,198,134,161,173,37,215,166,249,106,196,225,126,125,237,136,102,104,123,43
],[
214,83,75,68,43,179,80,15,132,190,50,155,128,34,59,33,73,246,116,150
]
]