aLevelData = [
[
10,2,2,8,2,2,2,41,74,140,69,79,125,65,120,250,242,190,175,143
],[
2,2,2,2,2,2,2,205,167,203,246,158,88,134,150,137,123,181,129,164
],[
2,2,2,2,2,2,3,218,203,235,160,113,159,225,172,200,111,56,150,128
],[
9,2,2,2,2,2,2,36,195,51,43,215,201,2,97,149,181,12,16,95
],[
3,3,3,3,3,3,3,16,14,19,117,173,218,6,213,35,251,89,254,128
],[
2,2,2,2,2,2,2,152,164,249,60,155,58,154,108,17,1,4,56,212
],[
2,2,2,2,2,2,2,129,107,143,104,58,30,26,36,59,196,110,146,240
],[
2,2,2,2,2,2,2,229,133,24,60,173,111,215,199,237,69,211,154,99
],[
2,2,2,2,2,2,2,95,84,233,59,198,141,47,213,236,124,129,201,155
],[
2,2,2,2,3,3,3,17,27,41,44,146,64,6,249,62,65,53,21,49
],[
2,2,2,2,3,2,2,219,82,58,135,197,6,2,196,138,134,90,116,149
],[
2,2,2,2,3,2,2,92,52,14,138,106,125,30,221,44,79,163,157,61
],[
103,182,144,29,217,109,133,49,2,255,230,11,191,41,141,236,220,208,216,135
],[
208,231,0,8,167,147,166,85,63,141,175,148,183,201,82,237,37,85,111,145
],[
135,131,35,251,253,74,153,118,53,234,35,223,38,207,137,172,1,184,161,45
],[
100,24,31,18,209,188,175,46,96,175,65,122,176,91,164,93,35,240,87,42
],[
75,10,156,235,159,142,205,93,115,212,243,59,39,12,149,191,158,218,206,103
],[
241,68,162,245,101,206,146,185,155,227,110,18,7,119,107,51,163,235,118,35
],[
229,49,199,7,238,48,184,164,4,106,216,32,66,220,59,8,142,37,21,152
],[
204,235,135,54,81,123,185,63,155,175,41,6,63,21,67,26,34,77,49,200
]
]