aLevelData = [
[
6,2,8,2,9,2,10,181,130,125,24,145,124,39,149,236,53,219,23,200
],[
2,2,2,2,2,2,2,185,72,38,223,232,157,190,138,202,148,73,225,34
],[
2,2,3,3,3,3,3,175,202,36,70,193,91,90,45,177,217,55,202,123
],[
2,2,3,2,2,2,2,222,67,152,119,239,57,119,222,247,173,182,138,244
],[
2,2,3,2,2,2,2,242,113,253,241,59,29,165,52,0,97,95,184,164
],[
2,2,3,2,3,3,3,39,57,222,84,244,124,95,50,116,234,133,179,90
],[
2,2,3,2,2,2,2,68,155,69,103,15,162,54,199,152,69,209,164,54
],[
2,2,3,5,5,5,2,15,202,246,207,220,220,152,157,141,176,161,50,0
],[
2,2,2,2,2,2,2,1,241,186,64,254,10,129,248,239,34,181,46,28
],[
2,3,2,2,3,1,3,118,108,45,234,224,232,195,72,172,26,173,73,168
],[
2,3,2,2,3,2,3,102,80,18,122,166,170,247,54,113,135,225,48,157
],[
2,3,2,3,2,2,2,248,243,15,2,1,109,35,129,146,208,249,70,184
],[
2,3,2,3,2,2,2,67,44,73,21,53,125,27,142,68,38,223,67,93
],[
2,3,2,3,2,2,2,108,150,196,37,116,161,130,152,87,128,131,240,120
],[
2,3,2,3,2,2,3,224,90,201,22,213,87,130,29,100,251,230,66,68
],[
2,3,2,3,2,2,3,174,12,78,229,180,123,186,178,94,146,125,148,125
],[
2,3,2,3,2,2,3,40,34,183,28,111,29,144,111,30,95,31,6,207
],[
5,3,3,3,2,2,3,40,113,70,165,29,106,26,51,154,193,230,153,73
],[
2,2,2,5,2,2,2,76,189,240,244,126,211,233,151,46,53,176,186,153
],[
183,23,253,171,46,240,245,122,224,186,54,20,57,129,177,122,192,255,65,236
]
]