aLevelData = [
[
5,5,5,5,5,2,2,2,2,2,2,2,2,2,135,188,149,13,71,164
],[
5,2,2,2,2,2,2,2,2,2,2,2,2,2,158,236,2,175,13,48
],[
5,2,5,3,3,3,3,3,3,3,2,2,3,3,196,5,121,230,241,203
],[
2,2,5,2,3,2,2,2,2,2,2,2,3,2,127,7,54,74,90,178
],[
2,2,3,2,3,2,2,2,2,2,2,2,3,2,191,77,180,185,170,202
],[
2,2,3,2,3,3,3,3,3,3,2,2,3,5,188,95,188,197,121,96
],[
4,2,3,2,2,2,2,2,2,3,2,2,3,2,83,114,94,50,156,154
],[
2,2,3,2,2,3,3,3,3,3,2,2,3,3,30,139,6,63,194,35
],[
2,2,2,2,2,3,2,2,2,2,2,2,2,2,247,131,248,187,189,198
],[
2,3,2,2,2,3,2,2,2,3,2,2,3,3,174,94,199,15,223,231
],[
2,3,2,2,2,3,2,2,2,3,2,2,3,5,21,173,173,195,237,30
],[
2,3,2,3,3,2,2,3,2,3,2,2,3,2,177,248,208,47,143,102
],[
2,3,2,3,6,2,2,3,3,3,2,2,3,3,172,101,205,77,83,156
],[
2,3,2,3,8,2,2,3,2,2,2,2,2,2,229,16,44,238,152,57
],[
2,3,2,3,9,2,3,3,2,2,2,2,2,2,40,214,134,188,248,149
],[
2,3,2,3,10,2,3,3,3,2,2,2,2,2,252,128,126,213,13,27
],[
129,141,228,222,164,36,88,17,153,217,193,127,146,98,10,54,248,211,8,136
],[
96,194,10,85,187,169,178,141,204,139,3,240,224,219,186,24,185,153,226,186
],[
203,190,163,41,171,218,91,27,196,252,240,176,76,210,100,176,118,17,169,20
],[
233,23,183,201,114,208,221,176,245,214,84,233,170,220,26,81,133,76,253,73
]
]