aLevelData = [
[
2,2,2,5,2,2,2,5,2,2,2,5,2,2,2,5,195,61,26,86
],[
2,2,2,2,2,5,2,2,2,5,2,2,2,5,2,2,31,123,179,213
],[
2,2,3,3,3,3,3,3,3,3,3,3,3,3,3,3,252,15,175,243
],[
2,3,2,2,2,2,2,2,2,2,2,2,2,5,2,5,177,10,179,75
],[
2,3,2,2,2,2,2,2,2,2,8,2,2,2,2,2,181,20,146,251
],[
2,2,2,2,2,5,5,5,5,2,2,2,2,5,2,3,5,72,203,16
],[
2,2,3,3,3,3,2,3,2,3,2,2,2,3,2,3,198,69,83,62
],[
2,2,3,2,2,3,2,3,2,3,3,2,2,3,2,3,44,129,148,213
],[
2,2,3,2,2,3,2,3,2,3,2,3,2,3,2,3,154,225,181,240
],[
4,2,3,2,2,3,2,3,2,3,2,3,2,3,2,3,11,135,28,239
],[
176,236,49,40,218,46,101,218,27,171,116,98,168,206,230,178,2,41,220,254
],[
214,196,9,184,33,181,255,191,151,241,172,212,70,98,36,77,119,58,161,13
],[
213,134,199,179,209,6,45,18,68,60,26,226,86,195,140,180,160,226,127,44
],[
141,97,107,106,6,155,15,201,78,213,109,204,42,206,22,85,70,151,167,24
],[
212,165,148,80,118,37,36,176,94,143,189,157,179,126,98,154,55,191,122,4
],[
40,168,211,255,100,171,230,176,208,43,93,173,249,141,210,177,252,147,218,149
],[
164,229,66,123,211,241,152,77,35,245,237,102,204,90,218,142,201,68,193,44
],[
54,103,85,183,253,28,93,110,177,180,181,73,186,12,149,47,179,97,21,105
],[
16,102,241,87,4,148,138,97,162,194,46,49,66,245,153,31,38,121,188,237
],[
93,49,189,181,232,43,62,31,28,119,226,215,71,58,13,63,150,254,236,97
]
]