aLevelData = [
[
2,2,2,2,2,2,2,2,2,2,2,2,2,2,2,2,2,107,82,88
],[
2,2,2,2,2,2,2,2,3,3,3,3,3,3,3,3,3,64,13,204
],[
2,2,3,2,3,2,2,2,2,3,2,2,2,2,2,2,2,12,5,90
],[
2,2,3,2,3,2,2,2,2,2,3,2,2,2,2,2,2,73,165,73
],[
2,2,3,2,3,2,2,2,2,2,2,3,2,2,2,2,2,166,97,174
],[
2,2,3,2,2,2,2,2,2,2,2,2,3,2,2,3,3,119,125,249
],[
2,2,3,2,3,3,3,3,3,3,3,3,3,2,2,2,2,203,185,47
],[
2,2,3,2,2,2,2,2,2,2,2,2,2,2,2,2,2,183,84,16
],[
140,185,68,164,237,134,82,89,116,68,93,162,148,44,13,154,211,60,184,81
],[
206,43,130,99,126,162,201,208,187,169,192,7,254,96,89,68,107,239,105,28
],[
15,191,7,87,102,235,52,253,32,241,194,179,36,174,110,72,214,137,80,140
],[
149,238,117,97,136,254,202,20,155,132,59,237,196,43,29,4,139,239,201,87
],[
201,210,138,26,176,208,186,78,11,20,39,149,199,108,188,69,179,251,93,187
],[
132,46,18,242,28,241,104,84,12,34,20,207,87,69,218,44,121,122,173,156
],[
167,173,24,148,89,13,220,219,6,191,219,226,46,211,52,83,158,119,176,236
],[
240,106,93,142,81,180,120,145,135,149,144,91,50,187,233,49,81,183,31,76
],[
9,178,11,48,162,92,234,57,211,38,188,119,63,177,235,188,63,134,45,242
],[
226,7,171,178,50,166,99,19,185,84,203,192,68,60,183,78,231,178,124,204
],[
65,102,86,155,1,222,7,128,169,35,193,247,147,186,70,202,49,213,78,227
],[
152,203,41,94,64,198,165,227,5,187,50,51,114,160,68,0,63,217,249,2
]
]