aLevelData = [
[
12,2,2,2,2,147,4,52,138,133,139,202,141,117,26,67,236,50,146,15
],[
2,2,2,2,2,45,190,60,96,136,2,176,130,236,193,246,106,67,203,236
],[
2,2,3,3,3,145,247,115,231,3,181,66,157,178,113,237,67,17,170,133
],[
11,2,3,2,2,242,222,239,238,79,63,162,146,107,17,252,86,232,125,81
],[
2,2,3,2,2,206,94,204,149,172,252,124,32,127,115,147,174,154,15,51
],[
2,2,3,2,2,170,81,39,111,172,108,184,93,64,213,77,108,233,148,34
],[
10,2,3,2,2,248,101,253,136,28,51,40,139,200,83,162,211,19,77,98
],[
2,2,3,2,2,200,210,116,255,250,105,108,32,191,225,234,51,30,59,187
],[
98,235,4,8,194,52,42,216,206,220,14,214,21,134,218,85,47,180,21,145
],[
245,48,117,55,242,172,244,40,20,165,37,122,167,141,201,192,132,40,158,140
],[
134,55,119,50,62,84,145,206,232,29,37,136,157,148,58,22,202,198,189,131
],[
224,171,211,47,77,78,110,24,172,45,31,87,56,227,43,238,135,4,224,192
],[
117,73,41,225,94,237,97,16,144,86,101,130,255,248,237,226,59,119,28,149
],[
160,11,85,66,204,41,81,146,87,96,110,52,190,129,74,37,159,2,145,46
],[
44,164,19,174,218,84,26,153,89,79,250,193,201,138,233,84,43,81,17,166
],[
21,46,228,49,170,12,176,219,202,156,115,119,134,248,240,141,215,135,2,94
],[
143,32,49,35,143,114,131,150,59,163,148,179,43,55,233,192,35,52,130,139
],[
70,131,174,243,134,154,36,169,95,88,78,56,197,48,232,67,91,138,202,14
],[
229,102,2,65,0,67,38,232,17,63,233,189,123,127,235,170,21,209,214,138
],[
219,144,166,48,227,201,72,170,147,155,103,198,18,228,131,214,252,26,67,177
]
]