aLevelData = [
[
2,104,151,86,101,199,164,239,146,142,158,85,168,183,39,239,129,127,24,127
],[
2,225,106,118,76,9,135,162,128,136,245,207,207,85,166,185,89,27,99,149
],[
5,210,212,16,67,224,153,50,203,196,184,174,7,61,8,211,157,169,121,155
],[
5,49,110,239,46,216,152,81,168,207,196,220,28,109,60,190,217,86,99,224
],[
5,236,242,84,3,230,29,198,14,223,32,51,166,186,224,57,0,171,86,64
],[
5,243,247,63,93,82,251,21,118,120,112,61,167,36,237,130,229,136,173,194
],[
5,225,156,147,231,47,184,107,25,168,98,115,51,13,101,26,115,237,35,7
],[
2,117,200,43,93,98,116,14,62,101,192,111,142,94,88,90,249,219,232,215
],[
2,55,68,132,190,142,85,72,204,153,209,59,247,73,117,121,255,41,43,146
],[
2,70,230,129,45,225,14,89,241,239,24,226,165,41,165,199,149,187,5,166
],[
2,56,83,253,195,17,119,199,254,211,27,91,2,200,115,237,192,115,6,183
],[
2,28,117,4,248,229,173,217,61,11,163,2,223,12,39,31,205,176,53,74
],[
2,139,246,28,168,123,78,223,61,92,8,220,5,16,13,171,64,162,205,73
],[
2,13,135,120,118,58,36,113,91,91,145,0,112,25,157,71,157,205,18,119
],[
2,160,78,58,67,174,6,161,149,93,76,29,128,193,238,12,119,213,12,221
],[
13,188,29,45,210,26,138,140,3,215,158,179,167,229,208,75,143,88,50,51
],[
2,243,29,81,207,113,232,93,163,83,110,138,32,17,213,181,189,22,104,75
],[
2,74,199,144,103,129,194,255,58,223,99,47,176,178,141,11,80,114,167,236
],[
2,101,84,228,198,91,29,200,164,107,52,232,81,123,252,241,88,63,96,235
],[
2,47,165,176,191,176,112,171,247,200,34,221,198,115,32,43,72,232,17,172
]
]