aLevelData = [
[
6,2,8,2,9,2,10,2,11,3,2,2,5,2,2,2,5,68,27,80
],[
2,2,2,2,2,2,2,2,12,3,5,2,2,2,5,2,2,119,221,134
],[
2,2,3,3,3,3,3,3,3,3,2,2,3,3,3,3,3,171,207,218
],[
2,2,3,2,2,2,2,2,2,2,5,2,3,2,2,2,2,190,181,218
],[
2,2,3,2,2,2,2,2,2,2,2,2,3,2,2,2,2,125,207,218
],[
2,2,3,2,3,3,3,3,3,3,2,5,3,2,2,2,2,167,166,228
],[
2,2,3,2,2,2,2,5,5,3,2,2,3,2,2,2,2,38,94,236
],[
2,2,3,5,5,5,2,3,3,3,5,2,3,3,3,2,2,13,253,39
],[
2,2,2,2,2,2,2,2,2,2,2,2,5,2,2,2,2,236,63,12
],[
2,3,2,2,3,1,3,2,2,2,2,2,5,2,2,2,2,71,225,157
],[
2,3,2,2,3,2,3,2,2,2,2,5,5,2,2,2,2,127,140,118
],[
2,3,2,3,2,2,2,3,2,2,2,2,5,2,2,2,2,245,116,236
],[
2,3,2,3,2,2,2,3,3,3,2,2,3,3,3,2,2,216,142,176
],[
2,3,2,3,2,2,2,3,2,2,5,2,5,2,2,2,2,105,14,33
],[
2,3,2,3,2,2,3,3,2,2,2,2,5,2,2,2,2,145,56,141
],[
2,3,2,3,2,2,3,3,2,2,2,5,5,2,2,2,2,37,68,33
],[
2,3,2,3,2,2,3,3,2,2,2,2,5,2,2,2,2,7,79,56
],[
41,133,90,211,111,181,4,99,84,133,89,87,222,240,51,175,95,24,2,177
],[
81,150,201,222,133,14,105,36,125,6,34,85,22,248,87,216,105,165,145,159
],[
244,173,199,88,245,93,221,232,23,200,106,21,80,25,190,130,10,39,36,225
]
]