aLevelData = [
[
5,5,5,5,5,2,2,2,2,2,2,2,131,140,214,53,15,140,36,159
],[
5,2,2,2,2,2,2,2,2,2,2,2,21,242,206,81,56,34,182,109
],[
5,2,5,3,3,3,3,3,3,3,2,2,162,237,124,235,248,181,7,225
],[
2,2,5,2,3,2,2,2,2,2,2,2,140,209,98,2,213,50,202,101
],[
2,2,3,2,3,2,2,2,2,2,2,2,29,71,5,137,122,31,245,149
],[
2,2,3,2,3,3,3,3,3,3,2,2,255,206,108,228,51,17,66,192
],[
4,2,3,2,2,2,2,2,2,3,2,2,194,53,165,110,115,52,177,108
],[
2,2,3,2,2,3,3,3,3,3,2,2,90,34,64,246,79,199,4,206
],[
2,2,2,2,2,3,2,2,2,2,2,2,159,142,211,61,1,158,65,85
],[
2,3,2,2,2,3,2,2,2,3,2,2,203,70,116,122,101,158,52,33
],[
2,3,2,2,2,3,2,2,2,3,2,2,254,107,66,214,127,68,235,132
],[
2,3,2,3,3,2,2,3,2,3,2,2,189,243,220,241,243,30,56,136
],[
2,3,2,3,6,2,2,3,3,3,2,2,111,39,232,91,139,80,51,104
],[
2,3,2,3,8,2,2,3,2,2,2,2,223,35,142,27,181,17,181,21
],[
2,3,2,3,9,2,3,3,2,2,2,2,189,89,250,44,3,43,221,179
],[
2,3,2,3,10,2,3,3,3,2,2,2,29,13,222,251,169,127,143,25
],[
247,218,237,234,2,126,240,85,165,44,97,208,11,177,236,38,104,197,118,119
],[
230,50,177,128,227,57,237,28,89,49,49,11,157,113,138,243,77,112,163,164
],[
131,43,150,160,79,199,2,219,101,120,94,191,18,161,140,115,117,61,177,93
],[
235,125,69,230,203,178,102,125,84,110,114,222,227,230,212,148,105,155,30,188
]
]