aLevelData = [
[
4,2,2,2,2,2,2,2,2,2,2,2,42,68,90,151,81,1,201,154
],[
5,2,5,3,2,2,2,2,2,2,2,2,151,127,158,113,83,200,135,159
],[
2,5,5,3,3,3,3,3,3,3,3,3,77,150,48,179,34,29,194,194
],[
3,3,5,5,5,5,5,5,5,5,3,2,234,44,170,20,23,116,155,30
],[
2,3,5,5,5,5,5,5,5,5,3,6,160,39,214,176,96,198,169,112
],[
3,3,5,5,5,5,3,3,3,3,3,3,185,52,53,135,124,14,117,154
],[
3,5,5,5,5,5,3,2,2,2,2,2,13,63,124,252,194,206,254,34
],[
3,5,5,3,3,3,3,8,2,2,2,5,141,251,18,87,219,139,54,176
],[
3,5,5,3,2,2,3,3,3,3,2,5,187,96,148,67,67,76,132,148
],[
3,5,5,3,2,2,2,2,2,3,2,5,47,39,81,80,204,31,64,62
],[
3,5,5,3,2,2,3,2,2,3,2,5,21,80,206,114,27,149,58,196
],[
5,5,5,3,2,2,3,2,2,3,2,5,170,157,67,128,41,65,51,95
],[
5,5,5,3,2,2,3,2,2,3,2,5,194,20,28,182,195,60,98,238
],[
5,3,3,3,2,2,3,2,2,3,2,5,68,129,121,52,11,164,240,113
],[
172,242,175,125,244,24,125,144,136,57,197,249,202,62,153,18,252,110,247,115
],[
168,62,75,102,63,106,54,155,0,68,142,29,27,76,166,133,23,2,207,110
],[
113,248,30,40,134,43,112,177,178,147,172,224,186,249,72,228,103,9,15,237
],[
116,168,33,41,171,136,59,242,74,249,56,70,171,2,216,119,36,176,193,35
],[
45,174,195,103,192,22,96,80,6,135,140,146,47,120,177,125,161,203,246,44
],[
86,165,193,0,127,126,122,77,110,116,147,82,178,229,197,111,132,60,156,146
]
]