aLevelData = [
[
5,5,5,5,5,2,2,2,2,2,2,140,149,77,28,124,230,52,22,188
],[
5,2,2,2,2,2,2,2,2,2,2,217,131,244,7,141,236,106,206,253
],[
5,2,5,3,3,3,3,3,3,3,2,141,244,44,40,124,27,28,111,163
],[
2,2,5,2,3,2,2,2,2,2,2,244,234,62,206,233,231,238,2,187
],[
2,2,3,2,3,2,2,2,2,2,2,97,234,17,200,210,17,107,138,88
],[
2,2,3,2,3,3,3,3,3,3,2,92,55,97,101,193,162,146,184,87
],[
4,2,3,2,2,2,2,2,2,3,2,119,143,140,186,241,121,15,177,205
],[
2,2,3,2,2,3,3,3,3,3,2,227,21,14,162,217,14,214,117,32
],[
2,2,2,2,2,3,2,2,2,2,2,53,162,136,192,11,69,116,192,4
],[
2,3,2,2,2,3,2,2,2,3,2,175,119,49,128,18,15,110,252,67
],[
200,161,138,98,82,137,126,189,214,123,107,242,138,167,78,84,132,157,8,144
],[
204,16,18,145,180,217,108,160,108,62,214,208,209,117,67,153,134,100,139,195
],[
70,171,96,133,120,228,131,239,4,41,55,133,102,215,247,45,1,146,100,75
],[
181,138,129,42,179,252,34,158,144,251,162,231,153,112,213,217,103,96,61,58
],[
179,109,129,108,107,160,26,75,4,101,80,89,19,215,101,25,23,62,16,184
],[
153,214,45,242,120,211,178,52,126,161,229,254,54,112,204,140,2,240,229,181
],[
104,89,24,19,173,175,234,100,165,68,243,48,201,126,146,173,138,218,223,223
],[
229,49,225,3,56,59,2,46,84,81,191,50,211,119,164,193,172,153,120,213
],[
4,21,181,78,71,122,59,221,120,143,68,34,197,152,155,17,95,212,9,154
],[
136,74,16,137,238,198,220,171,55,30,119,50,221,185,60,90,60,82,142,77
]
]