aLevelData = [
[
6,2,2,2,2,2,2,2,2,2,2,2,2,2,2,2,222,153,165,251
],[
2,2,2,2,2,2,2,2,2,2,2,2,2,2,2,2,253,157,185,159
],[
2,2,2,2,2,2,2,2,2,2,2,2,2,2,2,2,174,237,218,73
],[
3,3,3,3,3,3,3,3,3,3,3,3,3,3,3,3,198,159,20,229
],[
2,2,2,2,2,2,2,2,2,2,2,2,2,2,2,2,83,25,137,30
],[
2,2,2,2,2,2,2,2,2,2,2,2,2,2,2,2,33,130,19,116
],[
2,2,2,2,2,3,2,2,3,2,2,3,2,2,2,3,131,118,43,142
],[
2,2,3,3,3,3,3,3,3,3,3,3,3,3,3,3,79,254,10,209
],[
2,2,2,2,2,2,2,2,2,2,2,2,2,2,2,2,43,191,13,49
],[
2,2,2,2,2,2,2,2,2,4,2,2,2,2,2,2,7,113,94,71
],[
3,3,3,3,3,3,3,3,3,3,3,3,3,3,3,3,235,147,209,164
],[
2,2,2,2,2,2,2,2,2,2,2,2,2,2,2,2,243,93,12,102
],[
2,2,2,2,2,2,2,2,2,2,2,2,2,2,2,2,152,247,235,9
],[
2,2,3,3,3,3,3,3,3,3,2,3,3,3,3,3,48,232,35,127
],[
2,2,3,2,2,2,2,2,2,2,2,3,2,2,2,2,184,209,37,130
],[
210,91,69,41,10,110,27,185,93,164,41,190,252,253,191,91,77,212,28,223
],[
51,17,214,152,143,161,124,236,7,35,121,165,6,228,59,141,3,14,149,59
],[
7,28,98,44,105,145,108,22,220,234,140,120,173,209,18,118,69,147,102,228
],[
245,212,240,161,243,130,54,38,159,7,68,94,11,195,81,185,187,185,159,124
],[
169,136,163,91,140,158,102,73,90,168,43,143,12,76,82,27,161,27,124,27
]
]