aLevelData = [
[
6,2,2,2,2,2,2,2,2,2,2,2,2,2,182,40,200,242,130,26
],[
2,2,2,2,2,2,2,2,2,2,2,2,2,2,37,129,41,103,182,161
],[
2,2,2,2,2,2,2,2,2,2,2,2,2,2,139,63,125,163,194,29
],[
3,3,3,3,3,3,3,3,3,3,3,3,3,3,150,126,252,76,178,114
],[
2,2,2,2,2,2,2,2,2,2,2,2,2,2,138,169,199,235,52,170
],[
6,168,208,159,14,28,19,56,95,21,166,72,17,155,124,200,198,27,100,31
],[
221,197,218,161,232,50,35,85,96,74,153,251,152,101,67,77,240,176,168,134
],[
75,211,229,33,195,208,254,227,155,46,114,27,116,88,18,41,196,64,18,61
],[
133,71,97,97,42,97,54,186,215,116,236,10,209,2,15,122,52,8,183,151
],[
228,38,20,154,197,255,75,236,47,227,128,233,156,172,52,229,164,229,210,108
],[
44,50,132,206,218,235,75,219,204,11,79,236,137,73,116,35,55,132,45,243
],[
15,100,149,226,15,63,188,141,238,57,62,237,85,176,27,218,76,215,194,205
],[
243,160,111,234,114,224,183,62,50,174,98,69,78,11,120,175,68,201,158,99
],[
241,165,163,197,188,183,87,52,17,12,156,215,17,145,191,154,135,50,8,115
],[
30,68,143,234,210,32,82,216,165,17,133,111,147,113,41,122,199,14,224,230
],[
15,211,0,130,142,164,230,3,177,137,141,75,100,15,95,235,133,235,74,230
],[
152,225,23,184,189,228,247,150,224,127,95,248,48,115,22,85,210,162,141,45
],[
214,43,110,77,106,215,119,79,77,180,137,96,135,255,252,70,88,71,54,161
],[
110,208,124,112,90,54,7,216,69,82,91,33,223,97,212,2,153,99,130,30
],[
20,194,55,206,217,52,221,33,74,226,13,33,217,202,222,88,119,98,251,147
]
]