aLevelData = [
[
2,2,2,5,2,2,2,5,2,2,2,5,2,2,2,5,2,2,2,58
],[
2,2,2,2,2,5,2,2,2,5,2,2,2,5,2,2,2,2,2,218
],[
2,2,3,3,3,3,3,3,3,3,3,3,3,3,3,3,2,2,2,221
],[
2,3,2,2,2,2,2,2,2,2,2,2,2,5,2,5,2,2,2,92
],[
186,195,44,153,200,135,86,238,136,73,76,160,251,150,176,212,129,223,127,163
],[
157,45,243,112,249,16,168,121,170,216,253,173,180,8,189,190,209,8,255,118
],[
110,26,74,78,247,143,253,61,84,59,238,206,180,38,82,117,137,132,221,35
],[
211,232,42,24,162,180,92,249,214,212,6,34,42,172,72,61,113,78,59,19
],[
31,241,143,163,10,159,115,113,114,45,181,33,63,112,43,68,139,174,81,114
],[
96,83,51,153,195,229,142,148,241,58,50,0,232,233,170,75,41,254,31,13
],[
189,242,122,156,118,218,201,219,119,222,228,82,246,237,80,132,65,175,99,124
],[
255,187,169,170,185,11,135,237,153,172,30,241,113,186,114,187,254,140,204,130
],[
111,44,93,193,33,10,35,138,173,241,17,29,36,57,106,185,153,63,110,178
],[
224,18,56,196,150,111,231,167,97,240,252,227,121,128,3,230,104,18,118,84
],[
14,147,222,158,231,28,59,214,145,109,166,194,136,151,53,47,53,248,31,135
],[
39,108,32,166,160,194,31,234,83,109,15,137,108,124,19,40,209,205,229,169
],[
167,125,120,68,25,162,220,217,84,61,99,132,214,106,2,115,233,218,249,244
],[
106,131,182,210,207,150,247,226,105,178,48,217,229,87,44,96,25,157,246,107
],[
254,38,250,198,248,81,104,240,94,176,217,45,54,189,53,215,64,200,212,245
],[
55,52,227,15,83,227,10,64,18,239,75,140,56,155,46,116,20,137,27,200
]
]