aLevelData = [
[
2,2,2,2,109,44,250,96,239,106,50,30,193,18,34,214,67,210,80,68
],[
2,2,2,4,79,238,125,118,201,136,216,49,119,30,113,146,19,84,240,241
],[
5,3,3,3,159,244,135,10,249,51,37,95,175,54,237,216,20,212,230,173
],[
2,3,2,2,148,158,244,133,68,28,7,224,189,90,146,178,43,163,63,80
],[
2,3,2,2,161,141,225,144,176,54,169,44,55,204,158,104,124,83,71,245
],[
2,3,2,2,124,162,170,20,128,175,123,255,241,13,141,132,109,179,140,243
],[
2,3,2,2,26,255,238,58,59,251,39,79,1,222,28,206,163,214,219,228
],[
2,3,2,2,177,4,137,107,165,200,155,86,187,64,74,80,2,11,64,160
],[
2,3,3,2,179,83,152,80,194,10,5,142,180,115,81,82,176,229,10,65
],[
2,2,3,2,216,204,120,210,218,240,209,175,193,250,176,94,18,52,196,32
],[
20,144,197,25,111,236,173,178,248,148,36,60,204,8,60,214,156,0,94,144
],[
71,174,133,208,174,67,169,245,196,180,127,59,228,190,95,222,104,40,133,131
],[
119,72,125,211,30,200,217,105,162,170,37,238,21,138,29,130,40,35,29,94
],[
64,21,216,184,204,230,77,231,213,70,247,200,214,151,68,96,207,172,73,195
],[
149,209,180,52,108,12,2,141,215,163,242,226,175,222,57,97,115,14,119,124
],[
223,206,106,75,192,137,97,43,6,61,244,172,27,126,243,170,115,189,156,185
],[
101,202,17,199,57,152,9,252,130,65,197,229,174,73,70,210,219,39,189,124
],[
236,1,67,235,220,184,202,151,83,36,83,206,119,161,98,85,5,202,175,82
],[
160,132,31,105,105,63,242,38,207,120,62,155,169,130,156,74,130,135,33,69
],[
51,202,144,147,184,46,205,214,60,252,149,43,118,225,109,82,56,54,216,15
]
]