aLevelData = [
[
2,2,2,2,5,5,2,2,2,2,60,176,253,132,90,142,253,251,208,213
],[
2,2,2,4,2,2,2,2,2,2,110,24,106,112,161,184,36,189,136,212
],[
5,3,3,3,5,5,3,3,3,3,154,54,200,77,192,82,16,233,211,166
],[
2,3,2,2,2,2,2,2,2,3,169,152,143,80,79,253,163,149,64,41
],[
2,3,2,2,2,2,2,2,2,3,98,201,146,170,187,111,201,196,107,162
],[
2,3,2,2,3,2,2,2,2,3,169,254,113,180,73,225,194,20,105,252
],[
2,3,2,2,3,2,2,2,2,3,63,117,5,43,228,44,43,25,66,218
],[
2,3,2,2,3,5,5,3,3,3,9,4,47,76,74,192,188,159,163,255
],[
2,3,3,2,3,2,2,3,2,2,103,168,168,207,146,147,229,100,52,201
],[
2,2,3,2,3,2,2,3,2,1,42,24,207,24,38,176,162,14,55,225
],[
2,2,3,2,3,2,2,3,2,2,31,165,129,19,159,38,62,100,85,71
],[
2,2,3,2,3,2,2,3,2,2,84,240,128,150,45,80,229,27,195,96
],[
2,2,2,2,3,2,2,3,2,2,125,57,250,69,107,214,51,175,48,188
],[
2,2,2,2,3,2,2,3,2,2,30,92,34,62,207,222,27,30,21,157
],[
2,2,2,2,3,2,2,3,2,2,110,174,7,31,31,54,223,135,83,150
],[
6,2,2,2,3,2,2,3,5,5,12,92,5,44,130,140,251,248,85,177
],[
248,254,134,146,52,236,29,237,9,253,119,116,239,29,226,21,170,78,103,126
],[
194,74,231,225,52,106,106,244,103,198,179,61,97,158,24,140,59,249,144,201
],[
210,139,14,239,192,220,13,89,139,167,108,61,27,128,125,118,114,186,89,134
],[
151,136,118,219,211,98,123,81,32,171,82,249,223,144,127,25,201,51,177,115
]
]