aLevelData = [
[
2,2,2,2,2,2,2,2,2,2,2,2,2,2,2,2,253,112,148,160
],[
2,2,2,2,2,2,2,2,2,2,2,2,2,2,2,2,65,134,238,0
],[
2,2,2,2,2,2,2,2,2,2,2,2,2,2,2,2,27,65,30,141
],[
2,2,2,13,2,2,2,2,2,2,2,2,2,2,2,2,94,251,166,17
],[
2,2,2,2,2,2,2,2,2,2,2,2,2,2,2,2,184,121,199,29
],[
2,2,2,2,2,2,2,2,2,2,2,2,2,2,2,2,136,112,242,171
],[
2,2,2,2,2,2,2,2,2,2,2,2,2,2,2,2,239,71,129,1
],[
2,2,2,2,2,2,2,2,2,1,2,2,2,2,2,2,42,31,164,217
],[
2,2,11,2,2,2,2,2,2,2,2,2,2,2,2,2,31,17,158,190
],[
2,2,2,2,2,2,2,2,2,2,2,2,2,2,2,2,53,182,49,185
],[
2,2,2,2,2,2,2,2,2,2,2,2,2,2,2,2,105,237,86,45
],[
2,2,2,2,2,2,2,2,2,2,2,2,2,2,2,2,159,216,50,0
],[
2,2,2,2,2,2,2,2,2,2,2,2,2,2,2,2,53,40,70,251
],[
2,2,2,2,2,2,2,2,2,2,2,2,2,2,2,2,222,155,230,116
],[
2,9,2,2,2,2,2,2,2,2,2,2,2,2,2,2,174,194,236,42
],[
2,2,2,2,2,2,2,2,2,2,2,2,2,2,2,12,113,8,173,112
],[
2,2,2,2,2,2,2,2,2,2,2,2,2,2,2,2,65,240,44,142
],[
2,2,2,6,2,2,2,2,2,2,2,2,2,2,2,2,88,158,142,100
],[
34,153,206,80,150,207,178,82,199,218,254,110,182,129,231,82,107,130,202,57
],[
68,143,30,15,140,150,168,214,79,69,237,72,109,206,237,190,238,231,14,80
]
]