aLevelData = [
[
2,2,2,2,2,2,2,2,2,2,2,2,2,2,2,199,185,48,17,15
],[
2,2,13,5,5,2,2,12,5,5,2,3,2,5,5,228,236,114,118,85
],[
2,2,2,5,5,2,2,2,5,5,2,3,2,5,5,225,240,28,64,206
],[
2,2,2,2,2,2,2,2,2,2,2,3,2,2,2,102,68,106,172,246
],[
87,38,214,158,44,131,109,12,134,196,251,180,222,16,86,31,99,107,200,134
],[
64,229,108,159,29,17,219,183,232,185,8,1,213,208,105,46,163,168,88,61
],[
34,102,184,149,242,178,219,81,141,179,163,219,135,58,232,188,21,61,26,178
],[
205,136,40,3,172,175,160,18,93,71,23,48,184,85,203,180,138,7,135,78
],[
148,162,199,152,214,188,29,238,13,171,211,128,122,61,210,165,229,170,194,115
],[
226,198,115,140,83,123,124,58,46,119,34,191,128,34,123,230,178,211,211,222
],[
11,67,78,72,119,66,207,143,135,168,25,120,184,143,52,250,248,191,19,79
],[
102,106,115,75,90,26,6,237,165,231,209,52,26,237,210,51,77,253,231,104
],[
154,147,235,74,105,8,34,33,177,9,215,26,187,72,67,155,41,113,177,212
],[
54,96,224,151,63,145,169,105,131,216,225,217,39,82,129,16,125,155,4,170
],[
133,65,17,196,180,121,90,86,245,17,196,196,238,166,200,175,132,23,25,17
],[
161,57,135,137,52,205,35,243,122,175,164,60,125,80,9,116,218,101,128,37
],[
198,225,135,228,83,33,81,37,240,103,107,84,47,138,159,33,204,236,25,27
],[
234,171,200,128,159,28,7,83,179,117,125,176,165,201,65,93,239,58,66,161
],[
139,106,231,89,182,50,242,72,244,151,170,175,84,249,57,29,245,142,83,137
],[
201,15,24,158,153,177,60,86,74,87,101,202,94,6,212,73,190,153,72,167
]
]