aLevelData = [
[
5,5,3,5,5,5,5,5,5,5,3,5,5,5,5,5,5,5,5,129
],[
4,2,3,5,5,5,5,5,5,5,3,5,5,5,5,5,5,5,5,12
],[
2,2,3,2,3,3,3,3,3,2,3,3,3,3,3,5,5,3,5,27
],[
5,2,2,2,3,2,2,2,2,2,5,5,5,5,5,5,5,3,5,139
],[
2,2,2,3,2,2,2,2,2,2,5,5,5,5,5,5,5,3,5,84
],[
2,2,2,3,2,2,5,3,3,2,3,3,3,3,3,5,5,3,5,223
],[
2,2,2,2,2,2,5,5,3,2,2,2,2,2,2,2,2,3,5,248
],[
5,2,2,2,2,2,5,5,3,2,2,2,2,2,2,2,2,3,5,47
],[
2,2,5,5,3,2,5,5,3,2,3,3,3,5,5,3,5,3,5,249
],[
2,2,5,5,3,2,5,5,3,6,3,3,5,5,5,3,5,3,5,121
],[
2,2,3,3,3,2,5,5,3,5,5,3,5,5,5,3,5,3,5,202
],[
2,2,3,2,2,2,5,5,3,5,5,5,3,5,5,3,5,3,5,23
],[
2,2,3,2,2,2,5,5,3,5,5,5,3,3,5,3,5,3,5,99
],[
2,2,3,2,5,2,3,3,3,5,5,5,3,3,5,3,5,3,5,21
],[
175,123,58,195,73,8,200,186,190,214,22,239,3,153,82,231,91,27,116,201
],[
26,234,34,183,175,77,208,94,225,125,43,204,89,18,184,130,97,188,184,203
],[
235,51,80,76,213,113,230,219,107,30,206,149,46,76,38,42,212,100,254,124
],[
143,96,189,105,146,59,191,228,210,166,67,75,9,253,133,244,1,121,39,10
],[
15,167,213,151,221,25,41,225,109,91,204,250,91,40,223,147,99,222,153,17
],[
34,48,49,227,33,27,254,18,15,27,221,25,78,158,211,248,178,185,243,132
]
]