aLevelData = [
[
2,126,243,19,168,188,245,27,170,168,160,20,18,182,227,65,233,91,180,210
],[
105,124,175,1,188,39,0,90,7,129,132,90,167,255,43,60,187,217,161,16
],[
226,188,45,13,70,192,217,40,217,153,211,230,222,17,19,110,172,182,62,226
],[
174,207,202,239,175,149,100,163,84,160,142,127,234,160,141,206,98,77,130,53
],[
154,161,215,138,223,68,220,233,175,72,178,5,195,22,105,189,77,168,101,240
],[
126,249,6,145,75,186,136,254,113,71,39,141,182,217,135,104,114,253,84,156
],[
79,69,37,108,77,61,167,235,9,160,247,202,62,204,79,110,140,116,229,69
],[
120,149,16,91,181,171,173,40,162,36,193,173,19,21,96,191,84,44,205,162
],[
107,230,226,217,158,1,178,61,53,53,110,77,129,31,133,197,29,126,15,114
],[
116,161,108,68,131,32,40,165,225,203,34,9,252,224,238,198,165,129,119,39
],[
207,100,233,187,147,205,206,243,120,185,119,236,242,92,157,138,40,206,72,198
],[
250,2,240,73,67,247,226,57,91,50,230,83,225,107,31,58,183,135,50,14
],[
77,198,171,65,35,62,156,166,137,136,134,203,170,185,125,137,200,147,136,217
],[
201,253,71,233,243,177,216,112,244,53,250,62,37,12,115,23,15,45,176,193
],[
47,180,172,92,246,216,19,242,20,29,166,79,246,202,225,19,141,158,219,5
],[
82,191,111,170,135,243,153,23,191,18,34,3,160,188,128,32,232,71,248,172
],[
174,251,5,66,235,130,253,247,56,154,242,162,217,13,214,123,251,227,227,232
],[
58,214,58,147,102,6,203,192,135,238,116,222,30,151,109,91,174,11,227,189
],[
123,13,227,239,146,7,122,216,9,68,27,50,136,95,64,154,9,252,84,227
],[
219,181,209,176,237,88,166,66,73,79,219,142,223,95,119,147,132,150,162,234
]
]