aLevelData = [
[
2,2,3,3,3,3,3,133,195,153,83,166,150,183,114,24,19,14,73,63
],[
2,2,2,2,2,2,2,216,81,14,138,107,125,24,2,126,14,68,35,114
],[
114,151,234,27,190,37,47,195,160,49,53,113,148,149,128,107,91,101,230,249
],[
170,207,233,108,31,69,68,95,120,223,196,61,7,250,89,3,97,38,109,71
],[
87,63,116,122,39,217,197,106,243,225,168,10,113,130,176,118,229,70,75,50
],[
76,126,151,178,218,227,119,32,167,125,231,89,166,196,140,57,214,6,143,24
],[
188,8,172,148,16,240,134,145,183,98,62,127,241,234,67,220,212,154,108,249
],[
249,244,68,0,117,10,165,54,10,227,136,126,159,33,27,31,238,225,20,198
],[
125,227,69,207,207,235,113,192,219,102,95,22,189,81,44,69,172,87,229,250
],[
44,57,86,163,132,115,28,49,115,29,2,28,31,15,138,168,78,72,201,104
],[
216,145,120,0,93,93,73,46,51,244,119,12,162,208,161,143,84,71,216,84
],[
7,107,247,156,133,47,50,149,214,203,242,219,180,97,225,62,63,224,64,198
],[
242,41,129,244,214,112,18,75,245,229,119,15,18,148,155,77,151,138,104,27
],[
207,58,149,33,85,31,191,88,205,162,188,18,209,61,44,59,46,225,80,222
],[
81,149,32,234,252,97,151,55,62,106,82,196,161,94,89,67,165,18,61,215
],[
109,106,99,28,185,122,159,104,20,234,4,80,79,159,251,110,45,151,147,98
],[
96,21,24,23,180,255,231,72,139,132,128,66,137,1,221,235,144,38,3,3
],[
239,85,214,170,214,74,49,34,14,1,54,215,230,212,227,156,113,229,230,56
],[
238,187,179,33,136,48,211,135,64,138,127,148,39,232,109,243,208,224,234,143
],[
5,102,41,157,185,239,219,220,62,215,255,27,184,0,252,253,210,189,237,249
]
]