aLevelData = [
[
4,2,5,5,2,2,2,2,2,2,2,2,2,2,2,2,2,127,31,197
],[
2,2,2,2,2,2,5,2,2,2,5,2,2,2,5,3,3,177,4,188
],[
2,2,2,2,2,2,3,3,3,3,3,3,3,2,2,2,2,175,246,111
],[
3,3,3,3,3,3,3,2,2,2,2,2,3,2,2,2,2,7,105,49
],[
2,2,3,2,2,2,2,2,2,2,2,2,3,2,2,2,2,191,83,15
],[
13,2,3,2,2,2,2,2,2,3,2,2,3,2,2,2,2,227,254,211
],[
2,5,3,2,2,2,2,2,2,3,2,2,3,2,2,2,2,22,122,116
],[
2,12,3,2,2,2,2,2,2,3,2,2,3,2,2,2,2,255,37,211
],[
5,2,3,3,3,3,3,3,3,3,2,2,3,3,3,3,3,28,57,38
],[
11,2,3,2,2,2,2,2,2,2,2,2,2,2,2,2,2,252,84,177
],[
2,5,3,2,2,2,2,2,2,2,2,2,2,2,2,2,2,158,62,216
],[
2,10,3,2,2,2,2,2,2,2,2,2,2,2,2,2,2,134,57,91
],[
5,2,2,2,2,2,2,2,2,2,2,2,2,2,2,2,2,241,46,170
],[
2,2,2,2,2,2,2,2,2,2,2,2,2,2,2,2,2,20,234,23
],[
9,5,3,2,2,2,2,2,2,2,2,2,2,2,2,2,2,177,238,196
],[
2,2,3,2,2,2,2,2,3,3,3,3,3,3,2,2,2,142,125,54
],[
5,8,3,2,2,2,2,2,3,2,2,2,2,3,2,2,2,43,225,53
],[
2,2,3,2,2,2,2,2,5,2,1,2,2,3,2,2,2,67,168,192
],[
6,5,3,3,3,3,3,3,3,2,2,2,2,3,3,3,3,210,251,23
],[
233,47,153,92,5,99,173,82,204,78,99,4,112,114,9,32,57,4,204,168
]
]