aLevelData = [
[
2,2,2,2,2,37,146,233,186,183,162,174,213,107,185,20,225,205,64,179
],[
2,2,2,2,2,167,209,111,177,68,114,100,137,218,154,115,11,133,66,190
],[
2,2,3,2,3,165,145,218,5,224,234,235,191,45,211,251,105,226,219,177
],[
2,2,3,2,3,30,128,13,57,104,55,104,234,86,172,143,38,206,249,193
],[
2,2,3,2,3,130,37,245,10,39,237,183,187,121,14,85,25,246,25,241
],[
82,96,216,247,181,30,42,160,33,224,13,187,190,130,253,172,236,51,125,181
],[
121,214,243,116,23,168,184,173,13,35,112,74,44,35,151,160,5,72,93,244
],[
89,155,180,62,209,116,167,44,239,155,237,106,69,173,190,33,229,193,229,190
],[
24,76,23,244,83,66,131,4,102,126,170,60,247,100,113,189,47,197,116,130
],[
179,2,158,158,214,117,247,197,13,12,188,14,163,55,181,247,173,5,195,170
],[
65,138,185,127,227,131,108,193,64,61,14,181,31,178,183,216,148,245,69,105
],[
118,209,102,39,20,173,243,92,36,179,128,26,252,50,49,197,5,64,207,209
],[
108,163,26,205,26,242,97,161,231,247,81,20,10,88,11,145,212,118,121,42
],[
159,150,225,221,1,63,186,22,69,226,191,118,27,193,67,211,142,9,196,128
],[
55,65,194,206,176,232,209,210,76,90,238,105,5,244,15,122,182,120,254,123
],[
139,179,102,55,181,93,46,206,98,64,7,253,236,157,65,159,80,203,227,116
],[
227,33,250,34,64,22,49,121,133,167,162,251,191,249,236,156,162,64,134,198
],[
126,223,83,160,110,209,118,144,211,71,103,255,0,146,70,92,55,68,112,99
],[
213,146,81,159,201,253,121,45,74,50,241,196,202,46,207,242,37,165,8,168
],[
31,165,134,249,13,119,122,31,210,198,244,191,13,2,177,110,145,7,51,115
]
]