aLevelData = [
[
10,2,2,8,2,2,2,2,2,2,2,191,136,193,11,57,185,139,212,176
],[
2,2,2,2,2,2,2,2,2,2,2,36,33,203,222,164,195,196,150,211
],[
2,2,2,2,2,2,3,3,3,3,2,110,86,99,34,164,143,108,41,107
],[
9,2,2,2,2,2,2,2,2,3,2,231,154,59,152,115,253,62,77,91
],[
3,3,3,3,3,3,3,2,2,3,2,108,185,193,142,108,47,63,180,84
],[
2,2,2,2,2,2,2,2,2,3,2,172,114,101,174,157,223,152,223,228
],[
2,2,2,2,2,2,2,2,2,3,3,179,94,11,44,191,208,51,122,193
],[
2,2,2,2,2,2,2,2,2,2,3,69,160,5,229,201,133,72,139,203
],[
2,2,2,2,2,2,2,2,2,2,3,224,85,75,22,161,108,54,3,14
],[
204,95,236,102,201,155,227,196,31,132,164,71,134,196,201,112,135,144,61,203
],[
141,114,243,210,63,76,216,14,13,154,6,127,9,247,58,62,249,227,136,97
],[
170,195,77,31,135,41,102,53,105,86,159,135,177,253,110,11,149,74,226,227
],[
183,35,214,201,252,174,106,176,155,19,180,168,116,131,178,3,164,121,131,182
],[
86,63,215,2,219,181,165,83,254,78,28,104,145,91,219,180,76,140,100,4
],[
216,179,206,99,38,204,187,58,5,59,138,188,244,84,206,129,52,32,254,113
],[
34,94,110,228,196,201,125,8,162,153,16,130,215,76,64,88,103,166,80,14
],[
211,247,226,15,235,156,106,79,228,200,226,47,170,133,192,161,119,245,37,140
],[
165,222,87,114,193,101,113,80,224,26,89,197,54,53,243,119,228,31,148,179
],[
18,53,186,83,62,200,250,229,211,104,57,9,254,98,31,27,189,135,201,18
],[
57,47,190,168,85,126,37,188,135,230,53,244,231,237,236,166,133,49,4,249
]
]