aLevelData = [
[
5,5,3,5,5,5,5,5,5,5,3,5,5,5,5,15,66,95,85,61
],[
4,2,3,5,5,5,5,5,5,5,3,5,5,5,5,27,242,133,55,207
],[
2,2,3,2,3,3,3,3,3,2,3,3,3,3,3,50,245,150,226,159
],[
5,2,2,2,3,2,2,2,2,2,5,5,5,5,5,246,247,212,206,158
],[
2,2,2,3,2,2,2,2,2,2,5,5,5,5,5,170,1,185,200,170
],[
198,89,91,210,229,119,208,77,43,191,238,79,80,22,216,2,30,45,74,196
],[
213,86,32,143,207,151,24,184,96,253,216,221,0,51,51,25,172,83,168,121
],[
137,252,43,180,203,165,41,22,213,49,198,190,161,195,105,9,99,211,122,78
],[
105,130,106,204,70,42,244,224,47,58,163,124,165,65,149,212,85,72,126,90
],[
60,101,239,237,14,141,217,77,217,170,77,211,229,237,133,95,224,102,40,145
],[
55,210,202,60,199,180,178,23,181,167,225,182,154,242,80,185,228,93,120,68
],[
121,67,23,175,157,233,50,126,21,14,86,147,140,195,36,162,55,125,13,230
],[
181,105,89,18,57,255,110,139,234,218,79,212,138,199,99,73,86,28,120,17
],[
46,75,7,78,246,182,185,150,60,197,43,167,27,54,238,86,95,181,211,201
],[
233,173,101,230,86,93,182,11,219,46,95,0,115,68,194,42,61,83,146,1
],[
31,180,150,196,176,184,169,107,85,60,6,221,170,125,194,99,35,46,154,92
],[
243,200,239,51,44,34,15,143,40,65,182,201,41,113,213,163,60,148,145,55
],[
99,187,143,45,242,243,111,49,58,98,150,164,101,146,49,146,161,12,118,229
],[
129,41,45,216,159,37,112,174,135,117,175,163,208,90,247,35,140,183,115,58
],[
227,32,51,76,250,51,44,6,26,43,128,148,14,178,0,20,204,247,239,75
]
]