aLevelData = [
[
2,2,2,2,5,201,222,181,88,167,7,50,59,48,13,117,181,60,192,30
],[
2,2,2,4,2,182,136,49,9,121,243,23,35,8,237,113,124,2,44,109
],[
5,3,3,3,5,158,156,160,137,30,230,170,248,112,80,137,71,255,108,21
],[
2,3,2,2,2,64,125,245,175,15,120,17,120,163,47,211,193,87,163,4
],[
2,3,2,2,2,195,210,241,35,144,43,222,170,74,81,180,147,147,171,77
],[
2,3,2,2,3,27,68,251,109,198,98,136,85,163,78,124,148,209,59,139
],[
2,3,2,2,3,33,66,229,213,167,191,129,14,32,44,239,220,165,14,55
],[
2,3,2,2,3,128,132,74,51,185,148,47,137,229,197,183,221,106,251,10
],[
2,3,3,2,3,68,84,29,68,251,64,104,120,89,120,10,245,2,95,236
],[
2,2,3,2,3,200,94,16,207,130,73,66,154,59,12,111,242,214,140,53
],[
2,2,3,2,3,12,135,194,252,191,147,107,217,222,87,1,178,196,140,233
],[
2,2,3,2,3,163,48,201,238,161,84,73,238,93,40,239,211,107,4,135
],[
2,2,2,2,3,197,164,110,79,159,201,49,182,159,105,175,99,97,4,119
],[
2,2,2,2,3,121,14,112,26,26,209,124,59,42,138,212,230,85,199,36
],[
2,2,2,2,3,35,83,240,128,202,106,193,4,152,53,253,183,131,165,97
],[
6,2,2,2,3,181,75,69,215,142,82,194,237,233,173,170,133,109,123,116
],[
8,2,2,2,3,206,225,117,193,115,145,199,225,18,244,31,153,239,141,3
],[
9,2,2,2,3,35,234,15,103,119,174,196,127,201,44,47,210,83,72,241
],[
10,2,2,2,3,144,84,209,233,37,89,183,159,14,187,120,227,235,105,220
],[
177,214,231,226,88,244,151,250,219,73,56,116,152,209,172,57,39,204,254,185
]
]