aLevelData = [
[
6,2,2,2,2,2,2,2,2,2,2,4,243,127,194,117,87,113,214,192
],[
2,2,2,2,2,2,2,2,2,2,2,37,56,42,6,202,31,46,10,210
],[
2,2,2,2,2,2,2,2,2,2,2,20,107,63,171,90,102,38,172,126
],[
3,3,3,3,3,3,3,3,3,3,3,200,214,85,140,189,220,217,130,154
],[
2,2,2,2,2,2,2,2,2,2,2,70,217,5,194,251,115,83,202,78
],[
2,2,2,2,2,2,2,2,2,2,2,123,121,219,210,8,198,88,111,51
],[
2,2,2,2,2,3,2,2,3,2,2,127,193,181,27,212,216,113,45,19
],[
2,2,3,3,3,3,3,3,3,3,3,2,126,162,28,239,222,72,21,125
],[
2,2,2,2,2,2,2,2,2,2,2,9,134,95,218,133,154,200,233,183
],[
38,2,232,249,235,84,79,237,212,143,251,16,54,68,139,146,86,52,11,101
],[
44,8,208,148,102,66,162,214,176,116,33,99,51,175,97,6,91,63,216,115
],[
222,149,122,220,250,133,34,191,254,178,52,2,11,70,128,65,28,230,106,103
],[
68,229,72,123,55,183,12,189,12,169,35,242,65,208,157,252,0,63,141,173
],[
160,125,179,221,111,55,88,186,175,49,122,96,222,130,41,170,59,1,49,71
],[
133,251,249,16,6,39,171,152,208,219,149,5,71,127,208,31,223,67,31,167
],[
39,13,25,234,7,181,139,150,69,117,24,203,78,155,34,117,52,129,238,218
],[
243,191,2,111,248,159,210,240,228,210,156,175,141,97,145,45,69,230,53,231
],[
96,251,8,114,240,243,102,202,211,200,172,232,240,85,156,146,189,197,3,119
],[
5,76,152,123,232,21,40,80,35,123,240,70,145,123,75,100,242,105,141,183
],[
236,227,46,234,79,4,43,23,157,217,169,221,202,25,219,179,64,16,39,123
]
]