aLevelData = [
[
10,2,2,8,2,2,2,133,214,10,103,23,155,129,238,254,182,5,39,67
],[
2,2,2,2,2,2,2,87,16,114,86,127,183,103,2,29,55,23,159,120
],[
2,2,2,2,2,2,3,208,149,138,204,214,182,210,56,5,20,52,215,21
],[
9,2,2,2,2,2,2,89,74,46,142,186,255,198,222,193,70,25,168,80
],[
3,3,3,3,3,3,3,12,179,96,227,106,145,21,21,32,205,141,102,63
],[
2,2,2,2,2,2,2,125,151,59,37,216,157,38,174,154,121,104,169,170
],[
2,2,2,2,2,2,2,137,180,137,250,6,54,93,175,145,212,3,131,15
],[
2,2,2,2,2,2,2,180,152,103,183,254,50,108,105,227,210,227,66,222
],[
2,2,2,2,2,2,2,148,195,109,57,41,76,60,212,135,234,119,34,223
],[
2,2,2,2,3,3,3,92,244,116,208,21,103,122,218,227,124,6,21,206
],[
2,2,2,2,3,2,2,35,20,35,67,43,8,99,114,19,54,103,244,29
],[
2,2,2,2,3,2,2,167,169,177,163,26,121,1,174,74,58,17,197,111
],[
2,2,2,2,3,2,2,206,137,3,7,79,107,109,214,0,62,130,44,131
],[
2,2,2,2,3,2,2,109,19,102,76,234,84,183,85,22,52,41,19,229
],[
2,2,2,2,3,2,2,234,222,170,61,208,156,93,160,117,137,72,11,237
],[
2,2,2,2,3,2,2,50,81,30,108,210,92,124,20,210,190,117,10,140
],[
244,227,207,84,150,81,206,185,134,99,49,8,109,114,249,18,104,118,78,47
],[
254,41,19,131,86,105,190,128,166,222,103,172,239,222,30,165,232,141,130,98
],[
55,73,144,187,231,69,184,44,23,115,54,214,239,168,159,198,217,251,186,122
],[
237,110,146,161,172,208,201,35,242,225,47,97,38,184,147,190,180,98,218,94
]
]