aLevelData = [
[
5,5,5,5,5,2,2,2,2,2,2,2,2,2,2,2,2,2,226,93
],[
5,2,2,2,2,2,2,2,2,2,2,2,2,2,2,2,2,2,147,109
],[
5,2,5,3,3,3,3,3,3,3,2,2,3,3,3,3,3,3,32,55
],[
2,2,5,2,3,2,2,2,2,2,2,2,3,2,2,2,2,3,144,21
],[
2,2,3,2,3,2,2,2,2,2,2,2,3,2,2,2,2,3,133,41
],[
2,2,3,2,3,3,3,3,3,3,2,2,3,5,5,5,5,5,148,197
],[
4,2,3,2,2,2,2,2,2,3,2,2,3,2,2,2,2,2,139,28
],[
2,2,3,2,2,3,3,3,3,3,2,2,3,3,3,2,2,3,236,92
],[
29,155,19,68,147,237,59,176,228,129,42,33,23,144,71,47,251,253,245,134
],[
24,128,31,47,229,3,20,17,60,76,150,183,10,221,45,83,75,24,194,3
],[
54,167,104,84,180,27,125,5,23,211,242,13,9,32,231,222,194,166,123,236
],[
127,6,226,105,47,186,184,83,111,64,148,177,184,122,225,26,215,85,233,118
],[
158,169,51,9,218,96,15,173,133,219,111,94,60,145,248,252,243,249,89,77
],[
231,171,220,66,212,194,58,123,104,132,180,12,248,69,95,130,115,136,192,33
],[
148,104,152,112,91,54,1,248,189,100,186,72,155,161,192,60,241,70,30,127
],[
80,241,5,79,142,111,31,128,188,224,33,196,88,21,160,41,196,61,37,227
],[
247,193,131,76,115,108,104,41,118,207,51,47,117,228,5,198,198,241,27,12
],[
157,175,91,29,57,172,44,146,95,238,139,71,8,217,92,98,87,83,253,144
],[
205,37,33,146,192,164,220,249,9,146,250,45,254,63,149,180,160,243,231,177
],[
21,144,92,171,88,116,235,144,47,157,167,250,93,16,145,176,25,123,177,112
]
]