aLevelData = [
[
4,2,2,2,2,2,2,2,2,207,2,232,36,85,3,105,84,239,249,121
],[
2,2,3,2,9,2,2,2,2,144,57,97,175,224,172,30,118,218,21,26
],[
2,3,2,2,2,2,3,2,2,24,105,70,48,28,205,12,74,210,227,97
],[
198,44,167,226,31,207,247,131,201,106,154,129,92,71,128,152,245,32,75,119
],[
217,51,15,113,92,152,86,117,2,211,104,64,227,166,201,209,84,41,2,29
],[
195,28,164,5,227,123,139,133,10,83,96,46,215,213,97,214,23,168,101,142
],[
233,132,26,212,33,253,146,10,235,156,254,39,177,52,185,173,62,115,136,219
],[
35,184,32,35,89,36,232,222,41,244,1,63,73,14,132,133,72,217,10,117
],[
43,82,114,8,89,93,222,97,180,88,255,1,9,246,147,62,170,75,43,241
],[
89,35,50,112,104,152,43,188,31,228,58,251,94,115,230,40,131,61,29,9
],[
142,82,120,97,132,182,193,104,17,112,179,120,112,222,0,9,144,75,153,223
],[
111,195,41,130,202,38,226,239,249,124,125,141,21,136,124,98,91,160,179,135
],[
213,188,6,217,55,204,116,242,7,79,85,88,0,33,223,243,185,148,239,197
],[
130,195,7,213,142,35,146,108,88,91,112,132,63,86,174,126,115,150,149,19
],[
21,203,231,141,154,164,101,55,113,229,148,18,229,186,193,201,68,74,67,231
],[
65,144,0,72,151,102,51,205,239,227,108,84,4,231,216,232,5,244,194,52
],[
59,64,90,62,235,8,181,82,126,38,22,59,223,230,108,186,37,22,27,48
],[
114,92,255,158,26,205,174,207,8,186,254,212,94,205,200,177,92,85,235,86
],[
131,223,147,209,250,6,187,193,48,140,240,14,195,169,88,215,161,162,244,172
],[
109,158,34,254,36,182,102,211,0,75,105,190,156,156,66,15,90,151,245,71
]
]