aLevelData = [
[
2,2,2,2,2,8,165,157,121,11,143,72,132,8,128,252,15,173,255,119
],[
2,2,2,2,2,244,62,205,199,23,221,25,175,63,8,243,76,36,99,3
],[
2,2,2,2,2,248,201,184,123,111,11,60,74,49,122,20,147,39,105,23
],[
2,2,2,3,3,93,136,65,214,140,254,27,217,16,5,141,44,92,148,195
],[
2,2,2,2,2,27,25,0,210,57,28,29,74,167,150,166,10,146,139,223
],[
2,2,2,2,2,89,254,134,120,50,194,138,181,222,212,75,204,201,199,158
],[
2,2,2,2,2,143,142,146,47,74,84,147,114,239,93,212,220,112,220,140
],[
2,2,2,3,3,82,109,7,233,226,15,110,12,177,52,139,86,52,204,154
],[
2,2,2,2,2,226,163,130,171,82,171,160,245,207,100,44,109,75,130,87
],[
2,2,2,2,2,151,9,207,25,156,96,217,21,158,188,231,194,72,229,50
],[
204,169,132,82,184,66,227,247,200,93,244,217,30,161,149,242,35,228,18,234
],[
42,64,235,211,81,105,216,22,168,61,11,173,150,157,181,147,120,124,203,121
],[
138,53,10,187,11,34,57,146,156,106,174,139,234,26,19,56,140,120,106,37
],[
47,148,79,13,240,31,125,78,9,128,148,155,176,37,26,241,60,23,191,204
],[
138,210,229,154,159,83,95,112,142,114,121,252,156,114,57,187,163,215,229,107
],[
180,119,197,196,0,212,42,99,249,169,176,7,180,195,191,255,146,18,88,227
],[
31,0,14,131,58,1,82,29,119,108,244,211,193,137,231,91,68,235,69,249
],[
138,0,146,170,227,230,69,162,11,128,132,249,7,202,48,162,80,105,33,156
],[
51,135,179,108,120,221,129,202,66,17,112,155,54,67,240,31,223,227,126,108
],[
81,197,109,27,13,119,231,65,37,210,47,161,161,207,40,31,32,156,27,120
]
]