aLevelData = [
[
2,2,123,52,140,231,224,71,209,228,199,59,53,54,154,164,144,161,32,255
],[
2,2,252,45,79,55,65,204,98,111,145,62,43,251,118,50,169,175,8,174
],[
2,2,221,93,99,176,218,153,88,22,28,191,99,187,26,56,221,227,30,248
],[
115,217,85,75,215,214,34,210,181,37,184,200,233,133,232,138,239,207,55,87
],[
155,216,52,84,10,153,9,211,216,141,79,212,147,91,39,204,112,181,134,166
],[
61,128,208,8,151,53,169,215,93,135,8,253,101,70,140,106,109,131,20,88
],[
84,245,138,212,138,155,255,122,197,163,253,128,245,139,24,246,123,134,199,75
],[
149,33,114,20,29,38,204,9,116,192,99,80,185,225,118,255,62,225,6,220
],[
60,104,47,103,197,141,185,26,251,63,235,239,128,228,159,35,45,65,156,57
],[
7,154,31,67,110,26,187,93,152,117,99,122,62,203,198,99,149,208,219,252
],[
128,42,188,201,4,26,183,178,252,95,162,3,14,87,112,183,221,104,2,246
],[
128,158,63,220,52,149,103,124,77,154,164,37,115,13,227,228,10,9,225,73
],[
242,72,137,110,113,64,125,54,109,146,243,211,223,165,194,139,132,142,188,187
],[
214,52,63,28,58,177,7,69,123,251,70,113,119,195,247,131,24,157,111,71
],[
134,98,53,251,155,210,19,14,152,126,109,39,22,230,210,105,63,222,209,246
],[
61,54,14,177,243,153,149,73,235,182,109,115,144,158,113,118,158,109,91,237
],[
214,45,34,200,246,247,134,149,232,91,232,254,58,3,96,146,206,146,10,200
],[
211,210,160,64,243,15,78,77,206,190,193,177,168,99,130,167,94,177,130,39
],[
159,242,246,101,88,169,100,155,112,118,254,8,182,59,48,56,24,125,117,135
],[
21,13,110,225,117,231,53,203,55,90,239,167,203,105,160,51,129,114,68,84
]
]