aLevelData = [
[
10,2,24,214,156,187,185,158,124,175,99,81,156,236,23,49,62,122,78,45
],[
2,2,170,84,163,192,126,111,204,23,70,249,206,114,76,222,113,204,178,145
],[
2,2,242,190,189,9,249,161,116,10,202,243,106,165,191,251,216,2,246,176
],[
9,2,238,93,71,216,107,79,121,109,108,79,181,68,129,120,58,241,6,141
],[
3,3,83,229,177,58,134,217,103,156,15,112,84,4,141,23,58,248,250,48
],[
2,2,9,123,224,113,177,143,202,134,52,247,249,254,255,65,89,100,122,4
],[
2,2,180,172,222,103,36,210,71,226,206,189,10,73,205,105,72,6,109,69
],[
2,2,195,165,154,218,241,151,152,174,79,47,244,104,248,241,186,52,118,12
],[
2,2,232,105,216,37,35,106,4,86,169,202,79,119,135,179,75,156,12,136
],[
2,2,224,222,125,201,159,95,10,55,82,136,1,57,216,149,66,127,48,84
],[
2,2,243,229,211,41,116,154,71,86,149,129,241,121,7,215,43,86,17,23
],[
2,2,150,215,132,26,177,81,241,131,171,9,25,90,118,247,165,247,29,202
],[
2,2,24,34,87,44,1,120,92,70,117,17,247,135,188,95,221,161,75,89
],[
2,2,61,213,242,217,152,113,87,67,211,151,163,104,139,63,123,170,168,127
],[
50,96,53,11,61,124,111,248,231,107,27,197,70,60,29,155,109,5,71,212
],[
227,130,111,187,84,0,196,146,135,121,98,218,144,1,35,206,71,96,184,49
],[
248,1,249,73,92,11,122,44,200,205,95,58,165,95,113,235,32,134,113,203
],[
34,217,172,194,131,34,207,153,123,7,253,186,89,234,31,55,119,13,123,14
],[
109,250,137,172,133,34,1,175,111,196,57,240,54,16,174,193,115,141,224,115
],[
193,184,100,28,112,238,52,150,126,139,73,203,194,84,108,48,107,18,73,144
]
]