aLevelData = [
[
2,2,2,196,19,32,124,142,217,159,204,124,183,84,1,30,71,128,43,217
],[
2,2,2,173,199,42,152,121,136,185,191,207,106,171,97,197,55,115,178,12
],[
2,2,3,238,234,191,211,19,77,92,232,74,133,94,32,36,172,11,250,57
],[
2,2,3,204,207,127,119,234,49,108,185,67,4,147,155,213,226,127,141,33
],[
2,2,3,214,87,39,48,89,4,189,212,128,150,50,48,115,228,17,122,33
],[
2,2,3,115,217,0,50,154,153,105,61,227,189,62,60,179,40,169,61,46
],[
2,2,3,131,124,90,85,212,116,234,113,82,192,249,181,120,189,246,31,88
],[
2,2,3,4,172,159,50,166,116,123,69,182,168,242,229,8,90,32,206,57
],[
2,2,3,70,33,184,239,6,121,43,98,133,179,149,28,182,73,154,253,134
],[
2,2,3,196,171,129,15,36,218,70,14,130,236,200,151,244,176,111,7,177
],[
2,2,3,144,205,59,118,102,32,255,40,145,31,201,186,71,243,168,81,44
],[
1,2,3,131,119,166,36,244,86,172,102,112,91,116,211,39,132,77,133,148
],[
2,2,3,240,47,170,2,79,90,147,78,152,58,8,238,250,142,223,50,20
],[
2,2,3,201,205,202,104,184,123,137,13,102,220,105,165,61,191,206,143,109
],[
6,5,3,160,15,94,146,196,50,137,145,133,247,99,194,234,25,78,85,122
],[
5,2,3,208,44,238,82,154,23,147,118,59,82,200,101,2,127,248,240,79
],[
5,3,2,18,23,75,82,5,134,101,21,206,55,117,189,142,17,213,13,139
],[
150,20,43,224,195,71,167,115,55,159,185,40,152,65,202,84,51,81,54,117
],[
226,80,81,32,51,169,168,58,198,134,137,107,247,232,197,208,189,247,180,240
],[
210,151,122,242,21,59,137,13,44,254,103,63,109,240,178,66,255,173,97,188
]
]