aLevelData = [
[
2,2,2,2,2,2,2,2,2,2,2,2,2,105,39,234,215,226,253,228
],[
2,2,2,2,2,2,2,2,3,3,3,3,3,189,248,163,125,146,218,27
],[
2,2,3,2,3,2,2,2,2,3,2,2,2,1,128,218,251,252,249,115
],[
2,2,3,2,3,2,2,2,2,2,3,2,2,102,89,75,138,60,199,116
],[
2,2,3,2,3,2,2,2,2,2,2,3,2,244,142,97,55,57,85,141
],[
2,2,3,2,2,2,2,2,2,2,2,2,3,111,151,99,36,164,74,153
],[
2,2,3,2,3,3,3,3,3,3,3,3,3,212,220,11,91,195,179,215
],[
2,2,3,2,2,2,2,2,2,2,2,2,2,65,117,174,241,15,240,205
],[
2,2,3,2,3,3,3,3,3,3,3,3,3,42,232,30,95,96,190,114
],[
2,2,3,2,2,2,2,2,2,2,2,2,2,26,69,13,206,107,97,201
],[
2,2,3,3,3,3,3,3,3,3,3,3,3,165,11,91,149,93,211,116
],[
1,2,3,2,2,2,2,2,2,2,2,2,2,53,247,209,84,70,241,155
],[
2,2,3,5,5,2,2,2,5,5,5,5,5,9,44,107,227,77,77,138
],[
2,2,3,2,2,5,5,5,5,5,2,2,2,76,7,125,26,124,21,184
],[
6,5,3,3,3,2,5,2,2,2,2,2,2,119,115,73,23,173,27,177
],[
5,2,3,2,2,3,2,5,2,2,2,2,2,253,222,32,28,145,228,1
],[
217,114,56,104,194,166,18,183,122,211,210,227,242,177,159,133,50,191,78,46
],[
86,53,133,251,214,58,32,106,11,88,211,108,239,45,17,188,37,99,45,110
],[
57,226,192,203,40,67,74,92,35,136,28,69,144,11,117,213,82,181,235,90
],[
74,112,12,58,29,223,70,63,56,76,4,51,18,226,26,173,177,28,99,42
]
]