aLevelData = [
[
2,2,2,2,2,2,2,2,2,2,2,2,2,2,2,2,255,201,56,54
],[
2,2,13,5,5,2,2,12,5,5,2,3,2,5,5,2,71,36,210,166
],[
2,2,2,5,5,2,2,2,5,5,2,3,2,5,5,2,125,47,229,17
],[
2,2,2,2,2,2,2,2,2,2,2,3,2,2,2,2,149,35,152,145
],[
2,2,2,2,2,2,2,2,2,2,2,3,3,3,3,3,139,28,99,75
],[
2,2,2,2,2,2,2,2,2,2,2,2,2,2,6,2,70,111,26,90
],[
2,2,2,2,2,2,2,2,2,2,2,2,2,3,3,3,194,61,39,10
],[
2,2,2,2,2,2,2,2,2,2,2,2,2,2,2,2,110,72,22,71
],[
2,2,2,2,2,2,2,2,2,2,3,2,2,2,2,2,211,6,88,85
],[
2,2,2,2,2,2,2,2,2,3,3,2,3,2,2,2,119,244,64,193
],[
2,2,2,2,2,2,2,2,3,3,2,9,3,3,2,2,1,45,82,151
],[
2,2,2,2,2,2,2,2,3,2,2,2,3,3,2,2,157,59,189,213
],[
4,2,2,2,2,2,2,3,2,2,2,2,3,2,2,2,162,45,38,32
],[
2,2,2,2,2,3,3,2,2,2,2,3,3,2,2,2,115,233,167,182
],[
2,2,2,3,2,2,11,2,2,2,3,3,2,2,3,3,163,196,24,164
],[
2,2,2,3,2,3,2,2,2,3,3,2,2,2,3,2,92,80,141,57
],[
2,2,2,5,2,3,2,2,2,3,2,2,2,2,3,2,1,117,31,186
],[
3,3,3,3,2,3,2,2,2,3,3,2,2,2,3,3,18,196,240,87
],[
80,7,105,94,34,29,198,175,56,5,213,112,110,56,250,1,243,60,119,50
],[
170,118,234,180,208,64,23,206,224,59,232,81,179,230,178,206,236,112,186,6
]
]