aLevelData = [
[
4,2,2,2,2,2,2,2,2,240,91,144,66,46,145,98,174,130,17,177
],[
5,2,5,3,2,2,2,2,2,153,120,71,6,246,138,215,67,177,65,53
],[
2,5,5,3,3,3,3,3,3,228,230,157,112,132,82,183,78,163,7,165
],[
3,3,5,5,5,5,5,5,5,158,166,99,158,202,31,66,94,172,79,115
],[
2,3,5,5,5,5,5,5,5,204,162,234,105,219,229,25,51,174,22,197
],[
3,3,5,5,5,5,3,3,3,175,255,26,19,250,193,40,43,42,4,32
],[
3,5,5,5,5,5,3,2,2,62,64,26,31,199,88,248,80,17,35,222
],[
5,249,151,59,6,245,229,203,40,85,172,2,34,201,108,173,157,36,61,215
],[
138,95,193,233,184,225,87,22,166,253,145,246,150,189,233,113,226,222,175,223
],[
147,27,70,109,48,175,144,195,212,21,167,228,131,18,206,85,190,245,167,129
],[
85,30,166,92,125,189,197,71,34,220,121,52,127,160,229,10,235,203,78,75
],[
246,134,208,244,180,94,79,164,89,140,176,1,6,121,72,87,227,129,148,131
],[
110,247,43,16,19,106,242,159,252,39,143,140,42,255,32,206,197,75,44,31
],[
176,45,217,94,97,24,96,49,240,146,191,238,109,56,174,188,119,3,211,245
],[
10,203,57,207,153,9,255,60,93,225,77,14,236,96,140,95,13,2,215,48
],[
203,119,172,80,200,166,232,128,212,243,242,212,190,189,54,92,106,43,213,4
],[
36,41,154,185,52,173,49,205,179,63,147,157,157,184,197,113,39,74,194,163
],[
82,192,182,4,192,7,108,123,198,238,10,239,196,42,252,103,177,157,46,112
],[
250,216,126,192,141,222,113,24,48,42,36,111,24,244,134,76,183,177,197,116
],[
213,217,6,197,226,236,89,98,139,183,236,16,139,212,127,224,196,112,23,15
]
]