aLevelData = [
[
12,2,2,2,235,185,33,226,98,137,79,189,229,5,5,87,29,134,76,104
],[
2,2,2,2,120,15,37,188,29,120,30,124,37,204,34,175,8,239,149,0
],[
2,2,3,3,85,132,161,194,167,13,202,49,212,84,201,251,103,11,151,255
],[
11,2,3,2,81,175,200,84,219,178,26,141,223,216,78,59,56,226,54,180
],[
2,2,3,2,119,106,16,19,215,14,18,128,116,208,70,178,183,189,152,177
],[
2,2,3,2,21,205,46,225,249,11,247,60,254,245,135,223,98,38,34,200
],[
10,2,3,2,184,50,22,222,220,210,78,49,44,65,37,132,245,229,120,9
],[
2,2,3,2,44,50,255,107,95,204,221,17,234,235,117,162,110,4,128,196
],[
2,2,3,2,127,166,92,42,157,162,167,205,102,110,13,121,9,203,94,140
],[
9,2,3,2,254,166,228,251,245,60,243,149,12,130,193,140,68,196,120,49
],[
2,2,3,2,54,140,138,255,2,197,69,219,137,32,167,154,220,183,115,196
],[
2,2,3,2,243,241,132,151,163,165,98,79,202,130,19,165,205,174,52,150
],[
8,2,3,2,68,173,72,101,243,133,79,227,253,31,155,238,84,241,223,56
],[
2,2,3,2,116,218,137,74,81,77,81,200,141,178,18,246,239,9,217,123
],[
2,2,3,2,17,209,60,101,88,40,238,110,41,51,144,125,90,192,201,112
],[
6,2,3,2,231,42,152,25,231,125,233,134,190,219,103,134,147,31,146,104
],[
2,2,3,3,5,191,17,6,25,247,73,3,119,36,46,80,215,110,89,245
],[
2,2,2,2,182,169,92,14,77,125,82,19,195,197,186,93,162,54,133,230
],[
2,2,2,2,136,65,109,81,31,58,137,42,78,185,30,110,177,65,185,78
],[
2,2,2,2,71,31,122,48,107,149,179,247,6,56,178,132,2,151,218,124
]
]