aLevelData = [
[
5,5,5,5,5,2,2,2,2,2,2,2,2,2,2,2,2,2,2,73
],[
5,2,2,2,2,2,2,2,2,2,2,2,2,2,2,2,2,2,2,46
],[
5,2,5,3,3,3,3,3,3,3,2,2,3,3,3,3,3,3,2,147
],[
2,2,5,2,3,2,2,2,2,2,2,2,3,2,2,2,2,3,2,148
],[
2,2,3,2,3,2,2,2,2,2,2,2,3,2,2,2,2,3,3,178
],[
2,2,3,2,3,3,3,3,3,3,2,2,3,5,5,5,5,5,5,225
],[
4,2,3,2,2,2,2,2,2,3,2,2,3,2,2,2,2,2,2,234
],[
2,2,3,2,2,3,3,3,3,3,2,2,3,3,3,2,2,3,3,124
],[
2,2,2,2,2,3,2,2,2,2,2,2,2,2,3,2,2,3,2,112
],[
2,3,2,2,2,3,2,2,2,3,2,2,3,3,3,2,2,3,3,137
],[
147,235,45,116,170,84,33,74,81,40,137,168,187,157,84,11,132,174,31,240
],[
68,99,99,57,99,82,237,211,47,102,143,150,43,223,22,108,170,154,123,182
],[
157,147,94,235,170,168,175,130,126,160,175,19,99,107,23,185,21,171,150,186
],[
209,116,129,106,176,80,199,76,51,135,35,123,31,157,149,72,139,27,18,37
],[
55,147,123,194,31,222,204,117,80,168,150,223,251,47,175,205,200,71,39,92
],[
108,162,127,97,126,78,22,7,134,127,228,186,88,143,106,68,160,67,233,54
],[
189,80,211,138,211,29,127,134,27,203,32,228,126,115,248,47,99,174,201,112
],[
197,91,141,10,136,156,102,227,13,34,216,196,4,171,54,3,129,200,90,95
],[
82,228,153,43,145,130,247,175,117,198,150,203,109,55,117,221,112,195,87,229
],[
142,4,0,231,204,193,167,145,46,184,169,30,21,154,123,122,203,88,226,167
]
]