aLevelData = [
[
4,2,2,2,2,2,2,2,238,203,71,67,241,54,238,222,176,138,128,190
],[
5,2,5,3,2,2,2,2,145,163,60,181,109,8,92,164,242,194,154,239
],[
2,5,5,3,3,3,3,3,70,106,242,46,237,134,170,38,237,22,144,247
],[
3,3,5,5,5,5,5,5,48,105,131,150,41,53,52,126,187,231,46,163
],[
2,3,5,5,5,5,5,5,86,56,20,168,99,1,42,81,226,80,23,59
],[
3,3,5,5,5,5,3,3,81,187,234,203,208,244,90,100,132,158,82,221
],[
3,5,5,5,5,5,3,2,57,95,173,50,75,55,62,121,198,16,19,24
],[
3,5,5,3,3,3,3,8,204,150,250,54,55,72,69,111,128,207,203,204
],[
3,5,5,3,2,2,3,3,224,143,47,242,180,125,101,153,38,48,113,64
],[
3,5,5,3,2,2,2,2,10,58,114,31,6,184,224,94,246,40,18,132
],[
142,123,3,50,65,107,85,17,98,15,150,9,138,173,195,180,57,207,10,18
],[
192,153,212,126,94,89,3,224,169,96,120,37,47,17,217,236,94,55,145,130
],[
161,156,24,17,204,215,116,20,186,101,0,14,52,251,108,124,21,27,5,8
],[
172,230,54,255,98,49,79,5,157,218,134,8,228,92,60,114,67,162,129,163
],[
241,25,217,158,48,9,64,2,117,37,109,61,201,97,84,252,111,3,238,229
],[
199,253,60,137,114,122,138,148,183,183,241,71,37,20,31,41,122,107,91,249
],[
196,160,195,230,198,121,216,3,157,176,61,245,164,71,188,238,148,28,138,224
],[
240,189,204,234,160,125,89,23,219,200,194,71,75,179,144,109,108,215,204,251
],[
54,96,197,155,251,97,13,32,146,107,197,188,181,93,26,115,168,125,16,207
],[
27,200,127,214,82,135,90,57,131,35,55,206,128,58,12,64,149,242,55,6
]
]