aLevelData = [
[
5,5,5,5,5,2,2,2,2,2,2,110,155,41,239,59,173,202,202,178
],[
107,93,225,55,192,248,135,32,179,78,49,95,132,119,42,97,248,239,136,54
],[
241,224,94,241,65,164,51,82,192,133,179,162,157,200,165,223,241,235,29,25
],[
154,42,243,28,70,72,115,79,206,139,86,220,198,9,242,17,82,34,173,7
],[
58,78,183,129,65,25,249,22,179,107,72,147,62,13,223,155,2,105,12,144
],[
235,145,41,183,63,131,206,150,115,172,69,161,67,170,62,22,2,86,196,38
],[
46,2,112,85,71,255,221,35,225,99,91,236,249,8,232,13,133,216,92,72
],[
78,72,227,106,2,35,176,42,133,137,240,85,137,55,253,40,94,9,213,253
],[
11,188,202,43,157,249,123,39,191,143,2,239,139,1,111,168,160,64,118,133
],[
117,185,100,236,237,146,87,212,43,49,175,114,167,255,192,20,129,107,201,77
],[
22,49,42,82,210,220,209,164,69,137,246,239,120,239,8,50,129,156,231,33
],[
85,129,83,200,222,177,165,112,77,102,188,198,178,69,59,58,201,227,242,166
],[
23,135,153,48,54,50,196,113,110,220,19,215,133,1,169,71,215,92,224,7
],[
169,243,59,220,186,83,157,111,27,29,184,245,65,193,199,15,89,138,128,239
],[
219,219,68,189,98,184,154,57,187,135,219,161,59,24,47,213,86,228,183,185
],[
110,146,12,219,233,192,233,86,134,255,36,246,241,31,227,156,149,174,12,228
],[
177,187,253,6,174,223,126,250,176,127,243,224,107,75,215,158,56,10,101,203
],[
103,154,152,204,215,50,86,60,197,235,232,146,226,127,174,253,168,80,17,147
],[
237,172,184,171,185,79,255,135,85,41,165,55,164,98,196,185,182,156,7,101
],[
155,120,23,137,117,91,86,80,209,114,208,232,56,243,111,227,0,166,110,222
]
]