aLevelData = [
[
2,2,3,3,3,3,3,3,122,82,4,176,20,163,241,136,238,37,119,12
],[
2,2,2,2,2,2,2,2,95,37,196,135,11,3,193,9,90,218,47,34
],[
3,2,3,3,3,3,3,3,41,99,245,234,191,23,184,68,2,148,173,100
],[
2,2,2,2,2,2,2,2,234,66,171,143,55,54,133,34,95,87,150,214
],[
3,2,3,3,3,3,3,3,203,191,157,66,66,100,204,162,166,247,27,214
],[
2,2,3,2,2,2,2,2,222,12,226,174,19,124,167,100,31,7,52,106
],[
66,62,237,102,23,161,97,124,199,4,31,203,125,55,203,58,26,229,113,116
],[
41,189,24,49,21,208,155,184,153,58,180,161,121,5,90,224,112,74,77,255
],[
105,153,239,171,242,155,85,114,237,246,158,203,136,113,131,87,112,89,48,102
],[
66,35,82,189,67,82,114,151,80,156,129,233,24,72,180,234,136,218,146,211
],[
135,242,75,227,228,114,75,167,140,223,15,120,1,10,55,69,7,239,221,147
],[
161,221,38,193,59,215,22,145,41,59,169,228,80,161,31,197,35,6,151,169
],[
210,42,223,245,189,54,139,193,47,162,68,220,73,86,99,16,60,15,191,167
],[
188,5,194,45,177,203,195,120,47,118,143,230,168,1,73,230,96,240,117,186
],[
34,52,79,123,50,79,97,93,130,184,84,52,40,129,7,55,16,55,222,4
],[
238,10,93,229,119,45,245,82,209,128,29,183,72,109,165,119,66,15,71,48
],[
117,154,128,65,87,247,158,137,214,174,25,114,74,9,38,46,168,119,138,65
],[
248,46,172,64,9,20,239,216,99,224,62,17,125,124,233,212,48,174,175,172
],[
108,248,28,201,42,189,21,74,161,164,177,188,189,66,74,221,205,243,212,166
],[
124,8,110,137,2,40,55,248,155,240,99,38,56,221,142,17,117,108,79,192
]
]