aLevelData = [
[
5,5,36,68,150,253,100,73,121,190,32,92,176,14,145,31,98,69,68,62
],[
5,2,156,13,203,83,164,102,178,7,138,237,181,122,255,93,47,230,106,86
],[
5,2,214,127,57,93,166,157,117,37,27,28,154,12,163,3,165,233,83,101
],[
2,2,110,5,217,133,56,103,178,61,135,85,157,161,50,23,79,223,184,254
],[
2,2,104,106,215,165,166,87,91,119,88,7,53,113,22,6,204,41,176,51
],[
2,2,152,16,100,33,236,244,84,190,19,201,55,50,159,168,78,10,254,24
],[
4,2,153,150,78,141,76,143,114,46,125,253,102,219,31,88,207,111,51,238
],[
2,2,215,66,61,132,55,243,245,64,149,100,64,199,17,5,94,162,27,86
],[
2,2,101,230,135,167,238,20,227,34,14,62,8,12,136,107,239,72,64,61
],[
2,3,198,29,243,209,67,57,38,231,57,245,92,67,105,218,140,83,154,100
],[
210,17,236,7,101,43,105,112,201,97,221,13,70,47,231,207,152,173,81,47
],[
232,179,157,111,251,64,224,34,170,29,212,238,146,189,40,145,12,104,26,34
],[
96,153,72,153,53,164,195,146,76,155,102,78,110,115,102,251,163,99,41,53
],[
165,141,92,204,148,224,64,200,235,61,68,170,179,216,217,245,247,226,130,237
],[
119,101,42,159,160,111,187,33,188,114,236,27,103,235,91,134,66,66,219,180
],[
235,241,15,145,44,233,56,40,114,49,75,105,129,209,71,41,103,238,197,106
],[
174,54,208,221,214,127,248,165,3,170,162,94,242,206,162,94,49,147,12,58
],[
144,219,70,140,211,168,98,244,169,58,171,93,226,119,126,130,220,144,92,176
],[
62,226,60,205,233,26,38,153,44,157,253,52,55,39,157,225,211,177,38,9
],[
80,153,150,131,190,253,158,18,96,103,174,47,93,176,83,9,185,30,194,203
]
]