aLevelData = [
[
2,2,2,2,2,2,50,109,138,185,201,47,234,226,175,160,116,241,188,2
],[
2,3,5,3,5,5,237,226,19,193,168,16,178,176,180,154,71,150,84,10
],[
2,3,2,3,2,2,69,233,175,57,56,217,201,109,86,145,178,197,86,185
],[
2,2,2,2,2,2,254,215,133,63,116,151,22,87,11,123,185,192,18,220
],[
2,3,5,3,5,5,112,73,174,160,158,149,137,22,97,27,201,33,34,112
],[
2,3,5,3,5,5,63,153,107,201,225,238,248,188,123,14,16,70,161,137
],[
2,5,5,5,5,5,22,18,232,243,91,248,86,139,54,197,22,25,87,58
],[
2,3,5,3,5,5,112,29,88,87,249,37,149,217,7,127,62,1,104,16
],[
2,3,5,3,5,5,170,151,84,132,238,47,159,168,175,171,51,19,52,1
],[
2,5,5,5,5,5,190,12,191,62,168,168,30,203,72,51,125,239,87,209
],[
2,3,5,3,2,2,126,150,165,101,140,81,10,178,108,157,160,193,20,104
],[
5,3,5,3,2,2,47,130,193,209,233,181,68,48,88,11,156,86,148,137
],[
5,5,5,5,5,5,202,22,185,46,225,4,152,213,93,124,173,93,181,230
],[
5,3,5,3,5,5,82,6,52,57,49,30,4,190,255,222,140,23,104,143
],[
5,3,5,3,5,5,252,127,69,240,37,83,21,220,143,210,171,40,197,33
],[
36,203,244,145,28,65,180,37,34,49,38,79,104,77,63,251,191,121,99,206
],[
195,48,54,176,83,36,175,136,69,37,110,70,87,68,79,39,104,56,63,52
],[
232,1,78,13,141,203,6,228,71,20,251,204,119,17,164,52,92,78,105,174
],[
205,150,253,246,46,18,238,47,157,180,123,111,108,215,165,126,212,31,137,219
],[
231,167,236,0,199,91,24,231,22,162,231,205,173,65,29,54,145,124,250,49
]
]