aLevelData = [
[
2,2,210,89,140,205,240,132,191,89,30,194,235,102,130,54,245,85,202,97
],[
2,2,169,214,180,153,89,253,212,183,199,153,146,17,70,193,114,168,27,175
],[
5,3,152,162,41,210,139,250,206,30,57,118,8,167,59,217,220,110,91,90
],[
2,3,248,122,83,86,151,43,216,66,165,204,215,227,35,103,255,193,206,221
],[
2,3,127,217,251,53,17,146,198,53,55,242,107,47,196,18,244,30,159,207
],[
2,3,21,242,196,195,84,39,139,116,108,156,45,202,244,163,132,199,60,84
],[
2,3,18,114,120,40,69,20,32,195,249,167,150,16,63,140,10,147,93,124
],[
2,3,155,251,22,193,190,247,43,166,228,75,33,44,87,35,69,254,101,167
],[
2,3,238,167,193,207,2,3,38,121,187,243,61,185,171,85,193,112,254,52
],[
225,32,0,59,230,254,223,112,21,73,177,31,215,219,184,19,23,254,229,12
],[
236,128,156,110,120,10,183,55,16,173,205,51,156,190,180,115,65,228,68,251
],[
62,111,94,187,20,235,45,193,234,245,172,172,47,78,105,100,129,46,136,8
],[
206,219,10,40,185,121,80,53,63,36,218,53,154,60,85,187,101,0,213,23
],[
2,95,95,202,57,10,170,61,33,206,38,178,68,33,62,122,254,251,218,104
],[
38,231,41,135,240,89,157,8,18,66,55,126,38,226,4,78,80,221,232,96
],[
32,146,154,27,186,168,240,145,52,233,93,246,63,84,184,87,10,109,62,136
],[
99,216,219,95,32,38,165,31,189,239,169,55,70,33,235,45,119,151,168,213
],[
35,238,222,198,210,148,15,14,174,33,65,37,160,235,73,32,182,212,73,39
],[
200,103,120,41,91,36,33,206,197,23,239,174,146,176,103,192,39,206,182,21
],[
165,29,173,198,16,162,10,43,177,148,249,77,184,110,218,158,38,66,69,232
]
]