aLevelData = [
[
5,5,3,5,5,5,5,5,5,5,3,83,223,240,148,79,148,20,156,28
],[
4,2,3,5,5,5,5,5,5,5,3,193,21,61,141,186,136,10,242,95
],[
2,2,3,2,3,3,3,3,3,2,3,94,128,236,157,90,162,128,56,201
],[
5,2,2,2,3,2,2,2,2,2,5,224,107,199,109,61,181,0,186,177
],[
2,2,2,3,2,2,2,2,2,2,5,137,53,69,204,68,31,121,157,204
],[
2,2,2,3,2,2,5,3,3,2,3,219,139,210,35,50,177,32,60,29
],[
2,2,2,2,2,2,5,5,3,2,2,143,230,13,136,242,13,229,87,193
],[
5,2,2,2,2,2,5,5,3,2,2,50,0,167,49,7,89,86,55,246
],[
2,2,5,5,3,2,5,5,3,2,3,191,197,67,8,43,220,43,6,81
],[
79,101,222,117,32,122,71,128,102,183,168,83,76,38,54,91,92,189,93,101
],[
254,212,98,180,59,221,70,81,199,79,237,163,63,227,128,63,175,3,15,1
],[
87,127,123,92,175,131,147,238,168,198,125,88,53,3,88,76,10,173,31,232
],[
163,223,208,66,137,146,206,68,209,18,132,186,229,179,76,169,135,191,143,226
],[
18,180,45,216,3,172,31,175,185,29,91,149,121,194,247,85,181,217,146,41
],[
142,143,240,208,151,185,228,225,220,196,115,95,35,239,54,141,113,183,0,4
],[
208,147,193,2,80,226,170,5,76,34,146,153,238,98,153,110,245,250,11,173
],[
182,121,135,140,97,223,96,33,134,13,67,115,216,121,26,215,48,38,49,122
],[
213,212,151,58,250,116,200,186,136,222,136,181,30,198,18,146,86,236,114,57
],[
75,148,48,38,88,54,46,187,34,118,211,219,216,86,105,180,185,171,196,220
],[
215,206,37,160,27,147,94,153,138,127,54,128,198,53,14,66,216,50,197,87
]
]