aLevelData = [
[
4,2,5,51,43,187,211,164,147,149,78,84,97,206,253,129,109,46,143,237
],[
2,2,2,3,32,221,223,220,202,122,106,77,126,140,241,191,81,219,235,95
],[
2,2,2,9,40,228,23,61,192,196,188,183,81,84,137,29,251,254,204,209
],[
3,3,3,170,213,223,21,164,213,90,115,94,107,135,92,148,56,22,15,152
],[
2,2,3,18,18,188,235,75,20,233,10,54,183,22,138,232,75,156,103,60
],[
13,2,3,206,219,154,26,24,148,233,248,85,148,3,160,184,147,204,52,110
],[
2,5,3,91,246,112,209,45,209,48,223,96,100,50,234,75,188,28,144,101
],[
2,12,3,132,193,238,171,214,160,17,66,81,173,173,94,108,85,18,98,9
],[
5,2,3,188,91,73,78,73,233,68,176,100,16,164,80,126,15,251,139,82
],[
11,2,3,70,126,204,107,163,174,165,231,94,56,31,122,230,25,78,182,27
],[
2,5,3,5,40,137,189,10,151,7,36,113,204,105,50,229,215,86,135,215
],[
2,10,3,116,98,243,32,40,213,49,232,141,173,210,199,234,230,119,43,7
],[
5,2,2,248,67,250,64,162,144,120,215,230,225,106,143,85,24,124,118,140
],[
234,224,2,255,143,56,95,245,190,182,8,212,216,129,149,159,100,91,211,189
],[
187,130,26,252,4,211,219,213,99,53,121,242,110,53,90,237,225,238,61,91
],[
146,44,206,9,167,209,119,133,6,119,122,224,13,86,61,179,132,104,228,96
],[
207,204,37,154,104,105,88,40,141,211,206,229,54,114,100,12,74,225,88,178
],[
18,148,91,148,238,190,231,19,71,113,210,125,196,7,36,142,193,194,38,55
],[
253,175,187,157,146,208,243,101,43,121,222,47,113,251,158,96,198,128,192,37
],[
54,54,205,181,170,176,27,214,95,137,233,162,151,74,171,139,143,141,163,157
]
]