aLevelData = [
[
2,2,3,3,3,3,3,3,3,3,3,3,3,3,3,3,2,3,2,2
],[
2,2,2,2,2,2,2,2,2,2,2,2,2,2,2,2,2,2,3,3
],[
3,2,3,3,3,3,3,3,3,3,3,2,3,3,3,2,2,2,2,4
],[
2,2,2,2,2,2,2,2,2,2,2,2,2,2,3,2,2,2,2,2
],[
3,2,3,3,3,3,3,3,3,3,3,3,3,2,3,2,2,3,3,2
],[
203,59,116,160,68,211,226,239,202,38,127,154,130,18,187,33,124,186,67,79
],[
230,227,210,190,127,158,74,157,79,40,3,177,150,14,99,154,2,148,175,88
],[
36,88,32,13,37,51,58,4,181,96,89,243,69,224,141,125,118,28,167,251
],[
209,205,148,124,184,25,234,10,156,254,193,48,113,244,196,185,95,206,136,185
],[
187,226,28,210,53,105,225,176,83,41,155,214,30,81,201,157,27,164,50,121
],[
124,217,193,127,152,66,146,36,153,173,77,72,116,136,179,115,31,72,118,94
],[
254,11,78,181,158,123,73,27,165,246,99,111,9,237,86,77,129,138,179,216
],[
57,150,50,183,202,153,70,94,105,67,245,143,94,10,231,32,185,21,189,254
],[
64,89,164,114,171,2,41,163,20,20,79,93,169,82,222,16,164,95,255,28
],[
125,35,6,75,93,112,143,159,215,229,204,79,211,19,29,12,202,223,225,136
],[
57,39,141,57,79,169,251,91,233,32,4,52,193,175,80,155,226,131,109,187
],[
96,181,31,21,69,109,247,196,206,77,39,5,216,13,149,246,149,98,46,158
],[
131,37,125,46,159,177,124,134,214,141,170,251,188,75,93,88,128,175,90,34
],[
32,20,163,33,217,12,144,27,226,71,33,227,89,182,147,147,126,239,49,21
],[
31,212,109,232,83,111,47,32,107,33,109,175,38,252,252,228,36,109,166,49
]
]