aLevelData = [
[
5,5,5,5,5,2,2,2,2,2,2,2,2,2,2,2,2,2,2,2
],[
5,2,2,2,2,2,2,2,2,2,2,2,2,2,2,2,2,2,2,2
],[
5,2,5,3,3,3,3,3,3,3,2,2,3,3,3,3,3,3,2,2
],[
2,2,5,2,3,2,2,2,2,2,2,2,3,2,2,2,2,3,2,2
],[
2,2,3,2,3,2,2,2,2,2,2,2,3,2,2,2,2,3,3,3
],[
2,2,3,2,3,3,3,3,3,3,2,2,3,5,5,5,5,5,5,5
],[
61,52,57,90,155,90,74,224,27,225,221,243,196,136,66,238,142,52,98,109
],[
188,237,173,105,108,41,83,165,109,77,183,73,80,113,33,205,194,99,178,25
],[
25,239,158,235,44,94,149,120,104,61,130,86,32,96,120,153,37,38,233,61
],[
151,253,26,196,250,41,211,31,140,194,91,210,214,252,164,84,130,172,194,180
],[
108,7,161,130,252,172,248,237,178,229,121,41,2,41,75,20,99,230,185,24
],[
163,126,44,83,125,143,86,245,109,120,177,234,195,25,40,186,247,218,19,173
],[
60,238,105,50,87,217,49,129,178,47,58,128,172,159,12,227,52,49,30,152
],[
150,204,74,98,148,251,125,196,185,240,179,32,234,202,35,32,62,19,182,85
],[
16,141,190,30,82,46,229,204,35,105,99,3,164,175,117,99,8,54,10,104
],[
235,249,191,143,229,0,13,187,94,225,193,214,164,135,173,187,58,50,158,84
],[
116,191,142,255,64,42,26,55,71,81,54,112,53,250,31,66,84,24,145,202
],[
96,74,59,78,151,165,112,31,15,179,31,196,76,187,5,84,18,67,33,36
],[
120,212,104,162,62,253,187,129,96,154,22,23,235,87,10,3,16,111,109,18
],[
119,186,80,100,214,230,49,202,193,4,114,115,196,71,10,200,175,9,123,148
]
]