aLevelData = [
[
2,2,2,2,5,5,2,2,2,2,2,3,15,115,89,96,80,229,171,186
],[
2,2,2,4,2,2,2,2,2,2,2,153,69,20,28,214,166,244,189,116
],[
5,3,3,3,5,5,3,3,3,3,3,137,78,223,187,235,194,247,94,131
],[
2,3,2,2,2,2,2,2,2,3,2,187,14,80,69,233,103,218,42,242
],[
2,3,2,2,2,2,2,2,2,3,2,98,235,51,100,160,175,172,239,104
],[
2,3,2,2,3,2,2,2,2,3,2,98,174,209,74,103,231,145,2,148
],[
2,3,2,2,3,2,2,2,2,3,2,157,240,159,209,241,29,228,225,97
],[
2,3,2,2,3,5,5,3,3,3,3,40,238,127,145,185,23,173,75,2
],[
2,3,3,2,3,2,2,3,2,2,2,27,73,196,242,121,225,33,171,28
],[
2,2,3,2,3,2,2,3,2,1,2,200,57,55,59,105,157,118,126,220
],[
2,2,3,2,3,2,2,3,2,2,2,214,91,98,183,237,88,222,39,49
],[
23,71,63,52,107,113,143,23,134,23,249,7,108,124,192,8,168,83,226,241
],[
61,220,168,184,223,81,123,240,99,128,249,144,117,185,72,246,137,234,170,44
],[
20,9,82,105,251,178,119,219,75,18,166,163,44,3,92,34,16,120,212,115
],[
48,28,30,56,57,54,113,154,66,208,194,139,2,24,149,78,64,6,20,58
],[
138,63,94,187,42,58,33,153,86,161,107,125,167,250,189,177,205,134,98,39
],[
128,105,254,189,185,12,106,191,35,192,191,173,204,164,177,63,33,200,31,167
],[
25,146,231,22,176,97,255,129,151,113,194,165,42,255,135,73,162,173,120,195
],[
140,39,162,189,122,7,72,57,248,246,125,211,193,20,242,70,51,155,12,50
],[
1,191,57,29,40,216,133,183,36,194,104,98,99,132,226,241,250,49,202,176
]
]