aLevelData = [
[
4,2,5,5,2,2,2,68,243,210,28,125,210,218,92,249,226,85,35,51
],[
2,2,2,2,2,2,5,202,35,107,138,117,81,149,46,101,40,90,64,74
],[
2,2,2,2,2,2,3,106,4,53,211,216,222,124,196,247,233,96,73,20
],[
208,47,137,134,30,156,127,51,175,98,5,86,100,42,50,127,27,175,230,219
],[
223,32,163,181,91,198,159,61,149,230,23,136,217,233,229,217,242,186,85,31
],[
161,112,53,190,71,45,43,146,229,69,76,49,70,163,233,113,123,105,172,43
],[
136,215,228,62,93,110,30,214,8,85,245,238,40,251,43,19,165,254,248,107
],[
158,76,161,247,163,136,77,21,37,175,21,73,42,251,90,60,69,7,91,5
],[
198,53,6,168,46,77,15,220,230,102,64,18,48,10,16,178,93,149,118,168
],[
65,222,255,31,228,25,31,140,122,252,196,239,149,33,49,86,154,172,10,162
],[
113,45,171,141,129,200,190,236,220,147,13,50,182,63,148,54,28,251,219,54
],[
227,149,131,27,222,226,30,254,84,97,68,236,176,27,227,230,123,205,214,44
],[
136,73,185,188,110,26,252,21,59,103,55,64,103,26,189,17,7,64,116,171
],[
67,179,228,66,10,247,141,37,5,99,126,251,201,129,35,76,80,183,95,68
],[
170,38,218,180,240,210,157,90,122,3,220,98,81,236,18,44,231,139,84,80
],[
6,208,222,224,7,1,243,237,68,93,228,76,208,0,110,153,101,6,72,125
],[
157,243,253,45,101,83,248,51,175,157,221,113,104,93,32,99,170,146,208,164
],[
50,85,179,180,20,188,152,248,173,254,233,2,218,216,128,19,103,47,187,222
],[
203,246,211,143,18,82,105,12,26,252,98,123,2,232,245,4,224,36,2,216
],[
178,2,166,114,152,121,12,29,64,201,134,182,161,94,220,179,236,247,228,100
]
]