aLevelData = [
[
2,240,14,229,126,68,110,238,36,80,149,222,108,118,104,209,141,96,254,84
],[
2,115,159,177,40,109,146,117,67,38,138,105,24,214,43,172,24,185,22,114
],[
2,121,193,197,87,54,136,181,243,87,136,203,174,114,142,241,213,114,108,0
],[
2,238,151,238,226,73,190,16,248,216,227,110,185,64,228,252,156,48,135,247
],[
56,242,191,28,170,64,43,23,56,88,224,62,52,83,104,127,34,178,10,151
],[
29,58,76,133,118,2,183,63,159,202,218,163,71,142,146,176,199,91,136,246
],[
189,98,250,75,246,75,191,192,146,203,133,212,98,121,94,231,149,221,123,241
],[
148,202,54,115,42,238,86,174,232,168,143,20,200,25,73,252,16,126,163,153
],[
121,189,182,45,145,61,30,122,94,251,183,121,68,219,164,79,40,60,150,125
],[
214,206,74,87,160,168,84,183,72,149,28,242,33,175,38,11,112,48,150,39
],[
24,132,243,65,119,163,43,31,139,157,215,133,89,118,193,168,143,53,163,229
],[
104,56,50,179,208,202,91,215,201,248,205,215,13,160,183,176,244,202,211,203
],[
153,59,163,46,56,72,251,240,219,233,191,239,54,14,238,197,207,54,223,247
],[
98,61,203,112,131,117,140,46,133,249,164,60,155,62,129,224,61,235,0,21
],[
205,235,47,59,123,192,87,14,102,26,58,213,3,168,153,219,195,46,249,35
],[
240,216,167,88,216,206,250,3,46,8,216,1,173,100,123,51,254,245,117,119
],[
220,158,242,215,118,224,62,1,21,241,135,247,254,14,227,8,154,17,149,255
],[
212,70,140,154,195,123,44,62,137,86,81,232,123,236,145,103,130,142,194,201
],[
192,230,188,19,119,68,96,53,39,50,218,60,247,78,34,202,86,89,201,195
],[
226,139,242,74,137,41,159,236,238,90,46,26,14,55,35,221,35,33,39,197
]
]