aLevelData = [
[
2,2,2,2,5,5,2,2,2,2,2,2,2,2,2,2,2,2,190,142
],[
136,133,62,183,78,174,148,131,191,36,27,116,160,164,110,67,23,209,114,213
],[
201,203,151,106,63,4,90,24,142,79,15,120,55,58,221,159,76,158,10,79
],[
212,116,120,111,113,234,112,185,64,183,159,179,1,171,94,224,120,138,55,55
],[
18,26,164,212,204,123,25,238,81,183,69,9,98,154,150,108,123,196,251,214
],[
180,252,237,109,229,199,176,247,13,57,214,76,245,12,6,11,16,239,251,141
],[
166,32,207,23,49,61,122,84,8,88,150,2,58,73,101,235,189,72,20,23
],[
200,187,65,64,125,76,188,134,203,63,138,100,147,2,48,227,9,6,46,13
],[
94,206,201,165,156,70,13,21,209,85,19,168,111,181,128,249,243,3,78,172
],[
197,18,207,91,95,133,238,211,178,157,185,129,197,79,28,39,160,154,239,211
],[
104,23,52,18,203,210,153,97,159,88,69,228,197,17,208,91,84,208,147,81
],[
243,169,35,150,135,3,24,240,15,237,19,14,203,182,255,189,164,183,150,95
],[
200,116,39,152,149,228,151,74,184,12,167,196,150,211,116,54,235,17,68,104
],[
176,233,127,172,67,89,252,18,194,15,126,218,183,126,127,47,251,50,44,18
],[
212,96,176,148,97,194,181,72,56,161,40,248,77,52,61,151,22,40,180,119
],[
236,128,90,188,181,159,210,17,192,163,149,153,240,245,56,40,29,30,238,180
],[
183,221,77,6,172,118,85,181,140,76,174,85,236,178,49,236,8,255,170,165
],[
172,224,220,201,84,243,198,234,146,145,37,98,176,235,58,252,150,88,205,240
],[
239,237,114,21,136,79,11,82,248,197,142,85,134,145,9,136,71,129,227,65
],[
135,193,100,58,106,243,119,64,211,129,175,47,133,50,137,29,137,252,241,214
]
]