aLevelData = [
[
2,2,2,2,2,2,2,2,2,2,2,2,2,2,2,2,2,2,173,41
],[
2,2,13,5,5,2,2,12,5,5,2,3,2,5,5,2,2,2,123,98
],[
2,2,2,5,5,2,2,2,5,5,2,3,2,5,5,2,2,2,135,61
],[
2,2,2,2,2,2,2,2,2,2,2,3,2,2,2,2,2,2,154,56
],[
2,2,2,2,2,2,2,2,2,2,2,3,3,3,3,3,3,3,173,18
],[
2,2,2,2,2,2,2,2,2,2,2,2,2,2,6,2,2,2,132,123
],[
2,2,2,2,2,2,2,2,2,2,2,2,2,3,3,3,2,3,38,35
],[
2,2,2,2,2,2,2,2,2,2,2,2,2,2,2,2,2,2,29,140
],[
157,255,8,149,101,62,199,29,186,185,36,217,74,251,208,197,244,242,75,116
],[
207,234,3,164,110,189,192,22,98,67,63,157,1,16,29,116,102,95,248,212
],[
185,73,208,198,177,59,179,55,86,166,153,74,12,248,141,242,205,204,13,191
],[
182,93,180,248,197,65,22,235,225,84,236,129,26,242,113,21,51,105,11,134
],[
93,173,46,139,70,78,125,71,82,168,51,30,40,90,194,198,113,249,186,161
],[
220,5,235,74,102,27,206,110,216,109,33,221,145,112,210,224,133,212,30,206
],[
134,185,250,218,195,32,178,47,142,159,208,63,98,90,63,87,36,46,176,119
],[
169,47,61,98,121,85,76,241,210,114,183,172,240,103,42,155,140,152,204,90
],[
163,157,33,108,120,59,47,209,220,146,223,219,173,151,167,61,157,197,102,101
],[
52,16,143,12,25,27,138,11,141,170,87,112,56,90,117,209,40,144,2,224
],[
23,175,35,64,236,142,166,151,133,41,230,229,180,150,239,20,135,59,227,208
],[
205,63,157,152,213,62,147,21,121,65,1,171,91,237,68,79,111,250,131,152
]
]