aLevelData = [
[
2,179,117,149,242,211,183,35,134,156,7,111,47,54,192,245,206,10,114,148
],[
2,18,28,228,135,155,154,89,150,95,181,19,141,77,175,22,238,49,53,46
],[
3,227,216,240,51,118,116,87,140,4,65,199,242,239,105,213,118,148,38,227
],[
2,198,125,38,241,172,215,51,182,215,38,19,239,222,55,173,248,130,86,110
],[
3,153,52,194,235,34,215,94,200,186,198,169,216,244,25,240,133,163,36,195
],[
2,115,240,65,165,96,169,208,7,79,220,123,120,229,165,191,22,19,68,167
],[
3,72,245,114,219,175,250,246,218,89,70,115,132,56,84,132,219,211,224,10
],[
2,10,60,4,197,167,66,161,34,53,231,0,84,237,21,185,166,190,140,212
],[
2,16,146,31,47,8,211,32,31,154,45,25,90,187,150,188,21,219,140,29
],[
2,105,185,158,31,251,123,46,44,220,254,117,42,174,107,200,170,9,11,25
],[
3,98,29,92,192,221,152,100,124,113,202,69,180,114,6,18,3,165,76,225
],[
8,244,247,38,33,10,111,208,46,4,98,155,35,94,230,147,240,27,136,96
],[
2,172,194,66,106,44,167,167,65,212,107,97,59,173,198,221,95,184,132,69
],[
2,129,130,206,175,175,249,171,148,204,126,199,131,123,59,114,22,63,183,235
],[
2,38,224,167,223,59,16,8,45,70,78,106,236,147,11,143,175,249,11,52
],[
9,7,84,15,47,74,53,177,186,147,215,143,15,10,85,171,53,102,27,18
],[
2,25,176,154,188,224,73,65,180,124,46,168,120,125,123,14,163,42,46,5
],[
201,209,46,108,163,91,140,158,108,35,8,233,138,9,215,66,113,194,163,54
],[
197,114,212,36,190,124,14,170,209,152,250,93,141,39,74,189,195,196,247,104
],[
233,28,205,141,192,255,42,164,53,183,3,92,133,152,39,213,165,216,200,16
]
]