aLevelData = [
[
2,2,2,2,2,2,2,2,2,2,2,2,2,191,242,194,199,70,80,18
],[
2,2,13,5,5,2,2,12,5,5,2,3,2,224,39,109,188,31,246,155
],[
154,131,6,245,49,22,138,240,236,33,250,51,168,156,185,169,117,232,244,212
],[
155,193,205,100,220,110,185,8,249,58,38,132,120,40,98,4,163,227,184,175
],[
212,244,220,128,240,55,137,81,50,144,104,57,42,218,52,24,5,32,28,112
],[
14,16,104,119,117,172,96,106,79,67,105,35,223,160,114,238,20,129,142,153
],[
82,75,226,202,118,251,194,149,20,96,23,78,2,136,4,156,27,120,201,207
],[
61,31,231,116,148,141,133,38,27,97,18,167,95,128,44,47,135,13,192,3
],[
145,149,115,74,222,137,65,28,241,242,100,221,116,96,120,201,123,35,220,207
],[
13,190,91,163,225,153,12,15,101,246,118,138,4,38,248,11,169,253,105,31
],[
127,131,251,58,252,236,101,74,29,203,65,146,243,130,178,182,94,253,75,18
],[
25,160,44,80,246,125,110,58,107,203,194,204,78,147,84,142,221,173,246,33
],[
1,235,122,23,212,148,95,8,96,20,177,225,170,241,42,128,239,1,157,126
],[
45,219,149,76,229,139,57,130,31,138,114,115,176,237,80,5,184,220,170,192
],[
110,70,5,36,32,211,183,64,117,26,77,128,246,21,41,199,204,209,112,189
],[
203,106,35,107,176,55,139,5,167,66,219,6,17,251,17,130,131,45,29,184
],[
18,48,69,232,206,97,200,100,140,207,193,232,233,55,79,46,139,51,243,190
],[
170,174,57,4,207,155,155,164,220,230,162,18,77,171,78,93,189,167,184,75
],[
172,236,246,171,127,216,63,231,200,71,79,217,200,8,13,223,51,142,108,50
],[
50,232,143,115,174,244,48,135,204,207,66,165,180,143,213,173,151,53,59,188
]
]