aLevelData = [
[
6,2,8,2,9,2,10,2,11,113,14,38,131,45,220,250,142,182,131,129
],[
2,2,2,2,2,2,2,2,12,204,205,16,161,85,182,10,214,135,233,86
],[
2,2,3,3,3,3,3,3,3,133,6,10,88,141,1,27,91,32,183,241
],[
2,2,3,2,2,2,2,2,2,51,209,58,228,32,237,115,203,246,15,103
],[
2,2,3,2,2,2,2,2,2,40,123,239,184,159,17,123,111,173,149,41
],[
2,2,3,2,3,3,3,3,3,248,150,134,139,110,159,106,36,26,126,109
],[
2,2,3,2,2,2,2,5,5,122,54,15,76,108,246,72,113,198,201,111
],[
96,19,220,138,81,178,223,24,30,44,13,254,96,197,102,196,213,81,63,1
],[
6,73,253,20,38,30,30,21,60,205,121,12,133,180,198,96,19,164,96,146
],[
187,55,74,42,46,100,112,242,102,80,48,99,68,103,25,93,119,172,243,27
],[
159,77,255,101,178,123,128,7,159,120,121,131,50,242,185,3,56,143,21,145
],[
227,201,245,138,112,252,18,80,6,189,125,64,226,110,228,228,177,15,17,105
],[
61,87,179,83,76,4,97,111,197,111,220,9,21,99,148,96,209,47,110,87
],[
157,250,197,109,76,87,175,239,73,26,129,109,53,105,149,106,209,22,74,87
],[
31,44,77,195,196,199,23,204,177,41,183,217,2,11,210,139,38,49,232,240
],[
65,65,216,250,206,213,167,48,137,207,125,164,140,237,240,37,184,157,133,181
],[
86,18,116,62,254,151,172,128,184,35,23,78,98,46,31,250,82,196,113,14
],[
60,216,1,60,85,218,78,152,184,140,231,5,9,17,46,237,89,70,92,54
],[
74,86,197,113,116,137,94,84,7,93,124,106,177,216,222,9,194,28,238,133
],[
142,60,68,163,18,78,108,80,219,194,233,147,36,242,121,193,63,249,155,240
]
]