aLevelData = [
[
6,2,2,2,2,2,2,2,2,2,2,2,2,2,2,2,2,2,87,35
],[
2,2,2,2,2,2,2,2,2,2,2,2,2,2,2,2,2,2,214,233
],[
2,2,2,2,2,2,2,2,2,2,2,2,2,2,2,2,2,2,222,96
],[
3,3,3,3,3,3,3,3,3,3,3,3,3,3,3,3,3,3,235,137
],[
2,2,2,2,2,2,2,2,2,2,2,2,2,2,2,2,2,2,159,129
],[
2,2,2,2,2,2,2,2,2,2,2,2,2,2,2,2,2,2,160,100
],[
2,2,2,2,2,3,2,2,3,2,2,3,2,2,2,3,2,2,96,129
],[
2,2,3,3,3,3,3,3,3,3,3,3,3,3,3,3,3,3,19,237
],[
2,2,2,2,2,2,2,2,2,2,2,2,2,2,2,2,2,2,95,249
],[
2,2,2,2,2,2,2,2,2,4,2,2,2,2,2,2,2,2,141,27
],[
3,3,3,3,3,3,3,3,3,3,3,3,3,3,3,3,3,3,67,66
],[
2,2,2,2,2,2,2,2,2,2,2,2,2,2,2,2,2,3,17,177
],[
2,2,2,2,2,2,2,2,2,2,2,2,2,2,2,2,2,3,83,217
],[
53,195,230,8,49,118,26,195,54,7,201,209,1,15,185,44,175,5,19,169
],[
211,4,23,219,198,206,13,53,62,18,127,112,34,234,165,44,157,168,33,218
],[
114,210,237,217,143,107,145,223,228,116,153,155,117,179,70,153,174,179,132,101
],[
247,12,28,243,137,228,43,62,128,182,211,48,49,83,48,194,189,38,141,100
],[
231,187,216,159,34,131,84,249,238,209,142,25,101,41,146,43,17,186,94,134
],[
1,41,151,140,28,144,123,210,181,199,23,130,95,226,186,253,2,250,169,196
],[
46,49,20,152,176,240,73,224,99,115,40,76,73,136,215,184,218,147,183,83
]
]