aLevelData = [
[
12,2,2,2,2,2,29,249,76,80,57,213,107,22,187,8,223,210,130,14
],[
2,2,2,2,2,3,4,84,157,135,41,13,52,184,237,252,247,2,157,138
],[
2,2,3,3,3,186,179,219,28,92,1,149,59,86,79,56,243,147,172,32
],[
11,2,3,2,2,120,131,157,84,16,107,28,112,44,255,224,226,216,50,223
],[
2,2,3,2,2,89,86,77,18,123,6,62,120,215,138,51,93,26,38,104
],[
2,2,3,2,2,220,133,109,61,163,158,26,140,246,38,60,57,247,76,150
],[
10,2,3,2,2,11,36,32,69,186,33,74,163,73,184,252,108,149,30,37
],[
2,2,3,2,2,31,47,119,232,167,103,157,76,59,169,29,53,131,13,131
],[
2,2,3,2,2,147,252,41,216,217,157,42,104,177,187,35,201,237,42,164
],[
9,2,3,2,2,24,193,165,143,134,48,111,39,19,197,59,106,154,131,74
],[
2,2,3,2,2,161,14,30,211,53,3,108,167,196,112,22,21,116,179,147
],[
2,2,3,2,2,11,135,213,87,127,48,16,71,13,165,142,113,226,118,116
],[
8,2,3,2,2,250,216,29,31,87,226,214,173,192,171,177,192,226,122,229
],[
2,2,3,2,3,126,213,89,103,221,77,118,187,29,20,201,11,150,184,247
],[
2,2,3,2,3,118,179,129,119,170,63,165,243,181,223,191,241,24,224,126
],[
6,2,3,2,3,178,29,51,154,90,107,182,13,82,216,182,127,235,126,177
],[
2,2,3,3,3,2,68,17,96,255,109,112,244,112,204,121,161,80,192,34
],[
2,2,2,2,2,89,80,133,197,218,204,88,188,234,253,219,46,225,112,186
],[
2,2,2,2,2,40,105,183,143,240,130,94,3,150,201,33,54,203,249,91
],[
2,2,2,2,2,98,246,178,194,187,133,121,82,153,129,1,135,216,102,168
]
]