aLevelData = [
[
2,2,2,5,2,2,2,5,2,2,2,5,195,235,201,221,141,231,5,214
],[
2,2,2,2,2,5,2,2,2,5,2,2,211,188,207,220,212,190,251,1
],[
2,2,3,3,3,3,3,3,3,3,3,3,172,169,38,255,119,53,247,113
],[
2,3,2,2,2,2,2,2,2,2,2,2,185,235,163,66,254,54,183,101
],[
2,3,2,2,2,2,2,2,2,2,8,2,189,189,18,198,130,240,48,129
],[
2,2,2,2,2,5,5,5,5,2,2,2,76,225,175,83,52,86,11,77
],[
2,2,3,3,3,3,2,3,2,3,2,2,80,28,173,208,215,158,36,181
],[
2,2,3,2,2,3,2,3,2,3,3,2,134,182,178,204,66,194,10,136
],[
2,2,3,2,2,3,2,3,2,3,2,3,254,251,88,248,223,2,130,249
],[
4,2,3,2,2,3,2,3,2,3,2,3,158,188,173,171,47,96,4,33
],[
160,206,180,93,67,35,59,123,15,138,227,44,68,85,137,102,78,76,163,90
],[
236,68,130,167,145,244,212,205,11,5,108,228,98,104,70,142,3,236,197,42
],[
29,16,64,74,76,21,189,103,117,88,252,212,241,223,184,241,237,50,41,161
],[
16,108,205,254,95,145,104,75,94,34,74,41,120,239,208,14,161,45,45,244
],[
58,200,106,78,53,251,172,64,121,29,182,15,136,190,174,215,95,242,36,124
],[
158,237,80,226,232,208,155,97,141,195,98,115,102,68,246,176,1,190,231,253
],[
254,94,130,0,185,34,152,215,42,51,129,9,9,116,97,188,53,91,170,41
],[
86,0,226,78,193,115,167,226,157,83,240,142,68,156,149,90,236,193,18,102
],[
135,251,136,218,232,224,4,31,38,55,4,80,69,11,55,235,19,254,133,205
],[
81,224,79,93,19,128,248,7,106,194,164,236,63,242,63,215,130,88,194,115
]
]