aLevelData = [
[
2,2,2,2,2,2,2,2,2,2,2,2,2,3,210,82,247,202,123,158
],[
2,2,2,2,2,2,2,2,2,2,2,2,2,133,15,35,128,145,21,209
],[
116,245,96,203,59,197,198,89,138,47,201,204,255,165,36,191,88,63,164,157
],[
231,90,57,99,65,134,77,167,55,159,84,218,7,57,165,202,211,65,136,106
],[
81,226,144,214,197,166,43,146,44,222,119,18,186,67,87,128,135,221,199,185
],[
134,36,108,153,182,102,111,120,156,104,140,244,240,80,102,241,151,194,30,223
],[
209,74,35,60,180,250,76,89,217,84,36,96,85,106,133,150,234,67,104,222
],[
127,129,251,127,206,65,244,38,93,67,37,47,175,75,81,32,187,198,63,118
],[
157,177,12,165,140,183,197,90,12,153,54,3,100,211,252,145,83,125,226,124
],[
255,111,106,8,46,168,169,200,184,241,88,96,61,189,41,142,19,84,87,108
],[
130,48,129,239,52,167,184,180,231,203,215,252,101,143,18,245,182,43,210,59
],[
148,193,193,158,31,64,32,38,210,137,97,84,182,208,242,171,213,69,87,111
],[
242,244,123,173,119,234,72,123,175,154,117,129,53,127,159,184,173,2,156,114
],[
177,157,12,155,14,65,48,62,49,245,0,74,220,193,119,151,30,202,50,36
],[
129,190,57,163,133,114,29,55,77,202,67,124,153,218,127,200,244,74,228,176
],[
47,255,219,206,13,247,115,194,64,117,248,119,148,95,199,168,107,228,96,162
],[
105,97,189,75,112,134,227,99,207,181,182,10,182,170,17,130,238,97,22,55
],[
198,52,195,252,81,69,198,152,206,27,147,129,104,144,179,231,32,234,95,244
],[
7,72,77,83,176,64,202,239,229,198,9,253,153,79,187,60,30,55,223,123
],[
152,96,220,93,178,29,205,89,143,78,28,4,4,204,82,147,4,7,45,155
]
]