aLevelData = [
[
2,2,2,2,185,7,64,223,18,117,201,9,130,156,48,128,93,143,13,9
],[
2,2,13,5,161,100,236,145,216,138,80,31,64,93,247,8,42,248,96,98
],[
2,2,2,5,160,74,139,186,74,109,0,10,147,50,18,229,7,1,101,245
],[
2,2,2,2,255,224,174,167,129,209,186,37,98,97,178,133,173,126,157,63
],[
2,2,2,2,73,137,38,229,213,172,159,14,215,110,71,148,22,132,200,255
],[
68,234,4,64,224,51,17,163,91,30,130,255,122,105,233,47,251,234,154,198
],[
123,219,177,255,151,118,86,243,82,194,63,15,182,172,119,196,191,89,94,128
],[
116,187,242,222,87,98,76,26,255,149,109,199,4,162,59,196,27,114,199,108
],[
130,96,209,13,159,75,142,155,228,234,169,166,245,96,135,138,13,17,207,230
],[
158,179,42,79,55,168,71,69,171,139,35,101,112,9,135,225,69,242,210,46
],[
23,143,248,252,38,55,203,107,100,29,121,124,29,108,86,197,221,150,220,106
],[
143,232,240,72,226,99,103,115,241,199,201,227,34,240,85,106,78,101,69,233
],[
35,47,83,196,199,231,123,147,190,19,3,27,14,179,185,124,161,22,124,171
],[
234,242,253,35,204,180,199,216,183,21,125,109,20,238,99,166,227,77,32,32
],[
162,200,195,64,113,17,3,105,117,203,203,114,122,156,246,87,220,132,87,46
],[
167,109,252,93,253,3,179,11,184,197,206,212,81,92,36,193,1,44,88,119
],[
37,42,94,174,231,237,58,229,27,7,11,84,103,149,73,35,167,21,75,217
],[
143,120,12,23,146,120,46,134,3,44,63,14,123,218,60,73,122,12,83,55
],[
81,230,237,51,63,182,236,37,218,205,49,250,176,142,98,81,47,196,234,119
],[
194,57,65,150,61,132,109,41,123,34,201,179,69,200,5,177,118,248,110,205
]
]