aLevelData = [
[
2,2,2,2,2,2,2,2,2,2,2,2,2,2,2,2,2,161,146,208
],[
2,2,13,5,5,2,2,12,5,5,2,3,2,5,5,2,2,153,165,125
],[
2,2,2,5,5,2,2,2,5,5,2,3,2,5,5,2,2,109,228,158
],[
2,2,2,2,2,2,2,2,2,2,2,3,2,2,2,2,2,70,60,63
],[
2,2,2,2,2,2,2,2,2,2,2,3,3,3,3,3,3,119,57,35
],[
2,2,2,2,2,2,2,2,2,2,2,2,2,2,6,2,2,131,246,24
],[
2,2,2,2,2,2,2,2,2,2,2,2,2,3,3,3,2,176,160,157
],[
110,18,142,206,32,104,135,51,69,63,116,93,55,85,165,171,234,163,196,110
],[
125,155,12,74,15,175,182,224,212,18,180,169,104,194,162,37,99,198,250,54
],[
45,180,135,198,20,119,28,176,155,79,133,222,21,25,190,175,115,209,99,155
],[
91,85,104,25,122,108,10,192,26,6,5,173,247,198,8,38,78,189,102,124
],[
56,121,14,54,54,62,189,107,13,147,114,112,212,0,35,180,75,23,174,231
],[
110,177,18,98,74,122,223,195,16,176,235,215,104,39,71,190,7,145,113,73
],[
132,252,203,167,103,156,76,65,132,203,118,226,135,78,136,27,207,218,244,230
],[
128,214,19,137,211,99,24,189,177,154,67,16,129,20,87,136,62,176,77,137
],[
204,144,74,248,140,101,207,161,46,237,47,214,198,186,71,89,34,52,105,125
],[
91,225,153,135,171,228,252,90,126,196,141,84,204,111,18,115,165,127,79,188
],[
14,187,121,221,11,225,237,17,253,163,34,68,46,239,220,120,171,115,163,103
],[
82,97,116,105,43,111,182,153,252,35,111,51,23,77,184,65,119,213,111,119
],[
11,182,43,91,82,75,117,169,40,202,53,245,224,14,106,146,146,153,30,179
]
]