aLevelData = [
[
4,2,2,2,2,2,2,156,95,174,171,232,199,210,102,126,237,231,212,108
],[
2,2,3,2,9,2,2,185,2,70,16,33,19,123,125,250,105,19,31,14
],[
2,3,2,2,2,2,3,121,70,163,110,219,214,17,10,149,66,59,126,156
],[
2,3,2,2,2,3,2,61,91,47,152,94,248,151,232,25,9,221,230,238
],[
2,3,2,2,3,2,2,93,169,108,224,58,54,151,41,69,169,202,44,161
],[
2,3,2,3,2,2,3,161,246,171,91,15,25,58,6,72,5,244,162,88
],[
2,2,3,2,2,3,2,99,108,195,153,247,231,239,133,38,200,71,201,181
],[
2,2,2,2,3,2,2,75,105,154,211,118,150,76,90,77,16,33,82,70
],[
2,2,2,3,2,2,3,198,95,183,252,51,165,123,39,132,126,207,204,249
],[
2,2,3,2,2,3,2,55,159,177,141,238,91,20,217,236,253,156,54,53
],[
2,2,5,2,3,2,2,72,144,34,92,77,71,229,156,52,224,116,37,57
],[
2,2,2,3,2,2,3,51,149,180,245,6,68,102,223,133,85,206,18,236
],[
2,2,3,2,5,3,2,92,69,81,135,202,129,72,220,88,106,20,39,169
],[
2,3,2,2,3,5,2,40,6,6,42,129,164,118,62,98,241,254,152,187
],[
2,2,2,3,2,2,3,239,42,231,144,97,59,185,78,213,29,153,91,226
],[
2,2,3,2,2,3,2,153,123,240,175,204,91,43,180,216,32,96,197,217
],[
2,3,2,2,3,2,2,198,177,76,27,188,222,214,138,139,94,209,105,185
],[
174,147,71,237,233,159,47,83,153,36,32,66,204,199,188,29,107,162,68,119
],[
200,141,196,122,118,156,139,137,93,233,222,36,13,147,238,12,83,6,7,168
],[
10,125,9,168,52,198,28,232,74,69,160,151,208,60,99,152,43,74,23,40
]
]