aLevelData = [
[
10,2,2,8,2,2,2,228,234,56,164,14,177,81,77,118,144,173,132,39
],[
2,2,2,2,2,2,2,180,218,116,53,54,156,158,170,62,132,29,195,110
],[
2,2,2,2,2,2,3,196,46,93,126,66,239,170,35,235,103,40,54,74
],[
9,2,2,2,2,2,2,199,212,18,89,239,155,62,151,52,17,76,90,97
],[
3,3,3,3,3,3,3,101,0,103,251,149,181,192,202,222,253,189,148,119
],[
2,2,2,2,2,2,2,136,94,44,126,71,224,172,51,208,142,254,100,5
],[
2,2,2,2,2,2,2,218,161,40,240,172,169,208,242,250,8,27,29,153
],[
2,2,2,2,2,2,2,13,169,222,83,42,178,223,57,250,248,43,58,130
],[
250,148,245,184,107,82,204,65,226,236,58,127,211,92,102,203,190,110,248,255
],[
166,105,43,56,197,241,35,218,126,44,130,212,147,36,54,37,152,108,148,159
],[
168,7,171,234,86,133,210,205,230,111,132,169,190,229,110,70,23,134,197,210
],[
248,144,221,39,101,72,248,77,212,157,92,64,224,8,168,243,65,182,103,148
],[
252,233,230,18,215,156,67,221,16,102,199,237,78,160,117,5,216,202,227,57
],[
5,43,73,174,244,184,216,161,124,55,77,170,102,164,197,66,218,212,211,132
],[
24,88,208,48,105,164,114,245,84,113,160,240,20,95,133,112,74,223,228,252
],[
240,80,171,151,142,104,202,66,176,214,69,195,151,37,136,165,47,228,252,128
],[
65,4,215,122,234,129,56,14,76,69,115,12,131,73,169,225,218,253,157,25
],[
63,234,194,34,245,149,153,83,137,167,57,44,7,76,47,224,109,217,137,16
],[
96,177,46,218,30,105,113,18,180,42,229,207,113,87,114,42,154,112,168,66
],[
95,55,84,132,14,17,81,41,135,174,161,255,240,236,188,109,170,249,40,177
]
]