aLevelData = [
[
6,2,2,2,2,2,95,95,21,127,146,151,59,225,44,197,248,19,151,193
],[
2,2,2,2,2,2,151,199,15,225,224,47,75,17,226,180,95,38,239,235
],[
2,2,2,2,2,2,225,111,231,197,74,141,186,6,160,133,40,248,82,20
],[
3,3,3,3,3,3,203,96,100,67,88,177,203,58,34,128,27,89,223,56
],[
2,2,2,2,2,2,95,133,175,15,72,192,90,56,139,253,217,90,132,50
],[
2,2,2,2,2,2,25,66,31,174,251,213,248,173,159,72,193,42,226,147
],[
2,2,2,2,2,3,229,244,37,34,106,4,81,206,28,14,23,13,232,86
],[
2,2,3,3,3,3,125,101,134,197,150,39,91,60,144,89,157,40,245,244
],[
2,2,2,2,2,2,184,87,42,80,240,10,60,220,72,75,219,18,163,128
],[
2,2,2,2,2,2,167,170,42,65,171,14,237,103,39,15,205,101,147,214
],[
3,3,3,3,3,3,153,220,224,29,119,105,1,159,134,194,170,204,193,1
],[
2,2,2,2,2,2,88,194,39,63,145,121,25,101,109,61,3,63,85,98
],[
2,2,2,2,2,2,62,210,11,51,53,240,234,43,199,9,112,104,237,68
],[
2,2,3,3,3,3,249,92,157,206,205,198,238,114,93,224,124,107,202,218
],[
2,2,3,2,2,2,14,118,167,136,118,43,0,88,185,140,155,134,112,223
],[
2,2,3,2,2,2,125,147,110,185,176,243,163,92,68,6,64,66,148,73
],[
2,2,3,3,3,3,28,250,203,206,87,51,166,233,61,23,123,45,109,218
],[
2,2,2,2,2,2,122,150,58,146,51,8,81,73,88,248,156,80,196,105
],[
3,3,3,3,2,2,103,215,189,27,194,187,118,255,38,159,216,237,91,62
],[
2,2,1,2,2,2,130,153,152,255,15,196,237,203,151,175,222,27,120,213
]
]