aLevelData = [
[
5,5,3,5,5,5,5,5,5,116,221,232,166,191,169,184,217,124,174,55
],[
4,2,3,5,5,5,5,5,5,243,167,7,224,21,39,11,131,94,248,219
],[
2,2,3,2,3,3,3,3,3,141,22,137,55,138,44,99,150,232,227,12
],[
5,2,2,2,3,2,2,2,2,117,254,200,43,239,77,231,236,142,5,62
],[
2,2,2,3,2,2,2,2,2,166,97,203,114,188,78,185,193,193,170,166
],[
2,2,2,3,2,2,5,3,3,56,223,7,168,38,121,77,216,208,15,13
],[
2,2,2,2,2,2,5,5,3,85,102,98,17,140,54,217,56,182,32,36
],[
5,2,2,2,2,2,5,5,3,129,161,74,31,101,180,21,249,106,46,79
],[
2,2,5,5,3,2,5,5,3,149,245,174,170,48,95,248,108,69,76,246
],[
105,173,56,253,46,11,83,82,128,103,143,237,5,25,247,124,64,233,66,171
],[
195,116,168,163,159,210,244,208,32,117,219,232,183,84,140,41,56,73,136,226
],[
69,184,180,52,10,114,172,26,44,217,91,167,251,68,201,143,239,165,51,233
],[
82,105,97,51,58,159,52,151,186,93,127,108,89,95,23,0,195,242,46,149
],[
191,16,220,169,97,205,255,123,129,242,69,202,108,231,135,224,216,214,89,207
],[
30,13,223,251,163,164,226,216,151,96,34,245,227,216,238,58,92,214,243,110
],[
61,0,82,251,212,184,245,246,123,64,34,90,202,34,80,148,11,207,58,69
],[
238,134,51,67,127,119,185,225,84,41,76,112,11,25,129,5,244,164,82,125
],[
10,38,184,191,40,100,124,65,121,39,73,206,49,42,7,134,122,54,100,38
],[
177,140,179,137,211,131,250,111,50,114,70,126,109,208,66,134,158,154,8,9
],[
213,245,55,251,198,21,70,198,190,93,24,145,220,200,208,194,125,135,230,193
]
]