aLevelData = [
[
6,2,8,2,9,2,10,104,255,54,144,180,30,11,183,138,252,153,213,24
],[
2,2,2,2,2,2,2,215,182,183,9,131,115,122,18,178,78,243,199,114
],[
2,2,3,3,3,3,3,169,78,180,247,123,244,169,155,70,179,85,35,73
],[
2,2,3,2,2,2,2,25,22,68,246,32,16,102,166,17,125,167,140,162
],[
2,2,3,2,2,2,2,67,35,231,97,204,115,124,86,18,115,68,228,249
],[
2,2,3,2,3,3,3,72,98,241,226,162,87,71,125,63,121,57,222,177
],[
2,2,3,2,2,2,2,162,137,212,96,37,137,118,210,6,129,254,42,106
],[
2,2,3,5,5,5,2,81,219,239,76,87,1,15,114,147,132,36,159,9
],[
2,2,2,2,2,2,2,101,245,11,103,172,64,16,232,182,183,38,120,209
],[
2,3,2,2,3,1,3,72,17,25,6,161,89,133,54,244,251,21,105,247
],[
2,3,2,2,3,2,3,94,225,98,48,136,41,119,111,146,244,159,156,89
],[
2,3,2,3,2,2,2,246,205,178,119,183,124,12,114,242,139,224,50,59
],[
2,3,2,3,2,2,2,76,9,185,229,216,9,14,35,165,78,122,109,90
],[
2,3,2,3,2,2,2,180,247,38,225,76,230,123,190,92,0,142,160,166
],[
2,3,2,3,2,2,3,143,212,54,237,222,187,68,182,238,145,246,76,106
],[
2,3,2,3,2,2,3,161,116,6,221,159,182,204,35,70,154,216,30,63
],[
2,3,2,3,2,2,3,52,186,170,69,101,159,210,135,175,210,68,77,71
],[
5,3,3,3,2,2,3,131,2,223,108,200,91,163,248,225,26,133,53,192
],[
2,2,2,5,2,2,2,253,155,241,201,104,9,213,214,91,35,242,126,162
],[
2,2,2,2,2,5,2,210,157,151,75,57,125,249,93,152,226,133,199,112
]
]