aLevelData = [
[
2,2,2,2,2,2,237,53,254,179,150,87,136,138,240,238,20,46,110,111
],[
2,2,2,2,2,2,217,72,43,96,213,43,55,92,194,255,46,93,70,30
],[
2,2,2,2,2,2,16,59,106,190,76,111,77,209,30,29,26,41,27,82
],[
2,2,2,3,3,3,55,224,11,138,191,247,246,117,51,61,130,250,108,114
],[
2,2,2,2,2,2,124,125,212,173,180,93,214,251,14,193,147,73,214,149
],[
2,2,2,2,2,2,215,132,84,207,75,254,160,247,236,20,184,230,187,14
],[
2,2,2,2,2,3,208,206,182,70,233,122,8,141,165,215,125,202,90,180
],[
56,228,101,198,168,226,193,239,184,81,216,191,70,230,152,60,215,101,202,222
],[
137,193,159,222,73,133,140,177,69,114,88,207,164,106,116,184,117,141,138,57
],[
230,161,88,235,183,183,191,254,238,11,23,52,203,45,198,48,254,94,17,241
],[
24,61,50,154,64,163,170,116,39,203,216,53,62,182,203,131,38,205,85,180
],[
103,201,96,216,102,208,133,249,145,224,219,161,221,113,13,157,114,86,176,1
],[
164,229,211,108,38,87,215,141,122,114,129,230,172,101,77,208,64,243,5,192
],[
105,211,147,200,124,87,20,97,163,77,45,103,214,35,162,101,7,78,36,19
],[
157,235,107,29,36,167,133,38,67,221,110,13,238,255,224,111,220,55,108,109
],[
60,78,202,175,164,204,110,168,74,97,91,28,118,131,60,224,55,89,177,226
],[
86,216,231,105,136,44,107,157,231,89,64,73,163,34,47,224,245,42,94,190
],[
85,89,36,177,237,129,28,184,77,65,120,10,96,42,152,90,159,33,220,90
],[
132,4,182,126,66,145,3,2,179,131,155,46,146,253,38,217,234,44,50,44
],[
206,41,131,168,75,28,170,106,155,167,218,174,155,130,246,147,128,98,238,30
]
]