aLevelData = [
[
6,2,66,90,35,137,73,162,121,59,81,110,170,47,32,63,189,158,29,173
],[
2,2,129,107,171,100,126,78,181,109,43,49,138,175,98,218,236,181,16,203
],[
2,2,99,177,49,102,216,193,252,85,94,114,90,41,83,131,157,65,168,235
],[
2,2,111,238,125,28,8,212,241,138,165,148,56,103,53,168,238,177,85,142
],[
2,2,170,111,126,40,215,56,125,99,191,244,36,23,233,231,64,46,165,235
],[
2,2,203,9,229,252,98,31,78,250,249,231,143,171,205,249,242,0,154,112
],[
2,2,48,153,14,146,138,138,126,179,21,96,217,86,86,95,218,150,14,14
],[
2,2,129,196,87,246,195,82,240,166,129,239,214,250,183,244,20,157,246,255
],[
2,2,219,205,20,221,213,94,34,174,183,2,158,67,22,199,234,203,123,225
],[
2,3,253,175,185,170,89,186,126,231,60,125,41,77,27,242,219,68,76,95
],[
2,3,209,234,3,125,241,91,127,218,162,48,133,124,225,69,14,199,146,192
],[
2,3,61,161,19,78,147,211,23,176,102,178,178,119,143,0,176,11,100,13
],[
2,3,43,242,230,33,93,79,59,30,178,169,94,98,33,238,21,235,189,184
],[
2,3,35,190,135,206,191,137,135,238,70,135,27,202,45,164,142,80,57,226
],[
236,46,242,251,21,150,85,72,17,62,201,225,163,172,84,6,33,176,15,189
],[
130,50,215,189,185,45,70,139,66,252,225,227,250,213,147,89,51,147,91,64
],[
8,184,65,203,238,178,142,114,140,93,60,151,205,202,172,106,51,63,151,10
],[
110,126,71,237,45,74,7,129,52,40,216,19,174,99,101,241,197,82,57,203
],[
113,221,48,95,141,62,43,86,48,5,8,104,58,95,210,199,45,151,52,187
],[
63,221,52,137,173,71,30,154,81,21,189,217,119,57,209,93,237,23,190,72
]
]