aLevelData = [
[
2,2,2,2,2,11,2,166,148,63,14,159,157,129,109,78,107,196,215,183
],[
2,2,2,2,2,2,2,129,210,253,145,71,194,172,77,255,28,90,83,250
],[
5,2,5,2,5,5,5,61,255,143,12,252,38,44,61,141,67,159,193,166
],[
5,2,5,2,5,2,5,71,232,43,225,114,20,221,98,104,7,195,185,136
],[
5,5,5,2,5,5,5,120,65,9,121,61,105,106,5,201,114,141,43,243
],[
5,2,5,2,5,2,5,101,159,111,249,26,111,117,196,99,210,206,109,135
],[
71,18,1,242,215,47,129,42,63,0,45,5,81,34,2,26,152,3,130,117
],[
59,59,179,143,35,32,106,125,96,148,201,103,201,34,7,60,227,74,111,164
],[
5,24,172,54,185,252,67,236,100,213,97,211,42,79,215,7,12,111,99,223
],[
83,108,49,101,50,193,161,9,167,128,75,150,162,233,65,100,105,59,147,208
],[
59,202,25,233,51,82,108,108,112,139,54,243,115,253,172,105,200,22,88,193
],[
233,122,28,231,95,154,116,247,42,136,251,174,99,10,49,30,32,237,123,165
],[
152,155,107,31,136,240,66,91,213,74,179,204,114,223,234,129,132,84,205,87
],[
196,139,130,110,37,188,49,217,184,199,11,154,204,200,139,205,89,236,251,35
],[
159,132,59,146,10,88,190,75,89,62,213,237,255,235,48,248,201,8,161,132
],[
194,137,36,51,84,58,29,100,175,154,224,169,111,237,118,124,120,141,159,45
],[
37,129,19,31,163,80,13,52,151,23,10,134,7,218,206,88,119,24,169,76
],[
82,162,248,214,140,173,238,240,134,37,149,15,50,68,15,86,119,100,34,10
],[
215,17,244,71,79,99,18,241,126,138,183,236,10,171,76,144,64,235,43,87
],[
250,201,168,217,198,176,82,251,68,204,118,99,208,30,229,47,97,203,247,230
]
]