aLevelData = [
[
6,2,2,2,2,2,2,2,2,2,2,2,2,2,2,2,2,2,185,45
],[
2,2,2,2,2,2,2,2,2,2,2,2,2,2,2,2,2,2,37,175
],[
2,2,2,2,2,2,2,2,2,2,2,2,2,2,2,2,2,2,112,3
],[
3,3,3,3,3,3,3,3,3,3,3,3,3,3,3,3,3,3,248,127
],[
2,2,2,2,2,2,2,2,2,2,2,2,2,2,2,2,2,2,101,45
],[
2,2,2,2,2,2,2,2,2,2,2,2,2,2,2,2,2,2,151,130
],[
2,2,2,2,2,3,2,2,3,2,2,3,2,2,2,3,2,2,250,218
],[
2,2,3,3,3,3,3,3,3,3,3,3,3,3,3,3,3,3,142,233
],[
2,2,2,2,2,2,2,2,2,2,2,2,2,2,2,2,2,2,38,115
],[
2,2,2,2,2,2,2,2,2,4,2,2,2,2,2,2,2,2,173,15
],[
3,3,3,3,3,3,3,3,3,3,3,3,3,3,3,3,3,3,107,195
],[
2,2,2,2,2,2,2,2,2,2,2,2,2,2,2,2,2,3,163,185
],[
2,2,2,2,2,2,2,2,2,2,2,2,2,2,2,2,2,3,8,91
],[
2,2,3,3,3,3,3,3,3,3,2,3,3,3,3,3,3,3,207,156
],[
2,2,3,2,2,2,2,2,2,2,2,3,2,2,2,2,2,3,111,53
],[
2,2,3,2,2,2,2,2,2,2,2,3,2,2,2,2,2,3,82,31
],[
2,2,3,3,3,3,3,2,2,2,2,3,2,2,3,2,2,3,249,151
],[
2,2,2,2,2,2,3,2,2,2,2,3,2,2,3,2,2,3,105,99
],[
3,3,3,3,2,2,3,2,2,2,2,3,2,2,3,2,2,3,217,58
],[
250,128,79,172,108,18,30,243,188,245,63,115,205,76,215,18,0,200,103,153
]
]