aLevelData = [
[
6,2,147,116,67,50,68,159,72,214,127,188,205,237,129,28,178,109,185,138
],[
2,2,106,135,229,216,70,218,121,190,246,230,64,229,77,195,69,62,68,18
],[
2,2,244,152,66,53,125,114,154,187,121,13,85,30,208,198,51,177,218,163
],[
3,3,236,212,196,44,187,106,54,124,29,141,50,151,215,128,64,254,54,228
],[
2,2,200,129,154,47,191,85,54,91,133,102,17,219,14,238,80,211,65,71
],[
2,2,184,136,157,254,111,22,34,40,2,97,111,249,172,77,40,146,214,50
],[
2,2,154,27,218,138,162,18,12,237,202,226,251,64,182,184,244,41,191,146
],[
2,2,200,197,221,153,207,158,202,176,45,215,100,77,84,170,84,135,203,21
],[
2,2,237,113,45,207,86,167,116,129,236,38,119,51,226,97,178,4,42,145
],[
2,2,70,31,153,76,64,234,70,89,30,129,51,195,144,98,47,44,123,106
],[
3,3,250,100,67,0,171,58,74,144,79,146,180,59,211,184,110,204,36,244
],[
2,2,110,238,148,95,60,157,128,244,177,219,47,234,254,164,254,66,241,35
],[
2,2,186,156,116,38,78,78,87,208,158,183,79,141,178,209,62,75,23,6
],[
2,2,180,232,130,69,182,230,183,84,191,102,169,104,5,84,227,243,253,223
],[
2,2,38,189,33,44,84,54,241,75,140,11,56,106,151,247,144,72,131,220
],[
2,2,40,237,141,18,197,153,69,254,7,250,236,231,238,161,33,6,156,183
],[
2,2,189,220,93,236,251,201,228,177,220,217,216,167,201,225,143,87,122,203
],[
2,2,25,35,24,46,128,124,158,34,78,86,133,82,80,217,160,82,154,90
],[
3,3,69,51,203,137,173,85,146,236,157,125,113,140,70,39,193,238,107,30
],[
2,2,247,68,193,73,37,229,155,200,196,251,198,64,176,123,178,114,116,91
]
]