aLevelData = [
[
2,2,3,3,3,3,3,3,3,3,3,3,3,3,3,3,2,3,2,119
],[
2,2,2,2,2,2,2,2,2,2,2,2,2,2,2,2,2,2,3,190
],[
3,2,3,3,3,3,3,3,3,3,3,2,3,3,3,2,2,2,2,34
],[
2,2,2,2,2,2,2,2,2,2,2,2,2,2,3,2,2,2,2,125
],[
3,2,3,3,3,3,3,3,3,3,3,3,3,2,3,2,2,3,3,77
],[
2,2,3,2,2,2,2,2,2,2,2,2,3,2,3,2,3,2,3,232
],[
3,2,3,2,2,3,3,3,3,3,3,3,3,2,3,2,3,2,3,228
],[
2,2,3,2,2,3,2,2,2,2,2,3,3,2,3,2,3,2,2,186
],[
2,3,3,2,2,3,3,3,3,2,2,2,2,2,3,2,3,3,3,73
],[
2,2,2,2,2,2,2,2,2,3,2,3,2,2,3,2,2,2,3,20
],[
3,3,3,3,2,2,2,2,2,3,2,3,2,2,3,2,3,2,3,62
],[
8,2,6,3,2,3,3,3,3,3,2,3,2,2,3,2,3,2,3,75
],[
2,2,2,3,2,3,2,2,2,3,2,3,2,2,3,2,3,2,3,247
],[
2,2,2,2,2,3,2,2,2,3,2,3,3,3,3,2,3,2,3,48
],[
2,2,2,2,2,3,2,2,2,3,2,2,2,2,2,2,3,2,3,189
],[
9,2,12,3,2,2,2,2,3,2,3,3,3,3,3,2,3,2,3,156
],[
2,2,2,3,2,3,3,3,3,2,3,2,2,2,3,2,3,2,3,218
],[
65,156,10,176,156,44,176,248,89,121,125,178,5,43,138,102,151,170,171,103
],[
165,134,69,89,216,21,95,241,158,94,251,252,30,53,166,163,113,168,78,237
],[
15,154,84,133,135,174,226,190,116,103,127,212,172,141,224,117,186,210,1,127
]
]