aLevelData = [
[
4,2,5,5,2,2,2,2,2,2,2,2,2,2,2,2,2,26,42,49
],[
2,2,2,2,2,2,5,2,2,2,5,2,2,2,5,3,3,109,243,33
],[
2,2,2,2,2,2,3,3,3,3,3,3,3,2,2,2,2,6,249,107
],[
3,3,3,3,3,3,3,2,2,2,2,2,3,2,2,2,2,164,255,204
],[
2,2,3,2,2,2,2,2,2,2,2,2,3,2,2,2,2,252,20,132
],[
249,124,191,63,216,243,97,136,171,170,235,33,129,132,130,36,91,145,203,57
],[
142,225,102,12,104,150,184,255,22,61,238,28,197,95,62,77,8,82,112,207
],[
122,85,158,228,164,221,56,200,33,41,74,231,255,28,2,77,105,76,109,94
],[
131,87,129,199,150,118,96,180,109,84,219,68,255,32,53,57,78,224,42,245
],[
142,9,48,162,138,77,253,176,68,181,73,132,219,239,213,110,178,233,172,220
],[
207,159,169,206,129,49,57,138,70,56,98,145,235,90,5,209,245,28,96,28
],[
64,248,214,217,230,176,243,250,98,225,171,46,246,219,226,87,74,176,50,62
],[
85,139,232,133,128,67,79,222,9,48,50,123,166,62,156,198,108,63,226,81
],[
238,134,227,16,169,177,143,198,160,198,166,189,67,130,194,186,149,237,152,48
],[
142,50,123,180,190,174,34,177,52,71,170,93,158,255,222,235,178,200,183,3
],[
204,155,31,111,216,196,250,23,114,128,103,47,76,201,67,175,208,113,240,3
],[
7,110,84,4,186,117,36,40,215,202,98,245,21,86,36,188,219,250,152,131
],[
95,35,69,67,11,158,147,84,36,174,142,37,173,92,231,48,137,15,59,45
],[
225,92,152,134,197,31,62,12,22,203,162,232,163,254,185,212,146,89,114,139
],[
2,142,133,125,238,186,107,200,84,246,173,100,151,40,98,157,35,32,243,199
]
]