aLevelData = [
[
2,2,3,3,132,171,44,188,8,155,38,170,225,104,0,156,204,165,142,100
],[
2,2,2,2,97,94,62,7,162,89,76,30,213,155,57,124,143,46,121,17
],[
3,2,3,3,18,34,108,14,216,210,143,74,112,105,244,229,137,164,239,43
],[
2,2,2,2,77,217,19,187,240,56,92,232,136,81,174,95,31,214,126,10
],[
3,2,3,3,6,162,207,53,109,251,97,240,49,20,37,180,245,214,243,73
],[
2,2,3,2,116,224,127,230,21,205,138,155,193,181,85,236,241,246,91,191
],[
3,2,3,2,11,52,63,120,238,158,4,98,203,115,124,81,56,197,3,133
],[
2,2,3,2,127,126,109,210,60,160,60,254,39,209,22,107,46,22,119,245
],[
2,3,3,2,199,223,164,30,132,68,224,105,231,142,225,3,121,249,133,168
],[
2,2,2,2,22,184,194,197,139,58,219,218,99,172,218,35,253,191,58,119
],[
3,3,3,3,226,171,228,112,86,116,93,204,45,107,61,19,224,249,227,122
],[
8,2,6,3,224,152,103,8,42,34,208,247,28,78,135,93,135,119,12,12
],[
2,2,2,3,5,160,232,182,141,182,227,85,68,20,118,201,150,77,131,195
],[
2,2,2,2,134,37,68,227,66,224,130,29,251,192,7,97,243,201,85,123
],[
2,2,2,2,216,199,152,56,80,146,218,202,213,145,118,109,195,125,207,75
],[
175,103,65,157,251,253,88,20,167,9,64,119,106,58,125,141,2,39,220,61
],[
200,145,170,244,135,232,35,71,142,17,45,218,4,103,71,128,124,0,188,163
],[
201,49,28,231,20,84,236,10,44,200,157,15,28,58,187,155,3,35,103,159
],[
32,146,7,55,45,44,60,210,238,113,21,148,9,65,130,248,24,158,11,186
],[
253,179,193,244,117,21,117,135,241,74,41,188,161,136,196,43,209,190,10,220
]
]