aLevelData = [
[
4,2,2,2,2,2,2,2,2,2,8,2,2,2,2,242,212,153,251,246
],[
2,2,3,2,9,2,2,2,2,2,2,2,2,3,2,18,68,13,195,222
],[
2,3,2,2,2,2,3,2,2,3,2,3,2,2,3,137,131,213,148,228
],[
2,3,2,2,2,3,2,2,3,2,2,2,3,2,2,56,163,157,174,112
],[
2,3,2,2,3,2,2,3,2,2,2,2,2,3,2,119,237,148,118,126
],[
2,3,2,3,2,2,3,2,2,3,2,3,2,2,3,208,72,131,27,231
],[
2,2,3,2,2,3,2,2,3,2,2,2,3,2,2,118,226,129,109,250
],[
2,2,2,2,3,2,2,3,2,2,2,2,2,3,2,82,129,191,80,172
],[
2,2,2,3,2,2,3,2,2,3,2,3,2,2,3,160,28,76,197,109
],[
2,2,3,2,2,3,2,2,3,2,2,2,3,2,2,169,11,150,18,184
],[
41,154,40,73,52,120,208,209,97,226,255,59,126,189,25,45,40,130,194,140
],[
62,228,241,66,150,179,69,63,238,0,157,189,37,130,227,201,171,56,40,255
],[
54,80,246,149,182,72,225,155,140,83,96,128,246,254,219,217,206,19,5,94
],[
117,189,108,53,10,238,79,116,223,254,175,225,45,149,168,252,6,202,2,63
],[
140,140,4,164,97,65,136,104,94,174,85,14,136,23,168,168,63,167,20,82
],[
185,18,140,255,175,120,191,120,86,141,164,161,145,247,85,254,101,247,32,119
],[
173,76,219,88,15,84,121,156,46,117,219,107,33,187,232,225,37,194,224,17
],[
142,215,237,74,4,90,252,153,235,102,202,142,35,181,66,67,242,189,6,155
],[
62,31,76,200,0,66,235,16,245,59,181,208,151,241,8,193,75,126,160,122
],[
220,216,175,54,40,176,48,216,25,154,120,44,215,111,14,112,60,239,188,19
]
]