aLevelData = [
[
4,2,2,2,2,2,2,2,2,2,2,2,2,2,2,2,2,2,13,106
],[
5,2,5,3,2,2,2,2,2,2,2,2,2,2,2,2,2,2,215,55
],[
2,5,5,3,3,3,3,3,3,3,3,3,3,3,3,3,3,3,144,196
],[
3,3,5,5,5,5,5,5,5,5,3,2,2,2,2,2,2,2,95,25
],[
2,3,5,5,5,5,5,5,5,5,3,6,2,2,2,2,2,2,184,38
],[
3,3,5,5,5,5,3,3,3,3,3,3,3,3,3,2,3,3,242,122
],[
3,5,5,5,5,5,3,2,2,2,2,2,2,2,2,2,2,2,141,1
],[
3,5,5,3,3,3,3,8,2,2,2,5,5,5,5,5,5,5,136,125
],[
3,5,5,3,2,2,3,3,3,3,2,5,3,3,3,5,3,3,115,195
],[
3,5,5,3,2,2,2,2,2,3,2,5,3,5,5,5,5,5,44,21
],[
3,5,5,3,2,2,3,2,2,3,2,5,3,5,5,5,5,5,100,7
],[
5,5,5,3,2,2,3,2,2,3,2,5,3,5,5,5,5,5,92,210
],[
5,5,5,3,2,2,3,2,2,3,2,5,3,3,3,5,5,5,125,8
],[
5,3,3,3,2,2,3,2,2,3,2,5,2,2,3,3,3,3,179,251
],[
188,92,197,222,8,223,75,100,113,237,128,232,186,212,202,73,20,136,157,62
],[
45,153,156,234,105,99,2,177,111,133,65,73,232,148,233,20,131,16,202,173
],[
61,150,93,193,223,88,96,32,200,203,193,19,236,159,189,241,29,244,73,237
],[
138,203,177,50,133,186,127,50,137,229,158,58,123,41,191,74,48,154,252,37
],[
48,48,187,164,185,189,214,79,7,34,249,46,211,195,75,221,26,56,80,223
],[
31,70,14,52,179,13,110,46,180,130,230,128,212,32,85,152,155,219,46,47
]
]