aLevelData = [
[
2,2,3,3,3,3,3,3,3,3,3,3,3,93,185,225,32,236,225,44
],[
2,2,2,2,2,2,2,2,2,2,2,2,2,59,232,66,69,117,238,85
],[
3,2,3,3,3,3,3,3,3,3,3,2,3,217,151,48,216,184,0,35
],[
2,2,2,2,2,2,2,2,2,2,2,2,2,185,43,164,119,53,137,85
],[
3,2,3,3,3,3,3,3,3,3,3,3,3,76,65,5,66,163,41,202
],[
2,2,3,2,2,2,2,2,2,2,2,2,3,189,18,119,74,65,189,22
],[
3,2,3,2,2,3,3,3,3,3,3,3,3,210,179,129,183,98,232,114
],[
2,2,3,2,2,3,2,2,2,2,2,3,3,116,189,104,136,179,188,113
],[
2,3,3,2,2,3,3,3,3,2,2,2,2,149,78,231,63,122,241,70
],[
2,2,2,2,2,2,2,2,2,3,2,3,2,139,155,195,117,82,144,72
],[
3,3,3,3,2,2,2,2,2,3,2,3,2,247,215,30,134,204,235,101
],[
8,2,6,3,2,3,3,3,3,3,2,3,2,102,70,108,90,94,24,12
],[
2,2,2,3,2,3,2,2,2,3,2,3,2,120,77,176,83,179,166,199
],[
232,174,209,54,12,45,206,11,103,205,28,220,7,243,217,91,166,2,42,43
],[
43,209,221,242,116,92,77,176,83,185,134,79,214,78,170,123,204,66,148,179
],[
132,49,186,160,216,36,88,166,106,192,203,186,46,189,58,115,41,154,124,99
],[
120,143,54,167,147,196,68,189,211,192,91,150,50,36,236,236,83,153,75,214
],[
194,7,16,154,124,8,190,194,178,156,162,114,202,30,254,248,167,118,103,165
],[
42,145,108,219,248,14,120,104,126,58,250,18,51,63,194,115,29,152,174,8
],[
151,200,135,132,81,76,38,106,152,206,219,218,216,155,15,171,95,87,39,187
]
]