aLevelData = [
[
2,2,2,5,2,2,86,129,105,233,116,160,225,63,115,222,186,61,33,30
],[
2,2,2,2,2,5,89,129,48,158,24,207,231,214,152,17,23,163,89,156
],[
2,2,3,3,3,3,81,164,135,181,86,228,23,84,207,186,19,40,62,238
],[
2,3,2,2,2,2,50,218,53,29,172,150,198,95,76,200,58,38,199,35
],[
2,3,2,2,2,2,5,106,76,232,250,3,92,101,188,86,220,188,117,51
],[
2,2,2,2,2,5,105,229,202,254,235,246,14,13,109,162,181,82,44,0
],[
2,2,3,3,3,3,12,58,237,142,40,212,148,118,28,54,243,16,112,29
],[
2,2,3,2,2,3,224,167,206,211,138,128,253,86,13,24,20,182,67,174
],[
2,2,3,2,2,3,231,191,221,1,198,216,179,91,103,43,89,206,32,6
],[
4,2,3,2,2,3,243,190,89,129,74,160,66,98,31,0,193,61,191,201
],[
2,2,3,3,3,2,175,224,215,193,67,238,138,83,206,201,193,145,169,181
],[
2,2,3,2,3,2,194,121,108,59,5,119,97,204,66,44,57,167,207,110
],[
2,2,3,2,3,2,253,253,41,144,71,82,209,227,177,38,89,124,142,213
],[
2,2,3,2,2,3,190,56,216,188,248,254,106,157,208,68,111,68,242,213
],[
2,2,3,2,2,3,27,107,67,209,153,220,116,245,68,213,216,28,25,176
],[
114,6,108,195,83,89,219,134,35,229,129,243,253,44,108,51,128,34,80,118
],[
34,49,124,35,200,128,14,49,148,117,99,212,254,121,210,93,39,251,154,91
],[
105,183,24,7,51,56,62,223,20,155,64,144,21,151,144,25,76,186,13,46
],[
174,245,120,218,37,91,39,105,227,38,253,133,245,251,153,159,27,111,206,145
],[
215,201,83,129,196,9,188,8,41,42,169,147,206,165,62,10,14,54,211,176
]
]