aLevelData = [
[
2,2,2,2,5,5,2,2,2,2,2,149,229,27,123,1,111,82,147,195
],[
2,2,2,4,2,2,2,2,2,2,2,72,170,33,153,134,241,137,232,75
],[
5,3,3,3,5,5,3,3,3,3,3,208,165,173,236,88,12,183,82,222
],[
2,3,2,2,2,2,2,2,2,3,2,148,20,160,9,21,201,21,41,112
],[
2,3,2,2,2,2,2,2,2,3,2,198,53,202,208,24,35,138,48,97
],[
2,3,2,2,3,2,2,2,2,3,2,82,39,30,133,92,220,190,167,50
],[
2,3,2,2,3,2,2,2,2,3,2,238,17,84,118,130,119,253,37,177
],[
2,3,2,2,3,5,5,3,3,3,3,115,171,121,222,175,238,14,71,64
],[
2,3,3,2,3,2,2,3,2,2,2,22,67,219,42,166,227,76,39,6
],[
2,2,3,2,3,2,2,3,2,1,2,5,100,164,120,48,156,13,77,195
],[
2,2,3,2,3,2,2,3,2,2,2,235,74,89,148,220,138,164,216,227
],[
2,2,3,2,3,2,2,3,2,2,2,63,98,67,241,105,38,112,70,24
],[
82,130,135,44,210,12,16,96,10,46,139,135,12,1,193,21,15,53,177,224
],[
29,249,223,40,11,27,239,213,174,113,114,1,76,119,0,182,81,57,135,249
],[
67,116,226,7,248,248,174,222,7,80,89,255,124,165,123,115,208,224,106,12
],[
24,15,9,237,124,10,224,76,235,86,114,119,13,73,202,21,121,111,88,175
],[
41,45,251,111,42,164,95,39,152,216,137,148,202,18,176,229,202,131,79,119
],[
8,41,120,227,79,247,107,58,247,48,103,143,93,20,192,182,144,190,50,76
],[
77,77,117,247,46,66,17,239,30,41,116,190,16,124,66,68,241,196,236,253
],[
218,1,132,135,139,76,208,94,21,187,157,235,214,133,85,189,170,102,212,22
]
]