aLevelData = [
[
2,2,2,2,2,2,2,2,2,2,2,213,109,254,110,38,150,110,154,109
],[
2,2,2,2,2,2,2,2,3,3,3,160,237,136,166,45,228,7,53,156
],[
2,2,3,2,3,2,2,2,2,3,2,134,150,110,128,107,118,90,80,123
],[
2,2,3,2,3,2,2,2,2,2,3,4,184,96,14,70,67,15,82,196
],[
2,2,3,2,3,2,2,2,2,2,2,51,66,236,153,6,18,226,201,128
],[
2,2,3,2,2,2,2,2,2,2,2,194,184,213,241,244,217,141,182,28
],[
2,2,3,2,3,3,3,3,3,3,3,57,38,2,52,57,140,223,178,203
],[
2,2,3,2,2,2,2,2,2,2,2,249,111,183,214,199,120,137,220,131
],[
2,2,3,2,3,3,3,3,3,3,3,31,67,218,66,244,203,111,56,47
],[
2,2,3,2,2,2,2,2,2,2,2,5,65,134,57,70,157,84,111,12
],[
2,2,3,3,3,3,3,3,3,3,3,93,32,34,236,15,85,226,203,83
],[
1,2,3,2,2,2,2,2,2,2,2,32,252,81,133,127,65,155,156,155
],[
2,2,3,5,5,2,2,2,5,5,5,9,48,82,87,120,55,134,41,0
],[
2,2,3,2,2,5,5,5,5,5,2,231,222,41,39,62,176,103,139,246
],[
35,130,35,181,145,118,199,132,48,182,243,130,242,123,200,217,169,91,83,242
],[
111,29,18,229,69,204,180,52,250,10,33,184,79,167,186,219,88,114,226,8
],[
37,79,189,96,162,138,55,175,188,107,73,158,197,11,120,42,26,101,158,84
],[
3,176,236,26,218,237,48,167,112,188,84,199,172,115,39,157,117,113,97,152
],[
210,176,225,163,80,154,56,156,165,30,107,8,146,2,245,5,14,123,12,127
],[
160,251,37,167,13,74,186,161,51,216,75,125,53,82,163,105,216,115,92,37
]
]