aLevelData = [
[
2,2,3,3,3,3,3,3,3,3,3,3,3,3,3,3,2,3,143,184
],[
18,51,50,65,92,231,165,121,68,196,143,121,73,220,8,10,232,81,253,114
],[
24,197,213,142,23,17,84,33,104,58,192,108,29,161,67,255,82,121,145,206
],[
250,126,202,135,222,228,162,35,226,142,191,188,138,129,99,158,190,152,74,160
],[
202,121,214,181,169,199,105,190,131,154,18,162,116,44,109,161,143,213,196,229
],[
35,57,122,90,60,192,170,192,109,70,11,255,205,20,23,186,64,15,108,38
],[
248,48,114,29,59,52,62,110,102,149,182,120,50,184,246,247,54,104,243,29
],[
173,131,94,229,122,243,204,164,105,224,19,224,184,36,247,102,214,0,6,151
],[
106,13,192,3,151,117,251,57,126,98,134,220,5,183,13,250,215,255,60,154
],[
173,162,39,148,203,95,234,166,205,246,140,195,163,37,42,174,219,214,81,200
],[
30,151,171,39,254,74,222,231,239,30,177,197,146,190,113,233,58,200,147,4
],[
169,128,154,155,26,198,59,163,133,69,191,77,30,238,170,35,30,165,154,84
],[
199,57,113,76,162,154,182,136,12,70,57,169,240,5,246,199,214,214,60,7
],[
29,41,15,112,132,78,202,250,240,46,9,232,105,57,197,88,101,159,193,25
],[
73,195,37,188,45,237,105,238,223,62,117,5,43,234,7,216,90,161,84,212
],[
249,78,242,76,220,4,245,17,98,53,89,67,249,38,160,102,229,159,187,184
],[
62,231,46,194,56,240,112,46,168,206,144,216,195,109,30,40,40,132,73,158
],[
33,197,69,174,37,87,240,207,162,133,180,207,250,184,175,105,203,162,17,25
],[
116,189,198,47,213,244,86,35,86,159,9,40,42,181,78,3,213,61,93,30
],[
235,6,28,216,27,152,63,32,109,106,180,66,200,86,62,0,183,73,96,229
]
]