aLevelData = [
[
12,2,2,2,2,2,2,2,2,148,188,253,255,212,56,23,72,119,19,120
],[
2,2,2,2,2,2,2,2,2,139,186,104,97,88,253,229,89,107,25,206
],[
2,2,3,3,3,3,3,3,3,31,210,245,68,226,83,84,200,180,8,241
],[
11,2,3,2,2,2,2,2,2,251,61,76,206,167,172,219,201,3,243,52
],[
2,2,3,2,2,2,2,2,2,112,51,52,66,22,15,118,60,39,37,157
],[
2,2,3,2,2,2,2,2,2,202,184,1,153,105,98,172,221,16,81,114
],[
19,20,152,232,14,73,199,46,0,106,192,114,237,186,198,181,95,236,215,210
],[
92,64,60,188,149,240,94,7,224,202,219,170,232,30,217,3,35,218,155,27
],[
5,244,82,44,116,8,53,96,123,67,211,220,66,127,168,253,62,175,239,225
],[
165,126,184,42,37,51,58,254,213,216,106,82,108,155,205,105,177,116,138,151
],[
50,8,195,75,57,206,37,77,252,112,190,67,20,116,15,122,48,27,99,227
],[
11,137,95,92,155,39,217,49,140,70,238,227,236,5,78,40,40,116,219,50
],[
55,249,115,52,21,243,9,35,115,158,251,186,173,55,159,192,252,96,31,141
],[
237,197,136,203,17,0,29,122,246,186,241,54,87,19,181,189,144,68,206,172
],[
84,131,171,137,162,40,85,6,245,13,71,132,188,58,129,215,9,194,216,73
],[
141,232,144,225,196,134,44,229,109,176,133,157,61,148,26,90,212,164,167,183
],[
240,248,249,31,225,237,0,143,61,19,38,157,212,70,223,186,230,26,129,180
],[
148,125,87,127,149,151,240,52,42,245,189,90,84,231,220,101,68,38,46,124
],[
19,186,175,127,179,27,7,73,38,151,92,50,237,243,107,216,196,85,215,32
],[
140,98,192,119,137,163,152,94,205,45,50,37,244,129,28,246,18,177,47,22
]
]