aLevelData = [
[
4,2,5,5,2,2,2,2,2,75,232,66,149,167,190,65,85,113,133,193
],[
2,2,2,2,2,2,5,2,2,147,190,203,170,231,212,141,149,212,63,249
],[
2,2,2,2,2,2,3,3,3,133,167,34,120,209,162,204,236,101,90,139
],[
3,3,3,3,3,3,3,2,2,54,43,94,197,252,195,25,68,169,122,250
],[
2,2,3,2,2,2,2,2,2,210,181,122,210,6,38,62,125,93,87,73
],[
13,2,3,2,2,2,2,2,2,196,140,248,24,130,21,86,85,6,25,220
],[
2,5,3,2,2,2,2,2,2,77,185,109,218,164,0,240,134,71,100,27
],[
2,12,3,2,2,2,2,2,2,65,163,241,217,27,21,219,153,152,161,104
],[
162,181,230,9,167,38,81,202,156,226,146,237,200,225,76,210,26,36,17,27
],[
192,247,141,13,246,115,1,56,28,70,244,90,12,183,37,129,170,228,195,112
],[
189,78,224,68,253,152,36,87,108,140,190,101,234,95,160,237,4,54,236,218
],[
14,232,169,99,113,6,187,48,69,25,18,190,35,42,33,4,52,136,146,87
],[
142,197,56,139,193,2,69,91,172,108,189,10,150,7,42,75,122,171,146,95
],[
161,76,166,125,118,126,60,118,151,55,255,153,40,215,101,212,108,103,226,29
],[
150,30,92,16,220,42,222,218,206,173,144,85,230,5,231,116,96,80,25,226
],[
75,47,212,230,225,203,47,138,20,22,225,252,105,84,176,52,9,217,45,215
],[
22,20,159,92,59,204,61,109,135,170,160,144,123,248,119,6,97,168,125,243
],[
224,152,168,192,206,20,163,190,69,157,127,12,249,232,166,186,200,42,16,46
],[
147,147,185,199,77,24,82,193,81,118,54,89,249,116,161,49,108,104,28,245
],[
183,252,60,63,32,50,140,184,182,166,200,129,45,20,76,209,233,25,203,223
]
]