aLevelData = [
[
4,2,2,2,2,196,180,189,6,46,34,172,199,124,190,136,100,88,88,113
],[
2,2,3,2,9,201,6,245,226,215,244,26,228,197,147,71,130,192,102,193
],[
2,3,2,2,2,124,213,89,148,64,17,83,217,21,231,14,53,154,209,39
],[
2,3,2,2,2,162,111,58,113,114,50,156,143,145,173,230,194,10,77,32
],[
2,3,2,2,3,255,204,214,81,69,175,86,161,45,178,88,187,195,134,89
],[
2,3,2,3,2,117,148,81,128,179,8,172,137,136,242,237,3,159,102,172
],[
2,2,3,2,2,187,218,203,128,120,56,48,10,232,252,228,53,219,12,64
],[
2,2,2,2,3,187,175,151,200,236,11,250,115,171,209,229,70,185,77,185
],[
2,2,2,3,2,39,54,179,53,241,100,200,82,196,175,223,107,159,234,7
],[
2,2,3,2,2,161,48,220,131,126,234,251,122,217,89,119,240,249,178,122
],[
2,2,5,2,3,245,253,175,175,28,122,153,1,47,103,166,165,33,54,134
],[
2,2,2,3,2,90,68,68,57,239,188,115,35,6,52,21,98,25,208,13
],[
2,2,3,2,5,95,186,98,48,163,31,224,242,237,221,22,62,129,244,152
],[
2,3,2,2,3,165,194,12,251,187,3,254,68,190,155,150,161,121,55,152
],[
2,2,2,3,2,87,104,117,0,252,29,174,142,230,226,18,130,227,160,251
],[
165,42,0,123,136,146,207,55,16,2,167,121,50,41,204,128,252,111,84,27
],[
213,43,139,118,5,22,149,51,120,0,85,188,190,193,142,216,87,115,72,125
],[
46,222,118,230,99,52,213,228,77,255,23,121,192,87,65,163,139,88,82,118
],[
69,211,37,109,74,68,152,2,0,4,238,124,95,192,114,9,176,42,93,12
],[
148,238,250,184,73,232,8,222,41,148,96,3,115,198,216,182,78,155,102,33
]
]