aLevelData = [
[
6,2,2,2,2,2,2,2,2,2,2,2,231,22,133,241,111,224,65,181
],[
2,2,2,2,2,2,2,2,2,2,2,2,126,226,234,231,164,124,54,242
],[
2,2,2,2,2,2,2,2,2,2,2,2,240,147,69,12,16,41,223,105
],[
3,3,3,3,3,3,3,3,3,3,3,3,185,49,254,174,74,161,140,168
],[
2,2,2,2,2,2,2,2,2,2,2,2,172,200,109,62,124,226,192,164
],[
2,2,2,2,2,2,2,2,2,2,2,2,108,234,98,210,230,175,180,53
],[
2,2,2,2,2,3,2,2,3,2,2,3,243,42,159,164,92,15,213,149
],[
2,2,3,3,3,3,3,3,3,3,3,3,15,162,89,145,195,204,65,229
],[
2,2,2,2,2,2,2,2,2,2,2,2,223,110,187,155,152,245,78,168
],[
2,2,2,2,2,2,2,2,2,4,2,2,90,47,98,103,106,93,3,70
],[
3,3,3,3,3,3,3,3,3,3,3,3,201,137,226,192,91,25,156,139
],[
2,2,2,2,2,2,2,2,2,2,2,2,72,165,63,18,163,6,11,37
],[
2,2,2,2,2,2,2,2,2,2,2,2,74,175,117,239,13,65,114,41
],[
2,2,3,3,3,3,3,3,3,3,2,3,18,89,241,142,119,172,169,143
],[
2,2,3,2,2,2,2,2,2,2,2,3,58,87,22,71,86,112,190,177
],[
47,225,185,25,48,118,112,208,179,52,165,36,33,237,180,143,90,17,24,47
],[
87,199,48,118,14,60,67,35,149,59,195,113,139,255,206,142,180,69,250,78
],[
227,165,82,33,29,33,156,67,251,255,222,50,80,212,32,101,12,226,114,59
],[
96,163,49,50,35,166,135,89,117,154,49,8,162,169,133,206,73,7,179,171
],[
189,202,75,127,171,252,255,195,253,238,171,119,255,208,146,91,192,127,234,98
]
]