aLevelData = [
[
2,2,2,2,2,2,2,2,2,2,2,2,2,2,2,2,2,2,2,44
],[
2,2,2,2,2,2,2,2,2,2,2,2,2,2,2,2,2,2,2,230
],[
2,2,2,2,2,2,2,2,2,2,2,2,2,2,2,2,2,4,2,56
],[
2,2,2,13,2,2,2,2,2,2,2,2,2,2,2,2,2,2,2,109
],[
2,2,2,2,2,2,2,2,2,2,2,2,2,2,2,2,2,2,2,63
],[
2,2,2,2,2,2,2,2,2,2,2,2,2,2,2,2,2,2,2,172
],[
2,2,2,2,2,2,2,2,2,2,2,2,2,2,2,2,2,2,2,45
],[
2,2,2,2,2,2,2,2,2,1,2,2,2,2,2,2,2,2,8,3
],[
2,2,11,2,2,2,2,2,2,2,2,2,2,2,2,2,2,2,2,98
],[
2,2,2,2,2,2,2,2,2,2,2,2,2,2,2,2,2,2,2,207
],[
2,2,2,2,2,2,2,2,2,2,2,2,2,2,2,2,2,2,2,96
],[
2,2,2,2,2,2,2,2,2,2,2,2,2,2,2,2,2,2,2,208
],[
2,2,2,2,2,2,2,2,2,2,2,2,2,2,2,2,2,10,2,4
],[
2,2,2,2,2,2,2,2,2,2,2,2,2,2,2,2,2,2,2,16
],[
2,9,2,2,2,2,2,2,2,2,2,2,2,2,2,2,2,2,2,98
],[
2,2,2,2,2,2,2,2,2,2,2,2,2,2,2,12,2,2,2,185
],[
2,2,2,2,2,2,2,2,2,2,2,2,2,2,2,2,2,2,2,195
],[
2,2,2,6,2,2,2,2,2,2,2,2,2,2,2,2,2,2,2,169
],[
2,2,2,2,2,2,2,2,2,2,2,2,2,2,2,2,2,2,2,86
],[
222,140,223,61,207,4,215,120,253,39,170,135,110,47,187,23,181,184,73,60
]
]