aLevelData = [
[
2,2,2,2,2,2,2,2,2,2,2,2,2,160,105,46,179,23,195,39
],[
2,2,2,2,2,2,2,2,2,2,2,2,2,237,56,50,165,85,152,135
],[
2,2,2,2,2,2,2,2,2,2,2,2,2,128,116,108,185,40,9,73
],[
2,2,2,3,3,3,3,3,3,3,3,3,3,145,140,88,47,166,58,196
],[
2,2,2,2,2,2,2,2,2,2,2,2,2,198,140,199,160,231,73,113
],[
2,2,2,2,2,2,2,2,2,2,2,2,2,67,94,8,3,90,239,18
],[
2,2,2,2,2,3,2,2,3,2,2,3,2,249,131,151,249,229,23,19
],[
2,2,2,3,3,3,3,3,3,3,3,3,3,22,17,70,167,54,102,106
],[
2,2,2,2,2,2,2,2,2,2,2,2,2,24,145,140,149,250,252,83
],[
108,50,95,82,57,179,104,206,59,139,129,221,65,35,0,202,119,194,158,188
],[
127,84,43,147,195,106,128,19,10,129,180,68,74,135,147,24,189,155,75,79
],[
55,21,105,152,183,198,4,249,60,129,56,112,218,217,215,219,12,45,90,21
],[
76,226,30,98,225,240,205,13,249,160,25,79,247,148,177,115,14,7,109,56
],[
15,86,204,119,127,191,161,5,237,105,9,219,130,165,160,116,218,116,245,119
],[
18,73,59,150,35,16,65,182,110,110,164,80,152,75,67,23,151,142,243,219
],[
13,39,116,173,213,83,164,68,220,27,243,159,51,30,23,236,98,145,1,169
],[
254,132,15,9,126,103,131,153,74,204,52,35,21,111,131,210,109,115,145,152
],[
144,238,175,205,130,168,22,25,92,32,217,147,231,208,23,42,105,178,117,69
],[
191,3,203,166,172,71,30,148,113,141,207,57,158,244,17,73,39,110,160,228
],[
186,196,177,190,80,219,36,125,3,53,1,98,31,186,34,44,123,185,45,57
]
]