aLevelData = [
[
2,2,2,2,2,11,2,2,2,2,2,20,180,91,8,138,24,30,42,25
],[
2,2,2,2,2,2,2,2,2,2,2,196,75,80,232,214,217,156,93,171
],[
252,134,225,154,5,47,227,226,131,241,31,224,175,59,32,134,7,156,3,8
],[
56,29,127,216,65,212,34,213,214,182,221,192,2,173,195,239,17,235,14,69
],[
173,125,99,97,71,35,87,22,185,95,49,27,41,204,241,4,48,177,146,113
],[
59,214,141,134,50,150,158,155,88,54,202,52,115,117,161,51,44,100,193,76
],[
184,120,155,186,184,222,122,48,94,14,193,19,210,163,115,230,212,106,249,6
],[
162,185,32,151,28,2,98,190,38,167,102,16,78,16,202,75,175,252,31,68
],[
20,20,53,33,97,198,153,200,47,80,93,152,183,27,23,86,241,75,44,106
],[
253,148,79,75,193,79,68,56,212,205,234,41,154,235,120,5,177,230,7,21
],[
140,113,81,185,94,5,184,89,58,121,138,159,120,210,131,227,90,92,147,231
],[
240,250,226,197,56,186,18,37,138,172,196,179,51,245,93,209,97,31,10,136
],[
63,179,1,197,96,10,10,194,97,96,62,194,202,42,15,1,54,169,137,235
],[
180,192,216,140,108,3,9,72,134,16,21,204,71,34,27,68,125,227,237,206
],[
30,130,206,47,44,6,122,198,219,226,103,190,246,201,75,135,127,195,222,134
],[
150,129,225,11,155,237,95,132,151,6,51,241,216,235,202,152,220,53,42,250
],[
113,138,51,5,25,112,37,139,179,94,99,243,88,25,119,47,132,62,85,238
],[
118,26,228,18,217,194,186,100,163,96,39,134,62,204,118,42,230,92,111,130
],[
82,252,33,247,150,129,222,30,72,58,134,232,225,200,9,25,103,48,39,251
],[
73,47,122,83,139,206,183,148,34,53,49,83,162,196,158,251,22,96,30,194
]
]