aLevelData = [
[
2,112,49,223,116,134,212,142,227,13,0,252,248,229,111,20,205,84,151,120
],[
2,69,64,25,94,146,162,92,157,250,55,117,7,218,121,75,250,235,205,248
],[
3,50,196,254,114,225,160,234,106,2,98,123,116,234,214,217,105,32,58,222
],[
2,9,110,253,203,229,56,198,57,125,13,184,82,165,124,245,64,45,41,96
],[
3,230,192,32,168,206,13,104,130,99,37,220,53,97,36,54,92,137,20,109
],[
2,231,153,14,65,100,123,162,19,125,189,122,251,193,65,57,21,167,54,169
],[
3,27,207,70,22,57,140,17,245,28,160,219,202,77,70,129,72,189,118,178
],[
185,161,100,91,160,127,74,99,157,137,103,153,146,43,71,235,4,224,70,216
],[
196,73,80,40,206,128,234,218,113,170,118,94,176,203,178,4,233,223,131,181
],[
180,38,241,225,14,191,114,184,183,120,107,157,216,229,244,215,233,175,220,138
],[
210,47,236,230,80,59,112,159,155,64,244,157,70,145,76,244,102,255,215,22
],[
246,170,4,72,122,23,20,82,227,130,34,123,179,117,97,180,97,153,166,20
],[
255,205,38,132,26,117,128,188,226,20,254,110,138,30,23,192,242,7,57,0
],[
132,160,198,147,92,163,93,47,171,140,90,75,93,171,160,211,249,120,150,31
],[
201,38,111,38,60,123,175,239,136,222,234,73,147,178,207,188,20,226,102,191
],[
245,189,150,43,253,5,234,240,171,66,149,7,101,92,179,168,210,105,209,188
],[
132,196,176,149,218,95,70,221,36,90,6,204,9,212,97,158,38,1,141,69
],[
248,124,133,91,252,223,81,90,20,146,135,15,45,224,18,76,31,80,50,222
],[
212,50,196,190,173,120,196,140,33,199,16,56,168,206,110,3,215,215,209,166
],[
204,155,216,208,204,91,152,214,43,44,155,166,108,147,40,254,170,81,197,219
]
]