aLevelData = [
[
5,113,37,128,248,35,89,70,196,170,71,48,35,116,118,63,102,159,90,164
],[
5,70,14,26,120,203,189,151,173,109,81,169,69,122,244,171,193,183,95,59
],[
5,221,74,56,59,122,215,159,27,220,234,4,91,21,149,59,75,193,90,210
],[
2,22,244,74,162,254,113,111,164,233,29,104,6,29,179,83,126,72,184,240
],[
2,223,195,178,2,234,23,149,249,102,193,126,207,115,50,163,48,27,26,138
],[
2,221,42,230,122,82,63,135,48,167,36,118,210,180,91,245,41,120,249,151
],[
4,10,188,184,2,21,243,71,244,163,101,228,132,249,140,45,171,194,190,51
],[
2,2,188,13,209,205,177,108,60,57,169,19,218,226,94,36,88,152,240,142
],[
2,247,99,218,49,38,196,37,68,86,62,219,244,10,21,191,78,45,86,59
],[
2,95,169,23,154,154,53,0,119,122,110,11,117,104,42,135,49,222,9,99
],[
2,117,205,77,169,175,60,235,73,161,50,225,24,89,215,203,24,100,214,177
],[
2,250,63,5,36,225,14,72,137,105,144,179,180,232,83,238,185,244,36,222
],[
2,254,37,202,129,149,27,244,26,201,195,111,143,247,215,156,15,160,164,34
],[
2,247,187,16,224,247,80,219,38,113,66,37,36,33,109,49,162,3,240,104
],[
2,242,113,204,161,35,140,175,159,120,222,10,219,24,62,105,132,7,243,4
],[
2,197,85,28,145,70,150,79,93,245,146,128,155,6,61,36,252,56,233,151
],[
2,128,91,186,187,139,15,90,227,59,206,239,239,249,45,74,184,78,94,97
],[
2,174,248,250,0,191,62,253,187,123,128,19,39,118,18,18,74,238,75,199
],[
2,79,174,216,245,126,50,86,155,108,12,33,118,111,135,102,199,85,137,128
],[
86,86,190,129,183,70,242,14,204,16,191,113,139,95,105,233,1,158,6,68
]
]