aLevelData = [
[
6,2,8,2,9,2,10,2,11,3,2,2,5,2,2,55,144,69,214,70
],[
2,2,2,2,2,2,2,2,12,3,5,2,2,2,5,254,105,97,4,233
],[
2,2,3,3,3,3,3,3,3,3,2,2,3,3,3,124,239,69,163,22
],[
2,2,3,2,2,2,2,2,2,2,5,2,3,2,2,8,130,146,150,225
],[
2,2,3,2,2,2,2,2,2,2,2,2,3,2,2,44,51,20,129,64
],[
2,2,3,2,3,3,3,3,3,3,2,5,3,2,2,95,151,34,28,206
],[
2,2,3,2,2,2,2,5,5,3,2,2,3,2,2,136,218,145,217,103
],[
2,2,3,5,5,5,2,3,3,3,5,2,3,3,3,122,57,132,189,183
],[
2,2,2,2,2,2,2,2,2,2,2,2,5,2,2,11,187,82,135,44
],[
2,3,2,2,3,1,3,2,2,2,2,2,5,2,2,220,159,206,8,118
],[
134,58,162,81,65,107,40,174,153,88,203,207,88,238,206,186,0,250,220,59
],[
189,72,158,40,153,12,141,232,239,130,5,54,34,210,155,35,142,54,177,90
],[
191,94,72,168,225,20,21,188,120,28,214,43,82,94,230,183,185,71,15,208
],[
237,108,160,91,209,112,192,179,228,40,2,237,115,254,58,97,13,147,142,101
],[
56,169,208,92,98,63,11,240,26,253,91,155,128,211,2,108,250,222,185,8
],[
41,139,68,239,28,254,73,0,195,181,98,64,166,104,113,215,214,52,52,91
],[
36,249,25,81,146,1,83,241,7,226,45,42,71,165,158,230,33,39,30,143
],[
235,192,185,210,43,35,98,163,151,133,137,129,64,2,240,251,10,60,186,115
],[
95,69,197,34,36,191,57,92,236,65,97,21,108,253,186,165,48,160,74,200
],[
140,122,51,233,212,223,136,160,207,205,95,121,106,206,40,247,170,32,61,216
]
]