aLevelData = [
[
2,2,2,2,2,2,2,2,101,201,163,177,166,156,171,91,161,254,205,92
],[
2,2,2,2,2,2,2,2,169,5,153,149,107,187,193,124,209,114,33,20
],[
2,2,3,2,3,2,2,2,39,87,252,29,125,74,137,135,76,237,174,45
],[
2,2,3,2,3,2,2,2,92,251,11,192,228,220,58,1,244,118,85,52
],[
2,2,3,2,3,2,2,2,16,69,185,209,29,174,10,124,130,144,120,55
],[
2,2,3,2,2,2,2,2,135,29,64,215,0,232,117,180,48,62,0,165
],[
2,2,3,2,3,3,3,3,232,186,230,44,239,20,201,237,166,58,178,101
],[
2,2,3,2,2,2,2,2,236,162,13,216,64,222,245,139,37,113,178,52
],[
2,2,3,2,3,3,3,3,203,225,128,175,235,13,146,242,243,193,87,67
],[
2,2,3,2,2,2,2,2,99,136,252,169,119,193,50,160,6,245,49,16
],[
170,104,253,128,33,238,232,135,243,0,88,132,85,15,202,143,78,24,23,176
],[
24,121,246,78,201,3,195,234,51,80,127,13,8,87,23,126,66,61,233,185
],[
193,111,132,157,54,237,175,101,65,233,174,217,214,144,192,197,229,40,236,171
],[
58,91,253,181,162,210,204,237,79,6,189,176,125,83,140,96,86,79,74,90
],[
19,89,162,40,101,117,97,247,19,87,54,75,228,189,181,241,191,2,162,54
],[
17,240,109,86,111,215,249,55,125,219,161,87,14,146,125,3,140,207,225,203
],[
155,184,39,50,249,31,175,170,168,15,35,191,80,164,0,146,223,32,82,137
],[
114,60,191,69,120,188,198,212,20,70,73,40,196,116,73,200,65,40,242,198
],[
166,32,215,241,211,202,126,75,20,89,31,190,254,24,169,10,154,254,6,2
],[
198,131,160,248,215,179,36,118,131,129,134,47,255,93,69,52,100,9,240,107
]
]