aLevelData = [
[
6,2,2,2,2,177,91,173,253,168,131,78,5,12,41,43,73,243,152,169
],[
163,159,158,183,95,1,248,104,75,125,11,225,13,237,213,118,185,232,34,16
],[
163,68,3,210,114,217,124,252,118,136,125,15,60,125,19,50,95,176,224,212
],[
160,178,201,147,57,166,238,92,111,141,223,212,103,200,13,247,58,215,126,255
],[
75,103,197,136,217,140,50,241,208,75,70,5,229,91,105,219,225,44,223,250
],[
61,41,249,193,240,59,136,7,133,142,151,254,112,151,90,93,162,86,97,190
],[
91,216,17,68,64,1,85,130,173,136,145,152,76,67,216,159,231,165,94,72
],[
122,133,48,191,141,32,34,214,192,98,9,95,168,97,43,217,217,43,244,80
],[
68,193,235,126,196,99,228,54,243,14,118,3,66,68,175,12,73,11,7,58
],[
91,56,147,157,94,237,123,12,217,97,174,12,79,223,212,244,204,18,133,78
],[
189,127,184,127,4,83,126,171,76,95,240,211,154,97,101,64,37,133,233,37
],[
104,43,235,128,117,235,54,65,140,214,35,174,236,255,12,6,233,59,3,100
],[
63,36,196,231,166,100,233,16,167,48,93,107,173,18,19,114,95,236,248,174
],[
45,58,38,31,41,151,90,222,25,131,168,1,202,99,109,191,167,201,134,213
],[
137,246,191,39,209,157,142,171,181,234,2,131,215,195,246,105,28,78,138,80
],[
187,179,212,72,148,35,210,163,196,25,163,86,118,223,247,162,251,85,197,243
],[
30,238,60,8,177,251,251,84,108,44,132,164,248,83,238,3,70,108,219,218
],[
37,219,170,92,20,244,238,33,84,192,30,17,66,254,142,132,228,105,157,168
],[
194,57,48,34,247,236,96,248,135,70,112,174,243,151,2,175,11,60,138,239
],[
4,104,2,207,202,37,224,65,151,149,69,44,197,126,119,18,225,5,145,240
]
]