aLevelData = [
[
2,2,2,2,2,2,2,2,2,2,2,2,2,220,9,195,67,101,12,33
],[
2,2,2,2,2,2,2,2,2,2,2,2,2,55,165,61,2,122,108,117
],[
2,2,2,2,2,2,2,2,2,2,2,2,2,233,83,117,220,113,195,81
],[
2,2,2,13,2,2,2,2,2,2,2,2,2,11,225,194,161,109,1,204
],[
2,2,2,2,2,2,2,2,2,2,2,2,2,136,235,44,156,96,200,167
],[
2,2,2,2,2,2,2,2,2,2,2,2,2,56,172,201,49,45,78,154
],[
2,2,2,2,2,2,2,2,2,2,2,2,2,219,28,251,109,26,117,235
],[
2,2,2,2,2,2,2,2,2,1,2,2,2,228,27,131,213,49,86,169
],[
2,2,11,2,2,2,2,2,2,2,2,2,2,26,124,102,235,65,132,24
],[
2,2,2,2,2,2,2,2,2,2,2,2,2,175,163,138,194,197,103,107
],[
2,2,2,2,2,2,2,2,2,2,2,2,2,214,166,177,12,182,249,23
],[
250,202,92,85,82,209,96,65,223,116,213,1,131,33,73,123,216,22,203,13
],[
22,188,245,126,56,55,41,53,90,59,26,169,102,33,142,25,239,58,99,125
],[
93,99,208,188,75,217,238,31,45,79,119,6,54,62,205,218,121,125,62,66
],[
78,17,134,154,247,70,149,161,131,255,147,113,243,74,34,181,156,55,227,22
],[
204,235,59,246,176,240,87,97,117,207,109,64,174,225,69,208,246,98,249,83
],[
214,199,249,6,233,81,81,82,61,227,47,70,253,17,159,69,77,121,154,252
],[
118,86,63,151,67,82,96,53,171,156,64,153,175,59,155,34,134,162,231,253
],[
248,132,218,153,8,233,44,91,213,130,158,148,194,57,59,176,213,13,222,176
],[
93,29,244,218,216,2,131,174,19,98,108,29,147,194,237,246,52,156,105,161
]
]