aLevelData = [
[
4,2,54,241,154,191,224,254,148,178,171,243,238,54,163,192,171,216,112,124
],[
2,2,82,146,122,252,55,247,81,164,251,177,75,125,86,45,111,136,20,149
],[
2,2,145,82,94,255,191,201,59,228,220,78,87,211,139,11,2,102,79,135
],[
3,3,123,118,240,119,111,139,32,216,189,150,94,58,124,227,27,95,63,73
],[
2,2,27,4,151,164,31,255,218,133,193,138,35,39,159,223,154,165,187,5
],[
13,2,246,107,34,233,64,234,204,176,217,145,196,76,190,248,136,77,11,94
],[
2,5,179,250,190,85,217,161,190,188,179,43,28,238,124,243,152,57,154,217
],[
2,12,103,146,129,146,51,134,213,66,100,116,206,76,158,250,225,104,138,173
],[
5,2,157,247,218,13,211,148,135,184,249,236,93,221,208,207,186,244,69,135
],[
147,172,149,104,183,37,181,168,88,96,241,113,199,244,211,53,127,2,70,66
],[
101,106,251,150,78,63,12,244,194,121,224,55,0,234,78,231,65,116,5,10
],[
65,120,43,60,252,145,68,2,181,131,86,92,61,110,74,153,114,72,150,111
],[
6,137,25,75,130,40,70,230,138,199,133,25,98,43,214,242,177,238,184,7
],[
133,120,73,10,152,43,174,158,210,222,181,105,14,141,185,107,33,78,199,142
],[
24,135,254,126,194,95,60,186,111,114,247,236,246,201,104,118,253,9,239,77
],[
116,234,179,10,99,235,137,62,230,69,23,6,117,29,57,224,105,253,163,189
],[
188,133,200,88,17,94,251,197,244,112,212,77,98,85,214,121,140,13,78,109
],[
216,243,126,119,41,239,251,232,96,238,84,35,35,143,244,243,221,31,74,34
],[
5,200,39,71,164,5,103,223,17,89,211,159,255,65,70,9,186,103,15,62
],[
174,24,151,19,41,248,68,102,98,245,156,179,185,121,174,226,64,228,173,99
]
]