aLevelData = [
[
6,2,2,2,2,2,2,2,2,58,111,125,254,108,124,175,160,34,203,179
],[
2,2,2,2,2,2,2,2,2,1,252,139,207,220,24,112,179,182,53,77
],[
2,2,2,2,2,2,2,2,2,183,21,25,229,101,237,49,255,55,91,120
],[
3,3,3,3,3,3,3,3,3,184,161,149,153,29,82,34,88,249,184,70
],[
2,2,2,2,2,2,2,2,2,46,236,194,193,51,189,233,185,66,241,113
],[
2,2,2,2,2,2,2,2,2,244,87,157,236,74,59,120,1,90,100,52
],[
2,2,2,2,2,3,2,2,3,107,125,22,15,68,248,207,165,132,118,226
],[
2,2,3,3,3,3,3,3,3,8,197,181,98,18,73,127,65,250,61,220
],[
2,2,2,2,2,2,2,2,2,185,38,63,134,235,64,31,157,199,140,226
],[
2,2,2,2,2,2,2,2,2,156,43,121,13,140,79,118,32,119,96,6
],[
3,3,3,3,3,3,3,3,3,96,32,107,23,217,241,125,144,164,53,9
],[
2,2,2,2,2,2,2,2,2,41,102,135,137,127,25,138,104,104,15,219
],[
2,2,2,2,2,2,2,2,2,32,131,51,68,160,20,147,51,240,15,27
],[
106,23,115,163,247,61,217,45,103,13,77,103,55,93,92,120,139,17,110,248
],[
34,60,87,64,138,137,40,229,144,218,75,127,251,46,207,175,122,200,0,96
],[
218,142,59,76,124,175,0,194,7,136,73,167,90,201,26,188,197,211,90,30
],[
120,101,225,19,59,120,210,3,96,103,43,197,246,83,154,29,64,198,147,130
],[
102,150,159,36,105,13,247,45,92,70,81,71,210,218,250,95,147,189,37,169
],[
147,98,131,229,36,38,19,224,106,235,60,61,15,3,25,117,57,81,20,29
],[
185,170,182,104,134,129,189,236,105,196,111,169,249,1,47,71,202,205,78,159
]
]