aLevelData = [
[
6,2,8,2,9,2,10,2,11,3,2,2,5,2,2,2,5,2,2,4
],[
2,2,2,2,2,2,2,2,12,3,5,2,2,2,5,2,2,2,5,2
],[
2,2,3,3,3,3,3,3,3,3,2,2,3,3,3,3,3,3,2,2
],[
92,203,212,171,132,82,139,229,249,199,235,196,155,95,233,188,33,196,18,113
],[
174,94,197,27,165,209,160,47,191,199,56,60,91,239,13,18,21,70,189,42
],[
153,149,119,66,186,58,179,72,190,44,32,121,252,58,222,202,170,147,238,135
],[
240,139,231,58,64,156,234,206,234,171,215,244,235,141,193,198,6,202,160,170
],[
23,161,70,122,163,76,149,226,179,133,238,9,227,72,236,115,182,219,83,38
],[
44,12,67,11,151,186,178,152,170,150,25,172,211,43,108,186,203,28,80,42
],[
107,173,137,252,193,133,177,175,99,179,48,97,3,238,104,55,68,33,48,255
],[
204,39,132,20,154,210,122,130,154,51,120,107,119,21,165,170,177,203,157,181
],[
239,44,105,200,150,219,174,64,154,204,36,69,149,3,74,171,22,159,89,26
],[
59,24,118,109,130,197,43,89,220,161,24,79,3,78,230,163,14,90,125,237
],[
67,194,119,176,44,180,212,57,237,153,239,202,212,83,176,248,50,195,4,82
],[
105,143,138,67,71,34,144,58,146,244,61,7,228,11,15,137,185,194,137,134
],[
199,201,37,218,142,109,144,212,47,25,22,221,129,29,91,90,98,175,77,212
],[
75,47,86,86,40,176,214,23,102,179,208,89,77,53,228,145,144,237,125,200
],[
34,207,75,65,76,212,244,92,253,253,6,186,97,150,49,162,180,184,179,164
],[
89,17,19,124,38,231,18,57,3,91,223,158,179,235,138,200,241,59,187,17
],[
191,21,164,53,251,174,52,179,51,43,141,118,186,99,185,181,251,231,152,24
]
]