aLevelData = [
[
5,5,5,5,5,2,2,2,2,2,2,2,2,2,182,99,173,142,158,132
],[
5,2,2,2,2,2,2,2,2,2,2,2,2,2,5,155,124,30,217,120
],[
5,2,5,3,3,3,3,3,3,3,2,2,3,3,25,233,209,190,253,91
],[
2,2,5,2,3,2,2,2,2,2,2,2,3,2,96,162,216,119,74,109
],[
2,2,3,2,3,2,2,2,2,2,2,2,3,2,32,230,100,44,252,72
],[
2,2,3,2,3,3,3,3,3,3,2,2,3,5,155,168,97,204,56,152
],[
4,2,3,2,2,2,2,2,2,3,2,2,3,2,122,254,99,22,78,225
],[
2,2,3,2,2,3,3,3,3,3,2,2,3,3,229,80,157,62,50,128
],[
2,2,2,2,2,3,2,2,2,2,2,2,2,2,10,59,166,30,128,47
],[
15,83,206,181,108,178,148,0,244,35,99,110,90,31,32,95,80,35,169,71
],[
74,94,187,2,132,173,20,104,70,202,212,34,103,193,41,188,16,163,43,250
],[
194,125,5,112,154,139,86,77,212,170,215,120,143,12,61,222,207,47,97,10
],[
200,16,158,246,90,156,122,32,216,103,137,225,13,160,143,250,129,69,229,112
],[
248,147,30,155,60,193,233,121,28,237,57,72,181,87,164,83,240,205,9,12
],[
76,102,118,91,222,115,73,54,150,179,149,114,195,198,199,216,217,228,137,124
],[
114,207,230,74,148,6,175,226,50,60,30,166,245,8,186,16,60,222,122,74
],[
97,62,45,248,62,43,25,88,239,223,227,142,218,189,175,57,237,135,135,74
],[
39,209,1,22,90,182,28,170,47,201,108,94,106,78,119,173,111,171,94,67
],[
5,25,192,88,91,159,219,61,73,65,244,52,215,117,249,133,3,214,102,206
],[
191,28,101,155,58,76,57,54,96,44,220,193,164,250,231,129,253,93,179,125
]
]