aLevelData = [
[
5,5,3,5,5,5,5,5,5,5,3,5,5,5,5,5,5,5,5,203
],[
4,2,3,5,5,5,5,5,5,5,3,5,5,5,5,5,5,5,5,111
],[
2,2,3,2,3,3,3,3,3,2,3,3,3,3,3,5,5,3,5,87
],[
5,2,2,2,3,2,2,2,2,2,5,5,5,5,5,5,5,3,5,24
],[
2,2,2,3,2,2,2,2,2,2,5,5,5,5,5,5,5,3,5,157
],[
2,2,2,3,2,2,5,3,3,2,3,3,3,3,3,5,5,3,5,36
],[
2,2,2,2,2,2,5,5,3,2,2,2,2,2,2,2,2,3,5,251
],[
5,2,2,2,2,2,5,5,3,2,2,2,2,2,2,2,2,3,5,31
],[
2,2,5,5,3,2,5,5,3,2,3,3,3,5,5,3,5,3,5,236
],[
2,2,5,5,3,2,5,5,3,6,3,3,5,5,5,3,5,3,5,71
],[
2,2,3,3,3,2,5,5,3,5,5,3,5,5,5,3,5,3,5,155
],[
100,239,12,42,93,83,51,250,99,27,137,47,92,170,177,116,151,30,36,236
],[
247,224,119,107,84,121,221,231,30,168,236,41,67,177,164,200,83,247,173,88
],[
227,205,224,223,47,138,9,136,3,219,235,156,219,94,133,173,73,108,148,21
],[
151,54,89,159,173,19,156,131,54,24,241,152,255,234,58,197,159,208,109,184
],[
93,12,152,219,78,108,34,132,190,28,83,109,209,190,22,99,106,188,254,66
],[
76,221,136,32,128,23,160,201,246,165,102,108,111,89,49,147,153,50,212,88
],[
124,49,33,214,22,105,172,223,66,86,210,237,223,111,249,90,45,254,24,211
],[
122,48,123,10,255,104,192,171,5,217,38,146,76,84,7,59,172,94,162,121
],[
253,134,30,107,53,246,204,172,208,71,173,203,117,154,52,251,214,228,76,11
]
]