aLevelData = [
[
2,2,2,2,2,11,2,2,2,2,2,2,2,2,9,2,2,203,45,153
],[
205,58,129,243,249,69,248,7,149,38,115,126,184,109,208,16,66,71,26,239
],[
181,255,252,99,71,197,124,177,53,175,230,66,89,253,5,1,255,161,153,5
],[
245,255,6,112,225,241,74,151,215,14,49,99,43,44,204,247,132,35,31,146
],[
50,212,26,183,194,106,203,140,207,224,209,129,27,196,20,49,222,58,179,141
],[
93,67,62,55,191,63,38,44,28,177,113,166,216,67,178,65,47,10,57,92
],[
16,10,135,194,47,253,5,138,86,80,245,59,251,111,168,52,24,66,241,75
],[
55,247,219,181,204,3,151,38,200,99,184,56,107,40,163,17,90,50,64,64
],[
241,60,246,233,218,25,215,34,223,60,23,156,252,126,195,134,185,28,175,174
],[
183,255,177,234,136,65,12,182,195,236,47,30,88,5,160,223,34,201,51,201
],[
187,54,127,103,148,205,146,226,69,151,228,35,33,102,138,56,14,93,172,249
],[
148,178,57,235,51,179,217,100,250,7,36,240,85,55,17,244,39,109,177,145
],[
24,123,29,203,49,30,173,235,166,132,106,33,242,13,198,110,41,79,139,193
],[
138,92,18,97,84,71,181,138,220,228,134,91,219,208,66,240,12,177,128,203
],[
247,191,46,120,7,132,62,112,227,223,157,63,251,79,101,226,97,110,83,115
],[
219,188,123,8,54,158,58,216,221,167,109,159,170,21,224,68,251,159,10,185
],[
9,110,247,36,117,105,133,60,36,181,211,245,77,124,247,95,208,238,239,203
],[
202,134,218,49,102,143,105,206,246,230,144,17,66,1,129,184,31,48,218,55
],[
68,35,29,89,90,173,98,41,82,199,72,19,251,216,49,71,212,52,175,94
],[
31,226,57,64,54,162,35,69,34,46,205,154,106,193,26,231,41,214,35,46
]
]