aLevelData = [
[
10,2,2,8,2,2,2,2,2,168,155,43,177,49,107,190,47,77,146,25
],[
2,2,2,2,2,2,2,2,2,239,217,200,34,15,9,197,198,150,91,95
],[
2,2,2,2,2,2,3,3,3,144,181,201,242,122,77,67,4,3,176,92
],[
9,2,2,2,2,2,2,2,2,41,129,172,68,37,185,198,246,81,173,195
],[
3,3,3,3,3,3,3,2,2,178,64,181,109,174,161,209,147,9,103,62
],[
2,2,2,2,2,2,2,2,2,82,0,40,71,147,100,195,94,213,75,70
],[
2,2,2,2,2,2,2,2,2,107,45,7,15,100,138,84,49,30,62,213
],[
2,2,2,2,2,2,2,2,2,25,99,186,194,113,68,153,219,68,176,225
],[
2,2,2,2,2,2,2,2,2,160,99,70,133,195,8,104,46,222,186,145
],[
2,2,2,2,3,3,3,3,2,58,98,112,232,5,207,249,21,104,43,155
],[
2,2,2,2,3,2,2,3,2,83,128,173,251,198,177,185,60,16,234,17
],[
2,2,2,2,3,2,2,3,2,107,31,42,73,27,72,67,123,76,154,222
],[
2,2,2,2,3,2,2,3,2,61,146,108,191,208,115,57,74,154,16,174
],[
2,2,2,2,3,2,2,3,2,70,214,8,0,226,139,153,131,245,186,8
],[
2,2,2,2,3,2,2,3,2,121,138,220,67,39,156,140,198,47,30,128
],[
2,2,2,2,3,2,2,3,2,187,25,63,189,101,51,235,11,190,155,149
],[
167,95,154,52,57,161,51,139,5,2,252,174,101,202,45,194,119,238,247,4
],[
19,52,23,13,0,152,170,84,103,238,67,244,135,202,59,175,171,157,72,51
],[
89,32,81,157,205,246,129,60,166,141,155,151,222,69,141,177,255,212,71,139
],[
148,233,205,235,222,15,139,92,201,212,234,118,30,43,32,95,250,16,76,146
]
]