aLevelData = [
[
5,5,5,5,5,2,2,2,2,2,2,2,2,2,106,224,62,80,72,198
],[
5,2,2,2,2,2,2,2,2,2,2,2,2,2,77,34,25,194,70,174
],[
77,217,44,189,31,164,66,84,16,246,32,123,148,192,7,66,11,49,114,6
],[
242,33,237,241,91,175,42,192,154,41,82,201,66,45,153,60,80,14,21,169
],[
165,121,208,194,186,89,28,99,143,247,38,207,228,102,206,61,172,30,182,147
],[
191,231,153,113,207,249,223,113,157,97,110,173,108,166,194,130,182,173,64,148
],[
31,218,199,18,167,120,137,60,35,91,25,34,238,195,196,174,220,132,37,228
],[
111,100,244,105,78,197,31,66,242,132,28,223,163,32,125,88,163,31,197,246
],[
169,173,122,245,144,135,123,136,81,23,148,30,47,224,80,228,49,29,14,139
],[
213,165,87,75,3,18,111,40,64,34,42,116,36,94,1,149,14,249,101,8
],[
22,250,84,166,67,158,41,38,255,247,184,228,199,218,154,224,39,248,198,10
],[
230,75,97,189,126,180,216,137,206,226,43,53,19,117,140,4,21,99,40,56
],[
158,155,69,213,48,233,141,167,247,26,169,134,253,96,18,217,157,248,36,89
],[
58,9,117,24,49,208,100,193,11,250,245,33,248,81,220,230,121,155,215,167
],[
92,191,65,37,237,42,229,209,107,113,16,142,185,56,234,183,86,82,5,100
],[
143,42,55,233,243,97,165,160,8,184,33,233,60,49,182,110,30,113,128,172
],[
206,105,193,175,178,53,50,28,107,68,151,117,8,186,150,153,121,18,201,138
],[
70,8,18,115,129,182,47,234,249,253,142,114,176,38,98,68,143,201,246,79
],[
89,238,65,125,222,115,188,56,113,174,112,45,155,82,83,79,17,151,212,31
],[
228,149,181,43,248,241,25,213,183,188,222,86,6,152,44,3,120,29,78,206
]
]