aLevelData = [
[
2,2,2,2,2,2,2,2,2,2,2,2,2,2,2,98,4,175,106,182
],[
2,2,2,2,2,2,2,2,2,2,2,2,2,2,2,72,99,11,216,18
],[
2,2,2,2,2,2,2,2,2,2,2,2,2,2,2,180,79,168,21,150
],[
2,2,2,13,2,2,2,2,2,2,2,2,2,2,2,43,209,155,58,214
],[
2,2,2,2,2,2,2,2,2,2,2,2,2,2,2,68,39,42,137,229
],[
2,2,2,2,2,2,2,2,2,2,2,2,2,2,2,89,149,132,131,19
],[
2,2,2,2,2,2,2,2,2,2,2,2,2,2,2,231,81,14,218,157
],[
2,2,2,2,2,2,2,2,2,1,2,2,2,2,2,76,4,127,88,99
],[
2,2,11,2,2,2,2,2,2,2,2,2,2,2,2,45,254,48,27,136
],[
2,2,2,2,2,2,2,2,2,2,2,2,2,2,2,166,74,211,133,122
],[
2,2,2,2,2,2,2,2,2,2,2,2,2,2,2,173,77,116,216,81
],[
2,2,2,2,2,2,2,2,2,2,2,2,2,2,2,106,62,88,121,53
],[
2,2,2,2,2,2,2,2,2,2,2,2,2,2,2,83,247,67,35,227
],[
2,2,2,2,2,2,2,2,2,2,2,2,2,2,2,117,126,154,81,251
],[
2,9,2,2,2,2,2,2,2,2,2,2,2,2,2,187,175,229,1,167
],[
2,2,2,2,2,2,2,2,2,2,2,2,2,2,2,52,193,111,152,242
],[
2,2,2,2,2,2,2,2,2,2,2,2,2,2,2,22,2,101,51,151
],[
2,2,2,6,2,2,2,2,2,2,2,2,2,2,2,242,123,132,46,210
],[
2,2,2,2,2,2,2,2,2,2,2,2,2,2,2,45,184,238,183,76
],[
2,2,2,2,2,2,2,2,2,2,2,2,2,2,2,48,74,156,248,90
]
]