aLevelData = [
[
2,2,2,2,2,3,1,133,44,145,134,164,5,167,163,117,92,132,167,219
],[
2,2,2,2,2,25,190,224,183,41,228,180,175,43,97,237,46,108,163,85
],[
5,2,5,2,5,171,22,125,131,47,164,202,244,17,153,84,94,4,114,244
],[
5,2,5,2,5,64,85,217,250,190,109,27,206,172,157,220,216,233,27,10
],[
5,5,5,2,5,158,238,71,15,44,166,51,75,185,129,99,193,135,196,209
],[
5,2,5,2,5,16,11,35,52,166,78,145,130,48,147,87,180,84,58,99
],[
5,2,5,2,5,201,163,228,227,13,201,216,19,155,7,166,83,33,228,10
],[
2,2,2,12,2,125,227,31,18,117,3,231,131,2,255,78,122,220,123,252
],[
2,2,7,2,2,79,6,65,32,190,93,134,173,73,114,111,194,216,149,211
],[
105,163,50,67,133,81,97,71,6,97,184,235,95,202,99,122,58,222,119,138
],[
106,116,132,56,33,70,106,181,99,152,109,2,186,27,139,247,44,16,12,138
],[
106,176,92,78,74,204,22,58,119,177,97,172,103,78,127,173,142,153,163,119
],[
210,46,3,53,62,57,47,9,250,151,161,83,123,56,149,49,247,200,27,66
],[
28,142,106,176,1,148,119,109,93,8,198,188,247,226,128,244,93,199,199,128
],[
217,45,70,43,161,193,12,155,78,5,154,26,143,62,58,157,31,141,147,254
],[
244,92,123,141,186,251,12,199,127,139,250,101,176,28,35,153,68,18,104,148
],[
55,205,188,75,58,137,122,123,169,130,252,234,189,92,105,241,3,195,206,55
],[
12,79,113,191,102,170,98,37,204,244,82,36,154,102,168,92,132,54,210,82
],[
134,187,217,185,30,210,57,240,186,128,239,203,108,217,211,150,229,32,40,87
],[
161,47,114,84,95,25,135,213,212,15,233,43,160,128,83,241,129,132,146,146
]
]