aLevelData = [
[
10,2,2,8,2,2,8,9,51,163,63,149,70,132,134,61,19,20,54,78
],[
2,2,2,2,2,2,190,176,201,165,200,169,215,205,156,143,69,103,100,175
],[
2,2,2,2,2,2,185,207,33,218,80,252,251,104,148,168,213,125,168,177
],[
9,2,2,2,2,2,37,139,198,192,3,24,236,40,128,194,209,17,56,128
],[
3,3,3,3,3,3,30,213,43,42,219,170,200,60,39,130,75,215,45,47
],[
2,2,2,2,2,2,73,8,83,203,137,77,180,87,22,85,209,162,146,8
],[
2,2,2,2,2,2,131,108,205,199,53,204,151,245,79,207,210,182,245,98
],[
2,2,2,2,2,2,203,246,242,114,202,174,239,81,231,98,233,92,32,239
],[
226,219,169,131,214,40,131,237,240,20,80,23,254,134,102,208,35,101,34,207
],[
203,184,126,245,228,12,230,211,76,22,72,108,133,154,107,60,176,140,129,121
],[
185,116,255,152,207,23,172,19,23,83,248,106,161,75,144,104,155,196,47,167
],[
196,207,183,86,36,169,128,58,251,223,240,243,247,181,76,129,169,201,205,6
],[
58,244,247,205,90,113,38,140,122,65,106,230,59,205,148,52,38,206,145,133
],[
157,106,247,227,17,159,222,217,118,229,241,50,244,15,197,2,224,115,105,235
],[
234,74,62,153,152,90,8,143,243,210,70,38,128,117,191,210,113,250,94,168
],[
29,179,63,29,174,110,10,17,25,153,128,12,84,169,83,199,195,188,59,238
],[
243,124,70,36,138,71,112,72,126,142,115,246,134,123,224,81,206,215,111,0
],[
239,42,147,119,30,36,82,120,163,59,84,217,142,150,58,135,165,42,49,203
],[
160,35,198,204,153,133,252,86,190,19,155,217,73,112,204,181,178,132,227,180
],[
34,33,124,216,44,230,201,88,184,100,42,229,63,128,254,49,62,24,186,178
]
]