aLevelData = [
[
2,2,100,217,208,152,42,231,200,139,251,176,246,163,17,151,3,112,7,219
],[
2,2,6,67,63,104,3,157,129,243,177,230,228,69,129,98,242,215,219,98
],[
3,2,7,160,171,183,250,43,28,108,255,236,163,181,204,212,64,34,251,35
],[
2,2,1,24,176,126,199,130,123,65,76,196,128,22,101,240,213,199,133,61
],[
3,2,43,80,131,181,177,57,157,45,53,34,188,122,140,160,250,226,53,71
],[
2,2,97,209,57,8,245,205,85,190,245,172,91,3,95,5,214,72,178,228
],[
3,2,237,37,247,194,138,237,2,180,187,134,246,226,88,119,7,59,230,67
],[
2,2,132,103,187,246,20,253,99,253,64,247,67,58,49,99,124,88,187,91
],[
2,3,18,92,155,54,78,125,253,0,96,54,66,40,73,153,255,121,248,230
],[
2,2,73,75,179,92,48,251,185,79,137,152,38,123,241,223,22,152,14,106
],[
3,3,13,47,24,36,151,171,152,0,43,179,112,235,85,183,28,255,21,201
],[
55,249,130,175,65,237,178,54,159,56,222,201,227,183,194,65,78,54,67,255
],[
147,43,84,56,222,165,26,145,21,127,78,236,94,217,228,129,225,200,234,48
],[
207,77,178,21,163,132,51,94,168,30,173,89,187,17,140,209,82,142,143,155
],[
189,52,41,108,172,131,40,238,242,147,148,18,136,6,218,167,213,59,41,44
],[
44,196,29,226,151,27,155,38,211,144,252,254,155,134,109,242,42,223,149,29
],[
251,181,121,131,211,75,157,165,1,67,108,83,228,17,218,194,175,175,72,222
],[
105,146,168,225,56,222,225,37,222,214,117,54,132,150,97,44,183,4,69,56
],[
176,4,196,124,216,235,46,32,139,55,92,162,28,125,220,109,26,162,79,174
],[
210,78,14,99,21,158,20,180,60,25,24,135,104,230,249,79,15,60,95,36
]
]