aLevelData = [
[
6,2,8,2,9,2,10,2,11,3,2,2,5,2,2,2,5,181,248,79
],[
2,2,2,2,2,2,2,2,12,3,5,2,2,2,5,2,2,88,194,234
],[
2,2,3,3,3,3,3,3,3,3,2,2,3,3,3,3,3,110,92,216
],[
2,2,3,2,2,2,2,2,2,2,5,2,3,2,2,2,2,130,89,193
],[
2,2,3,2,2,2,2,2,2,2,2,2,3,2,2,2,2,110,170,95
],[
2,2,3,2,3,3,3,3,3,3,2,5,3,2,2,2,2,112,93,40
],[
2,2,3,2,2,2,2,5,5,3,2,2,3,2,2,2,2,66,243,149
],[
2,2,3,5,5,5,2,3,3,3,5,2,3,3,3,2,2,126,138,125
],[
2,2,2,2,2,2,2,2,2,2,2,2,5,2,2,2,2,14,14,31
],[
2,3,2,2,3,1,3,2,2,2,2,2,5,2,2,2,2,42,2,130
],[
2,3,2,2,3,2,3,2,2,2,2,5,5,2,2,2,2,23,135,90
],[
2,3,2,3,2,2,2,3,2,2,2,2,5,2,2,2,2,107,205,85
],[
2,3,2,3,2,2,2,3,3,3,2,2,3,3,3,2,2,102,40,51
],[
2,3,2,3,2,2,2,3,2,2,5,2,5,2,2,2,2,138,208,10
],[
105,153,211,182,142,243,168,202,214,206,65,195,220,37,58,30,58,0,13,189
],[
88,245,133,141,129,239,117,102,60,46,169,50,217,143,29,82,74,14,109,61
],[
52,137,141,106,70,199,186,113,202,184,176,109,121,254,30,164,148,173,87,106
],[
48,79,74,66,210,44,180,71,59,200,148,202,133,172,224,61,111,105,118,79
],[
246,219,85,89,37,171,13,249,45,23,116,252,184,246,155,130,123,246,0,92
],[
10,41,5,185,241,192,161,2,0,22,86,2,230,240,99,74,2,3,58,212
]
]