aLevelData = [
[
6,2,8,2,9,2,10,2,11,3,2,2,5,2,2,2,104,234,241,36
],[
2,2,2,2,2,2,2,2,12,3,5,2,2,2,5,2,229,0,73,146
],[
2,2,3,3,3,3,3,3,3,3,2,2,3,3,3,3,116,10,71,131
],[
2,2,3,2,2,2,2,2,2,2,5,2,3,2,2,2,41,155,198,175
],[
229,223,209,72,42,33,22,150,45,145,151,223,45,69,163,137,4,125,5,130
],[
252,43,123,224,227,179,106,197,98,239,207,134,138,118,121,12,176,30,118,122
],[
123,191,203,15,59,58,104,79,124,186,90,93,220,58,67,172,25,72,7,214
],[
110,8,201,204,32,123,22,48,84,1,95,255,35,29,173,115,240,121,144,40
],[
249,42,88,125,45,52,136,61,62,81,136,127,246,238,154,202,206,119,15,125
],[
189,212,187,110,78,52,166,210,245,9,4,93,163,83,104,170,152,34,52,220
],[
121,86,84,134,162,170,44,200,189,241,206,187,147,159,113,15,35,138,31,243
],[
241,242,173,53,161,191,240,171,196,11,46,209,242,224,211,179,25,67,101,14
],[
20,113,186,178,128,104,105,42,203,169,126,159,141,61,114,250,28,246,90,73
],[
91,247,94,100,210,118,109,208,4,193,47,227,252,127,59,41,42,57,139,7
],[
109,25,44,158,113,241,58,242,59,126,12,76,2,239,172,221,65,161,138,163
],[
10,45,113,145,157,164,185,234,57,25,191,238,50,96,146,184,68,22,239,103
],[
39,225,112,124,99,249,0,131,102,232,146,246,212,142,19,94,30,103,156,187
],[
86,17,237,38,66,8,23,181,175,181,120,159,7,167,236,160,38,32,66,159
],[
106,211,237,143,9,236,252,147,168,81,77,101,41,39,253,248,196,153,34,92
],[
89,212,189,227,4,86,234,130,243,105,90,121,116,234,3,54,82,79,22,119
]
]