aLevelData = [
[
2,2,2,2,2,11,2,2,2,2,2,2,2,213,197,113,39,68,226,27
],[
2,2,2,2,2,2,2,2,2,2,2,2,2,99,32,220,191,0,243,167
],[
5,2,5,2,5,5,5,2,5,5,5,2,5,211,169,138,107,43,242,249
],[
5,2,5,2,5,2,5,2,5,2,5,2,5,125,28,236,223,141,226,248
],[
5,5,5,2,5,5,5,2,5,5,5,2,5,235,33,63,216,159,66,101
],[
5,2,5,2,5,2,5,2,5,2,2,2,5,12,84,116,22,91,127,236
],[
5,2,5,2,5,2,5,2,5,2,2,2,5,10,176,50,254,145,39,230
],[
213,121,104,119,102,50,52,112,166,48,61,137,251,145,59,110,241,0,60,194
],[
47,217,59,100,169,141,245,241,23,73,248,138,165,210,253,215,236,180,119,75
],[
33,155,108,170,140,1,132,201,60,9,96,150,250,171,44,87,123,18,120,55
],[
218,66,67,254,69,254,89,32,246,233,224,249,100,235,45,87,187,214,220,57
],[
138,74,31,214,188,214,86,225,202,95,224,12,47,198,49,203,27,197,37,90
],[
107,26,148,1,217,232,39,151,112,90,106,69,68,137,34,140,95,160,224,137
],[
254,62,214,120,254,27,234,120,145,239,9,141,53,143,190,235,231,89,3,114
],[
147,211,87,117,208,143,16,191,202,82,243,216,127,116,2,132,47,138,149,141
],[
13,67,172,194,59,144,132,64,245,8,104,240,13,138,202,81,151,36,146,120
],[
229,51,182,85,182,204,11,55,170,91,91,146,249,138,183,1,101,101,14,135
],[
109,187,255,26,196,199,236,98,1,15,80,190,152,141,82,136,9,13,154,154
],[
87,214,99,16,188,140,209,80,155,85,133,72,182,59,112,247,161,210,228,47
],[
119,26,241,153,203,166,238,249,225,254,86,179,30,67,214,143,190,17,163,185
]
]