aLevelData = [
[
5,5,3,5,5,5,5,5,5,5,3,5,5,5,177,183,226,91,241,95
],[
4,2,3,5,5,5,5,5,5,5,3,5,5,5,243,76,243,31,166,157
],[
2,2,3,2,3,3,3,3,3,2,3,3,3,3,2,35,70,252,108,147
],[
5,2,2,2,3,2,2,2,2,2,5,5,5,5,42,241,228,103,59,89
],[
2,2,2,3,2,2,2,2,2,2,5,5,5,5,37,125,176,21,216,232
],[
2,2,2,3,2,2,5,3,3,2,3,3,3,3,28,3,184,140,171,45
],[
2,2,2,2,2,2,5,5,3,2,2,2,2,2,244,232,168,65,212,50
],[
5,2,2,2,2,2,5,5,3,2,2,2,2,2,67,66,160,169,146,124
],[
2,2,5,5,3,2,5,5,3,2,3,3,3,5,190,39,213,189,26,245
],[
2,2,5,5,3,2,5,5,3,6,3,3,5,5,254,194,203,228,113,240
],[
2,2,3,3,3,2,5,5,3,5,5,3,5,5,243,153,8,69,230,41
],[
2,2,3,2,2,2,5,5,3,5,5,5,3,5,90,141,143,230,61,217
],[
2,2,3,2,2,2,5,5,3,5,5,5,3,3,16,120,137,45,169,47
],[
2,2,3,2,5,2,3,3,3,5,5,5,3,3,31,121,219,151,42,202
],[
2,2,2,2,5,2,3,5,5,5,5,5,5,3,205,77,165,194,238,18
],[
2,2,2,2,5,2,5,5,5,5,5,5,5,5,30,70,220,30,185,118
],[
2,2,3,3,3,2,3,3,5,5,5,5,3,5,133,182,119,226,140,1
],[
2,2,3,5,5,2,3,5,5,5,5,3,5,5,184,250,238,24,255,199
],[
229,92,246,217,12,12,178,129,196,23,55,64,215,46,63,126,92,30,55,127
],[
219,93,139,148,177,226,35,142,181,58,46,120,27,217,30,134,153,174,243,72
]
]