aLevelData = [
[
4,2,5,5,219,156,184,56,109,33,189,175,190,81,8,130,102,50,18,154
],[
2,2,2,2,187,153,240,7,159,168,202,160,157,150,143,234,53,174,231,60
],[
2,2,2,2,115,155,105,32,199,226,15,251,16,176,230,241,250,214,10,3
],[
3,3,3,3,138,18,210,122,247,144,72,137,188,176,220,46,235,10,89,89
],[
2,2,3,2,196,176,23,80,134,178,115,82,133,232,124,122,125,235,239,231
],[
13,2,3,2,38,101,102,26,8,139,204,159,145,231,20,240,101,91,42,150
],[
2,5,3,2,245,99,42,145,83,154,209,250,69,128,49,231,152,122,168,143
],[
2,12,3,2,182,26,18,175,123,161,62,44,69,194,159,249,74,169,68,59
],[
5,2,3,3,47,60,10,171,214,161,17,60,119,0,108,255,242,138,29,67
],[
11,2,3,2,99,186,64,0,247,218,134,118,255,202,229,17,67,253,142,144
],[
2,5,3,2,153,196,32,102,182,207,27,96,67,240,151,137,52,35,54,75
],[
2,10,3,2,85,204,87,214,37,63,140,198,232,133,79,255,248,94,240,220
],[
92,130,210,138,155,44,215,174,210,217,25,78,5,77,219,238,179,216,191,249
],[
173,215,57,99,40,125,67,141,16,212,82,105,159,254,137,222,47,193,45,110
],[
76,67,90,22,14,17,244,117,165,102,223,49,54,171,115,151,230,58,42,129
],[
52,103,156,125,139,193,174,43,23,149,6,231,217,180,194,168,246,118,105,40
],[
85,255,33,70,104,193,35,168,74,66,109,164,11,32,182,97,72,82,167,57
],[
254,176,72,98,159,182,185,206,102,133,34,79,232,42,236,255,237,35,50,223
],[
125,31,114,190,62,6,137,93,253,57,222,208,138,27,221,39,201,208,167,78
],[
6,69,7,50,137,112,169,37,106,217,134,132,167,89,163,151,116,33,251,184
]
]