aLevelData = [
[
2,2,2,2,2,2,43,192,225,143,70,19,69,145,244,39,236,46,164,194
],[
2,3,5,3,5,5,90,109,142,75,36,29,152,37,247,198,118,59,219,223
],[
2,3,2,3,2,2,22,220,185,65,59,202,27,220,104,141,52,169,255,13
],[
2,2,2,2,2,2,32,223,170,96,109,106,250,225,217,153,78,130,93,23
],[
2,3,5,3,5,5,247,99,107,28,153,163,117,228,212,118,174,97,36,119
],[
2,3,5,3,5,5,20,45,6,64,174,194,93,56,18,237,19,173,43,128
],[
2,5,5,5,5,5,3,35,57,72,23,235,25,62,173,247,199,1,64,236
],[
2,3,5,3,5,5,33,132,68,121,238,4,81,232,30,62,132,242,83,222
],[
2,3,5,3,5,5,35,216,161,58,127,175,146,64,31,251,110,173,26,128
],[
2,5,5,5,5,5,185,129,197,85,252,175,142,58,201,24,40,43,249,186
],[
2,3,5,3,2,2,233,54,56,37,112,137,196,47,138,207,113,233,87,189
],[
5,3,5,3,2,2,241,210,168,231,82,74,172,217,200,73,204,99,173,80
],[
211,52,198,160,82,170,200,171,67,233,26,200,236,43,221,42,6,87,42,19
],[
31,212,154,69,61,159,12,186,196,155,162,148,153,41,13,87,136,249,11,86
],[
227,32,45,107,108,106,222,235,117,241,161,217,70,238,154,90,191,208,80,105
],[
63,139,177,204,196,51,87,71,83,201,9,15,154,85,133,129,212,52,124,20
],[
237,180,223,141,230,222,89,114,124,147,29,192,4,219,225,224,154,121,42,216
],[
122,195,203,191,174,176,168,115,234,51,192,142,180,199,107,149,199,75,223,115
],[
186,17,249,38,221,50,59,185,100,36,17,114,199,142,88,76,104,90,32,167
],[
119,12,177,63,18,83,205,91,177,222,53,71,194,113,111,3,144,56,197,61
]
]