aLevelData = [
[
2,2,2,2,2,2,2,2,116,146,169,191,92,23,157,150,253,0,194,208
],[
2,3,5,3,5,5,5,3,151,155,245,99,150,179,172,128,185,29,55,198
],[
2,3,2,3,2,2,2,3,115,142,70,181,146,176,172,101,30,116,98,120
],[
2,2,2,2,2,2,2,2,132,169,207,77,243,206,70,118,7,36,209,109
],[
2,3,5,3,5,5,5,3,165,8,45,130,38,128,21,24,183,20,196,17
],[
2,3,5,3,5,5,5,3,255,223,181,135,3,229,173,189,71,167,251,85
],[
2,5,5,5,5,5,5,5,54,245,254,195,196,4,233,1,82,192,195,132
],[
2,3,5,3,5,5,5,3,210,99,178,112,43,71,120,8,223,248,62,104
],[
2,3,5,3,5,5,5,3,235,142,145,118,239,58,170,22,142,30,242,157
],[
2,5,5,5,5,5,5,5,24,98,197,137,102,132,118,111,6,239,148,52
],[
2,3,5,3,2,2,2,3,153,208,108,128,120,37,207,112,158,22,22,139
],[
5,3,5,3,2,2,2,3,194,137,98,248,195,241,41,238,73,102,238,107
],[
170,251,79,41,10,76,69,206,199,86,168,98,20,140,241,7,227,39,68,228
],[
9,189,174,99,156,21,171,156,160,58,235,17,227,206,85,155,38,161,77,164
],[
125,130,50,151,249,85,43,149,131,102,36,106,11,253,19,191,227,51,128,144
],[
101,3,68,225,220,164,145,173,162,22,50,32,133,252,20,6,111,169,6,130
],[
71,125,189,3,18,114,27,116,94,242,177,179,224,236,130,69,92,38,9,72
],[
197,213,126,168,166,107,86,150,192,176,9,54,244,20,23,152,100,67,77,234
],[
214,251,68,236,89,26,44,164,42,252,199,82,216,3,184,166,167,119,254,49
],[
50,145,188,26,85,210,59,18,74,153,49,137,18,245,68,34,23,184,202,101
]
]