aLevelData = [
[
4,19,65,200,111,121,72,67,142,167,90,123,225,0,156,13,93,49,86,52
],[
2,37,103,86,154,8,190,143,110,74,252,6,183,167,127,239,232,149,116,18
],[
2,180,202,74,116,35,254,102,52,230,242,25,179,232,177,207,247,37,21,137
],[
3,82,191,142,141,62,78,31,91,140,120,169,228,190,195,108,247,177,166,203
],[
2,252,127,230,79,228,163,32,239,96,94,161,143,81,90,126,198,128,142,226
],[
13,228,144,97,162,52,49,18,23,126,150,87,44,208,40,68,182,126,124,111
],[
2,4,104,130,82,183,123,0,240,212,123,63,188,24,255,5,182,140,189,194
],[
2,215,89,7,14,175,220,150,83,77,253,135,199,95,189,163,158,154,15,227
],[
5,125,92,233,51,49,144,154,119,161,211,94,204,1,212,48,16,73,1,223
],[
11,164,230,96,100,112,175,186,115,40,26,255,80,206,176,230,228,121,190,212
],[
2,16,84,78,255,65,233,85,211,69,160,46,149,93,130,71,70,147,67,27
],[
202,77,128,96,73,35,69,129,214,238,210,78,78,33,159,243,131,93,157,38
],[
154,63,191,165,178,125,185,224,199,49,8,242,213,116,50,214,64,47,79,216
],[
115,46,200,73,199,118,95,119,167,217,111,221,243,199,117,150,161,103,208,24
],[
170,230,197,30,36,16,198,230,171,29,244,157,6,205,226,24,8,183,156,196
],[
179,221,232,224,164,133,203,233,171,68,79,86,185,92,132,134,255,72,197,247
],[
84,148,60,184,215,242,169,33,214,139,94,193,239,147,142,152,117,32,200,134
],[
22,60,191,4,186,56,76,18,173,68,182,112,1,61,48,17,46,198,163,205
],[
252,154,174,86,163,33,236,109,48,65,117,86,42,118,167,137,118,37,38,170
],[
120,45,33,187,123,192,215,145,83,113,90,132,64,141,147,107,22,175,135,200
]
]