aLevelData = [
[
2,2,2,5,2,2,12,39,181,152,182,183,150,135,120,7,37,151,79,171
],[
2,2,2,2,2,5,251,15,55,67,134,183,168,243,171,235,97,19,176,237
],[
2,2,3,3,3,3,100,39,90,128,66,17,82,178,152,133,205,249,218,190
],[
2,3,2,2,2,2,108,129,79,111,97,197,93,253,212,93,7,235,133,22
],[
2,3,2,2,2,2,180,150,178,72,50,34,59,100,250,180,4,205,182,225
],[
2,2,2,2,2,5,155,233,0,103,27,119,109,27,80,35,202,35,27,87
],[
165,101,24,85,16,63,127,131,161,121,72,5,189,120,147,145,22,180,70,127
],[
115,108,248,32,176,152,14,81,5,31,35,80,139,74,174,206,251,120,222,69
],[
185,20,201,139,18,197,198,168,194,228,23,229,186,51,204,37,32,204,227,120
],[
150,87,180,238,191,128,141,169,255,169,153,54,131,219,6,30,130,3,102,183
],[
194,91,86,64,93,38,94,45,197,160,25,192,6,53,150,217,75,241,253,15
],[
164,56,118,255,6,183,70,228,148,154,59,105,28,255,75,187,229,171,120,225
],[
168,252,247,80,220,31,144,186,54,131,72,40,113,142,62,72,75,142,211,8
],[
208,242,13,99,218,186,62,123,217,44,224,233,208,201,196,81,160,127,108,57
],[
137,32,181,27,238,19,184,184,88,74,243,176,190,115,164,80,4,115,118,171
],[
193,16,95,236,69,237,201,234,219,188,240,253,75,175,139,17,163,47,174,248
],[
55,209,239,5,231,134,200,214,160,18,60,113,38,191,189,147,16,82,78,68
],[
20,62,229,175,132,24,19,49,25,75,230,176,240,13,15,46,210,145,64,157
],[
184,126,216,245,142,161,194,133,56,222,154,134,211,109,18,246,61,67,149,164
],[
215,205,42,135,137,228,154,83,7,254,213,78,83,161,146,96,132,30,54,106
]
]