aLevelData = [
[
2,2,2,2,2,2,2,2,2,2,2,2,2,2,2,2,2,49,77,79
],[
2,2,2,2,2,2,2,2,2,2,2,2,2,2,2,2,2,58,212,96
],[
2,2,2,2,2,2,2,2,2,2,2,2,2,2,2,2,2,98,96,134
],[
2,2,2,13,2,2,2,2,2,2,2,2,2,2,2,2,2,33,222,236
],[
2,2,2,2,2,2,2,2,2,2,2,2,2,2,2,2,2,36,197,183
],[
2,2,2,2,2,2,2,2,2,2,2,2,2,2,2,2,2,80,102,246
],[
2,2,2,2,2,2,2,2,2,2,2,2,2,2,2,2,2,125,48,111
],[
2,2,2,2,2,2,2,2,2,1,2,2,2,2,2,2,2,28,140,199
],[
2,2,11,2,2,2,2,2,2,2,2,2,2,2,2,2,2,162,219,131
],[
2,2,2,2,2,2,2,2,2,2,2,2,2,2,2,2,2,135,184,220
],[
2,2,2,2,2,2,2,2,2,2,2,2,2,2,2,2,2,247,255,15
],[
209,104,2,69,179,115,6,6,78,74,202,34,0,98,60,227,190,107,153,157
],[
87,133,214,134,253,177,63,200,1,133,94,213,222,37,30,251,121,110,48,56
],[
167,116,174,79,240,47,254,27,147,113,250,36,201,27,77,112,78,145,32,156
],[
30,107,247,43,124,110,213,29,57,186,167,195,51,68,223,211,28,135,96,184
],[
125,119,154,43,250,183,246,7,215,11,116,89,187,16,146,183,180,43,113,212
],[
124,191,51,81,251,163,167,213,12,211,40,95,132,101,194,219,113,191,151,244
],[
159,8,129,42,97,220,249,36,141,68,56,71,201,229,155,135,5,119,76,125
],[
73,121,31,186,177,35,186,92,182,157,249,223,174,110,145,53,150,55,243,24
],[
16,161,115,159,168,148,169,15,91,170,23,244,90,227,13,113,11,154,202,213
]
]