aLevelData = [
[
2,2,2,2,2,11,2,2,2,2,2,2,2,2,163,91,21,181,29,253
],[
2,2,2,2,2,2,2,2,2,2,2,2,2,2,66,50,214,131,224,6
],[
5,2,5,2,5,5,5,2,5,5,5,2,5,5,141,253,210,89,95,106
],[
5,2,5,2,5,2,5,2,5,2,5,2,5,2,38,205,243,31,237,3
],[
5,5,5,2,5,5,5,2,5,5,5,2,5,5,246,109,73,96,199,126
],[
5,2,5,2,5,2,5,2,5,2,2,2,5,2,199,17,115,128,239,76
],[
5,2,5,2,5,2,5,2,5,2,2,2,5,2,227,5,26,217,84,170
],[
2,2,2,12,2,2,2,2,2,2,2,2,2,10,132,210,8,247,162,167
],[
2,2,7,2,2,2,2,2,8,2,2,2,2,2,59,135,182,100,89,105
],[
2,2,7,2,5,5,5,2,5,5,5,2,5,5,160,55,110,197,247,45
],[
2,2,7,2,5,2,2,2,2,5,2,2,5,2,222,195,88,60,86,168
],[
2,2,7,2,5,5,5,2,2,5,2,2,5,2,254,134,2,67,147,220
],[
2,2,7,2,5,2,2,2,2,5,2,2,5,2,1,135,70,129,22,121
],[
2,2,7,2,5,5,5,2,5,5,5,2,5,5,30,49,160,77,142,98
],[
2,2,2,2,2,2,2,2,2,2,2,2,2,2,204,203,73,202,9,248
],[
87,33,188,243,105,40,53,29,106,234,226,124,86,66,195,98,79,157,30,73
],[
238,1,116,2,215,79,179,15,144,197,173,77,147,198,201,214,161,222,249,37
],[
90,1,236,123,11,19,132,130,199,174,138,48,185,31,161,239,184,177,120,251
],[
28,47,68,11,208,164,110,51,169,101,136,9,246,81,134,7,89,88,43,48
],[
213,58,193,246,39,145,13,92,90,18,130,88,150,16,181,123,57,65,17,211
]
]