aLevelData = [
[
2,2,2,5,2,2,2,5,2,2,2,5,2,2,2,5,2,2,253,48
],[
2,2,2,2,2,5,2,2,2,5,2,2,2,5,2,2,2,2,152,75
],[
2,2,3,3,3,3,3,3,3,3,3,3,3,3,3,3,2,2,156,215
],[
2,3,2,2,2,2,2,2,2,2,2,2,2,5,2,5,2,2,75,117
],[
2,3,2,2,2,2,2,2,2,2,8,2,2,2,2,2,2,2,155,173
],[
2,2,2,2,2,5,5,5,5,2,2,2,2,5,2,3,3,3,152,97
],[
2,2,3,3,3,3,2,3,2,3,2,2,2,3,2,3,2,2,158,139
],[
2,2,3,2,2,3,2,3,2,3,3,2,2,3,2,3,2,2,130,86
],[
2,2,3,2,2,3,2,3,2,3,2,3,2,3,2,3,2,2,228,142
],[
4,2,3,2,2,3,2,3,2,3,2,3,2,3,2,3,2,2,67,248
],[
2,2,3,3,3,2,2,3,2,3,2,3,2,3,2,3,2,3,142,26
],[
2,2,3,2,3,2,2,3,2,3,2,2,3,3,2,3,2,2,62,109
],[
2,2,3,2,3,2,2,3,2,3,2,2,3,3,2,3,2,2,62,30
],[
2,2,3,2,2,3,2,3,2,3,2,2,2,3,2,3,2,2,53,191
],[
2,2,3,2,2,3,2,3,2,3,2,2,2,3,2,3,1,2,228,153
],[
2,2,2,2,2,5,5,5,5,2,2,2,2,5,2,5,3,3,188,129
],[
2,3,2,2,2,2,2,2,2,2,9,2,2,2,2,2,2,2,213,93
],[
2,3,3,3,3,2,2,2,2,2,2,2,2,2,2,2,2,2,237,182
],[
2,2,2,2,2,3,3,3,3,3,3,3,3,3,3,3,3,3,30,19
],[
94,238,23,127,80,178,59,5,41,34,54,108,37,221,64,227,72,33,170,65
]
]