aLevelData = [
[
4,2,5,5,2,2,166,192,6,101,224,23,46,166,51,30,92,151,51,228
],[
2,2,2,2,2,2,238,107,87,219,38,175,7,149,219,45,246,203,110,17
],[
2,2,2,2,2,2,178,163,0,74,122,50,226,51,79,64,77,115,77,76
],[
3,3,3,3,3,3,84,34,60,208,22,45,99,199,56,251,156,107,147,80
],[
2,2,3,2,2,2,174,67,41,114,214,93,94,139,167,217,101,79,21,167
],[
13,2,3,2,2,2,248,222,204,144,76,236,198,123,68,31,28,233,229,184
],[
2,5,3,2,2,2,28,195,10,118,157,85,88,183,143,154,117,225,214,186
],[
2,12,3,2,2,2,117,0,89,209,149,177,85,242,44,62,248,108,222,10
],[
5,2,3,3,3,3,43,75,19,48,175,34,167,103,107,8,228,41,4,225
],[
11,2,3,2,2,2,173,20,175,223,251,144,67,72,142,178,147,121,220,96
],[
2,5,3,2,2,2,250,43,78,182,55,245,171,169,123,18,212,234,193,101
],[
2,10,3,2,2,2,179,13,94,186,110,235,217,79,224,69,252,147,73,170
],[
5,2,2,2,2,2,43,45,68,154,245,64,250,235,233,237,150,108,171,26
],[
2,2,2,2,2,2,249,201,71,114,174,174,196,173,32,47,253,18,10,104
],[
172,58,48,96,200,22,77,52,17,52,76,113,233,61,186,193,101,195,124,202
],[
164,57,189,83,95,67,43,168,194,49,99,64,122,197,169,158,16,61,221,117
],[
117,141,170,15,222,237,1,239,209,147,198,182,128,194,201,67,87,3,247,30
],[
209,179,210,23,143,189,30,42,171,169,221,166,74,214,126,143,112,3,82,64
],[
25,20,63,84,133,19,184,199,211,118,236,89,209,160,62,51,19,170,246,205
],[
66,98,54,15,183,148,47,183,72,137,148,250,98,206,79,110,89,54,116,39
]
]