aLevelData = [
[
2,2,2,2,2,2,2,2,2,2,2,2,2,2,2,2,52,77,102,28
],[
2,2,13,5,5,2,2,12,5,5,2,3,2,5,5,2,103,243,245,48
],[
2,2,2,5,5,2,2,2,5,5,2,3,2,5,5,2,39,248,86,251
],[
2,2,2,2,2,2,2,2,2,2,2,3,2,2,2,2,63,139,78,63
],[
2,2,2,2,2,2,2,2,2,2,2,3,3,3,3,3,52,170,54,255
],[
2,2,2,2,2,2,2,2,2,2,2,2,2,2,6,2,206,146,160,147
],[
2,2,2,2,2,2,2,2,2,2,2,2,2,3,3,3,211,122,62,251
],[
2,2,2,2,2,2,2,2,2,2,2,2,2,2,2,2,22,128,0,116
],[
2,2,2,2,2,2,2,2,2,2,3,2,2,2,2,2,176,228,125,73
],[
2,2,2,2,2,2,2,2,2,3,3,2,3,2,2,2,142,116,148,236
],[
2,2,2,2,2,2,2,2,3,3,2,9,3,3,2,2,44,71,83,69
],[
2,2,2,2,2,2,2,2,3,2,2,2,3,3,2,2,159,174,23,74
],[
4,2,2,2,2,2,2,3,2,2,2,2,3,2,2,2,217,104,245,208
],[
2,2,2,2,2,3,3,2,2,2,2,3,3,2,2,2,41,21,89,160
],[
2,2,2,3,2,2,11,2,2,2,3,3,2,2,3,3,1,237,237,206
],[
2,2,2,3,2,3,2,2,2,3,3,2,2,2,3,2,252,178,189,70
],[
2,2,2,5,2,3,2,2,2,3,2,2,2,2,3,2,31,227,152,168
],[
96,51,185,86,100,58,167,203,141,105,89,46,52,67,158,38,51,202,188,241
],[
167,56,87,176,244,240,149,5,9,180,128,224,229,24,172,150,89,55,25,52
],[
16,164,90,18,206,164,247,171,245,154,17,171,77,194,68,74,4,34,210,217
]
]