aLevelData = [
[
6,2,8,2,9,2,10,2,11,3,2,2,5,2,2,2,63,241,122,238
],[
2,2,2,2,2,2,2,2,12,3,5,2,2,2,5,2,150,3,67,221
],[
2,2,3,3,3,3,3,3,3,3,2,2,3,3,3,3,46,72,132,34
],[
2,2,3,2,2,2,2,2,2,2,5,2,3,2,2,2,130,38,162,229
],[
2,2,3,2,2,2,2,2,2,2,2,2,3,2,2,2,42,160,32,230
],[
2,2,3,2,3,3,3,3,3,3,2,5,3,2,2,2,243,29,91,99
],[
2,2,3,2,2,2,2,5,5,3,2,2,3,2,2,2,53,107,119,60
],[
2,2,3,5,5,5,2,3,3,3,5,2,3,3,3,2,97,3,153,85
],[
2,2,2,2,2,2,2,2,2,2,2,2,5,2,2,2,218,143,86,60
],[
2,3,2,2,3,1,3,2,2,2,2,2,5,2,2,2,6,169,108,12
],[
2,3,2,2,3,2,3,2,2,2,2,5,5,2,2,2,164,230,176,145
],[
2,3,2,3,2,2,2,3,2,2,2,2,5,2,2,2,96,19,72,172
],[
2,3,2,3,2,2,2,3,3,3,2,2,3,3,3,2,164,190,26,249
],[
2,3,2,3,2,2,2,3,2,2,5,2,5,2,2,2,178,249,132,176
],[
2,3,2,3,2,2,3,3,2,2,2,2,5,2,2,2,240,90,78,201
],[
2,3,2,3,2,2,3,3,2,2,2,5,5,2,2,2,130,70,221,100
],[
2,3,2,3,2,2,3,3,2,2,2,2,5,2,2,2,30,111,169,103
],[
28,156,241,105,205,169,173,207,14,206,196,52,29,36,127,15,171,100,61,143
],[
50,242,105,202,136,27,170,23,181,155,89,184,2,99,56,189,82,153,97,36
],[
181,223,124,69,59,216,53,110,6,232,238,202,163,60,176,135,155,11,104,55
]
]