aLevelData = [
[
2,2,2,2,86,156,13,95,37,144,74,154,229,68,151,189,160,229,119,13
],[
2,2,2,4,25,128,216,150,186,34,161,113,206,62,138,67,240,78,48,6
],[
5,3,3,3,195,189,105,12,228,5,212,64,29,21,181,176,220,245,0,72
],[
2,3,2,2,227,172,180,224,64,98,106,122,128,194,46,196,32,162,141,229
],[
2,3,2,2,68,230,239,117,171,161,40,205,227,126,73,130,185,95,188,44
],[
2,3,2,2,244,67,144,108,67,109,17,45,115,195,156,41,229,116,177,175
],[
2,3,2,2,64,221,74,164,99,174,107,201,158,72,251,59,33,106,210,64
],[
2,3,2,2,180,13,19,64,169,140,188,18,15,8,123,122,41,11,196,239
],[
2,3,3,2,31,107,32,161,242,114,200,186,181,59,114,228,251,95,107,12
],[
2,2,3,2,140,210,230,102,92,7,148,178,189,91,116,189,211,176,237,42
],[
2,2,3,2,72,88,26,114,66,54,101,42,146,31,87,133,47,134,174,25
],[
2,2,3,2,226,89,176,230,66,38,192,148,227,130,47,252,203,171,84,234
],[
2,2,2,2,37,108,223,33,58,65,106,160,156,188,81,36,164,39,196,238
],[
2,2,2,2,31,107,26,198,69,49,104,64,235,70,83,62,249,68,34,182
],[
2,2,2,2,29,111,24,182,193,221,0,165,59,218,9,203,68,138,212,20
],[
6,2,2,2,172,208,204,16,76,111,182,63,59,111,136,140,69,195,127,23
],[
8,2,2,2,152,40,108,55,193,80,79,192,215,64,38,129,246,247,7,17
],[
9,2,2,2,239,80,109,204,62,41,208,24,61,197,120,237,151,111,146,148
],[
10,2,2,2,254,96,132,174,33,227,126,121,216,183,81,79,162,181,133,111
],[
82,178,165,0,5,167,222,83,87,16,201,105,215,145,132,181,184,223,7,34
]
]