aLevelData = [
[
2,2,2,2,2,2,2,2,2,6,173,110,9,17,31,115,45,77,179,35
],[
2,3,5,3,5,5,5,3,5,3,30,188,226,98,61,9,59,211,180,135
],[
2,3,2,3,2,2,2,3,5,3,88,248,10,114,18,155,245,120,241,109
],[
2,2,2,2,2,2,2,2,2,2,111,119,230,238,11,137,61,140,138,62
],[
2,3,5,3,5,5,5,3,2,3,205,15,169,40,114,52,62,157,189,152
],[
2,3,5,3,5,5,5,3,2,3,131,184,233,216,178,161,17,247,210,14
],[
2,5,5,5,5,5,5,5,5,5,161,0,208,10,11,236,209,246,187,197
],[
2,3,5,3,5,5,5,3,5,3,199,205,76,12,66,172,252,89,138,145
],[
2,3,5,3,5,5,5,3,5,3,93,65,234,98,78,124,78,50,42,71
],[
2,5,5,5,5,5,5,5,5,5,17,193,63,8,16,65,130,49,3,96
],[
2,3,5,3,2,2,2,3,2,3,128,102,13,130,152,226,145,78,104,23
],[
5,3,5,3,2,2,2,3,2,3,72,109,133,148,144,142,111,44,7,174
],[
5,5,5,5,5,5,5,5,5,5,196,85,89,150,179,206,86,165,180,133
],[
72,207,118,183,131,230,25,89,61,24,158,183,160,186,156,91,30,68,52,48
],[
5,156,70,231,83,151,229,154,203,189,9,175,72,76,132,0,82,128,56,56
],[
239,18,134,128,187,254,10,92,59,138,133,207,111,132,26,198,166,203,190,180
],[
150,17,234,121,172,222,146,136,161,216,91,73,78,67,9,188,193,196,54,96
],[
144,106,74,83,109,238,167,186,251,58,36,99,225,41,189,169,28,142,137,152
],[
153,119,236,82,3,179,13,177,218,145,138,46,197,235,107,2,41,99,85,139
],[
250,237,0,240,209,142,235,8,63,99,79,120,98,228,81,28,181,106,123,169
]
]