aLevelData = [
[
10,2,2,8,2,2,2,2,2,2,2,2,2,2,2,2,2,2,2,2
],[
2,2,2,2,2,2,2,2,2,2,2,2,2,2,2,2,2,2,2,2
],[
2,2,2,2,2,2,3,3,3,3,2,2,2,2,2,3,3,3,2,2
],[
9,2,2,2,2,2,2,2,2,3,2,2,2,2,2,3,2,2,2,2
],[
3,3,3,3,3,3,3,2,2,3,2,2,2,2,2,2,2,2,2,2
],[
2,2,2,2,2,2,2,2,2,3,2,2,2,2,2,3,2,2,3,2
],[
2,2,2,2,2,2,2,2,2,3,3,2,2,2,2,3,2,2,3,2
],[
2,2,2,2,2,2,2,2,2,2,3,2,2,2,2,3,2,2,3,2
],[
2,2,2,2,2,2,2,2,2,2,3,2,2,2,2,3,2,2,3,2
],[
2,2,2,2,3,3,3,3,2,2,3,2,2,2,2,3,2,2,3,2
],[
2,2,2,2,3,2,2,3,2,2,3,2,2,2,2,3,2,2,3,2
],[
2,2,2,2,3,2,2,3,2,2,3,3,3,5,2,3,2,2,3,2
],[
107,81,79,177,35,246,51,203,198,127,139,51,131,169,41,65,228,38,12,198
],[
4,251,53,149,252,39,183,66,158,133,14,41,102,243,177,178,173,180,235,212
],[
32,19,230,216,113,73,9,96,76,161,131,167,141,218,40,10,176,205,125,200
],[
136,80,14,6,52,89,8,22,80,103,3,248,104,29,32,33,178,48,84,124
],[
252,132,3,175,227,146,209,159,70,13,181,54,250,197,79,100,191,203,123,99
],[
115,214,38,64,134,229,96,151,174,38,179,158,220,23,179,100,110,235,215,91
],[
166,47,135,21,91,173,118,75,238,145,50,35,128,202,250,178,98,179,207,192
],[
205,243,205,204,212,162,188,80,150,173,227,71,184,123,28,235,19,208,46,195
]
]