aLevelData = [
[
2,2,2,5,2,2,2,5,2,2,2,5,2,2,238,128,151,90,173,207
],[
2,2,2,2,2,5,2,2,2,5,2,2,2,5,75,159,249,214,180,47
],[
2,2,3,3,3,3,3,3,3,3,3,3,3,3,43,222,3,68,34,148
],[
2,3,2,2,2,2,2,2,2,2,2,2,2,5,72,131,129,104,63,129
],[
2,3,2,2,2,2,2,2,2,2,8,2,2,2,24,52,109,133,159,30
],[
108,144,170,191,132,154,217,133,123,31,79,85,173,218,102,117,95,209,161,170
],[
80,145,227,157,145,187,222,131,151,191,205,253,143,232,102,61,241,153,10,107
],[
88,214,64,71,145,5,97,15,241,246,149,163,236,34,253,231,228,48,50,105
],[
63,190,239,68,188,93,10,68,7,221,169,74,139,204,178,242,135,57,131,116
],[
100,189,228,200,70,189,57,14,225,233,253,44,142,8,107,185,157,248,126,26
],[
237,240,28,234,187,9,142,160,184,253,52,107,94,46,119,97,131,234,254,217
],[
47,237,37,21,171,39,171,37,218,192,170,7,204,90,205,19,145,150,189,151
],[
75,217,220,190,135,80,54,182,206,49,181,17,118,68,148,108,190,163,21,79
],[
27,190,119,85,204,161,34,141,180,122,38,31,105,85,227,51,137,43,9,14
],[
77,27,196,126,96,247,48,121,241,2,19,1,7,248,203,74,20,79,133,31
],[
206,189,176,130,58,250,178,147,9,199,217,179,40,47,148,232,147,13,227,131
],[
106,206,12,1,70,120,144,48,205,235,93,147,132,104,69,6,229,79,175,165
],[
178,45,140,235,136,245,141,23,183,142,147,212,81,142,104,24,129,70,172,77
],[
30,254,18,175,128,129,204,245,147,221,67,51,41,100,12,255,149,246,23,211
],[
117,131,42,178,207,203,142,14,96,104,9,234,48,15,12,60,106,19,44,149
]
]