aLevelData = [
[
2,2,3,3,3,82,76,236,82,127,73,172,47,207,230,113,80,96,151,108
],[
2,2,2,2,2,110,21,134,182,146,234,144,65,49,132,144,15,156,13,225
],[
3,2,3,3,3,161,152,62,30,179,72,189,44,38,84,170,123,62,68,116
],[
2,2,2,2,2,136,13,45,242,167,47,144,175,255,184,127,133,214,107,1
],[
3,2,3,3,3,109,15,45,184,149,240,185,193,179,41,148,220,154,18,68
],[
2,2,3,2,2,205,10,53,189,2,205,12,28,117,255,12,151,212,174,226
],[
3,2,3,2,2,180,224,163,252,186,19,126,75,101,133,9,71,222,16,198
],[
2,2,3,2,2,52,234,178,202,164,98,52,206,62,227,9,132,189,198,121
],[
2,3,3,2,2,39,60,83,255,86,176,49,239,34,182,33,91,102,143,237
],[
2,2,2,2,2,56,87,104,154,189,91,223,229,12,31,196,238,20,227,28
],[
3,3,3,3,2,46,182,25,108,174,38,47,52,123,149,169,185,85,13,114
],[
8,2,6,3,2,7,167,156,116,55,188,180,102,238,47,210,229,38,163,94
],[
2,2,2,3,2,199,49,181,210,172,250,47,31,213,143,126,77,58,220,103
],[
2,2,2,2,2,97,214,185,245,131,70,40,182,96,146,215,39,206,75,237
],[
2,2,2,2,2,108,174,214,3,68,23,7,111,61,177,242,201,36,94,253
],[
9,2,12,3,2,168,192,32,58,173,192,55,244,195,241,137,136,164,180,71
],[
118,160,176,206,184,154,196,203,83,83,63,163,43,235,84,18,27,164,200,18
],[
69,234,238,254,167,144,213,247,240,93,192,135,145,199,214,132,22,254,27,55
],[
183,44,159,190,42,251,246,175,188,89,231,254,160,120,104,33,135,24,203,113
],[
113,8,50,212,194,234,72,153,152,56,51,163,92,132,196,202,151,4,241,126
]
]