aLevelData = [
[
5,5,3,5,5,5,5,5,5,5,3,5,5,5,5,5,5,5,5,165
],[
4,2,3,5,5,5,5,5,5,5,3,5,5,5,5,5,5,5,5,31
],[
228,171,3,31,208,93,196,148,136,52,137,171,83,228,132,220,151,207,221,194
],[
87,123,84,42,250,68,39,106,78,78,54,244,204,190,101,42,30,42,66,116
],[
222,77,232,144,161,0,35,42,52,102,212,173,37,102,151,88,133,94,164,148
],[
237,21,243,133,191,242,164,223,174,108,157,251,129,194,117,42,19,236,145,73
],[
159,209,140,149,58,186,220,193,161,7,179,70,53,33,36,251,68,175,135,229
],[
138,13,30,80,248,249,249,30,180,144,22,96,96,122,205,35,159,97,107,140
],[
213,167,30,40,47,88,17,125,228,93,215,229,186,243,13,156,203,92,59,23
],[
137,212,252,151,0,199,95,255,91,65,140,226,170,166,171,225,226,163,1,52
],[
37,100,92,134,68,8,178,6,131,82,5,187,156,161,137,23,6,34,9,208
],[
118,68,135,235,167,108,35,26,87,235,62,71,146,45,222,113,50,50,84,183
],[
167,66,29,178,244,221,7,8,250,242,148,62,249,81,163,206,84,97,77,122
],[
148,22,14,223,176,30,37,77,140,91,61,214,191,150,76,165,153,114,188,146
],[
101,158,201,243,235,79,42,180,57,238,243,170,163,13,186,36,9,160,248,195
],[
88,106,179,140,83,181,90,60,148,70,241,219,205,144,109,148,84,40,98,196
],[
223,121,219,81,140,185,137,61,36,28,33,123,160,71,255,1,236,7,15,30
],[
236,67,237,14,189,47,75,204,61,195,148,39,205,108,206,24,85,1,197,83
],[
137,248,102,28,107,218,105,92,17,244,51,244,169,80,250,81,186,227,42,64
],[
173,8,7,4,139,45,148,167,8,204,180,141,193,158,144,79,194,11,56,198
]
]