aLevelData = [
[
2,2,2,2,2,2,167,114,46,17,213,45,109,72,149,4,228,49,51,99
],[
95,54,0,163,227,24,74,47,66,53,139,230,236,7,225,193,8,238,190,182
],[
195,47,225,220,232,60,133,207,178,54,216,86,222,176,174,67,3,182,119,155
],[
38,13,110,247,137,189,20,42,197,205,221,36,24,78,41,23,0,155,117,216
],[
9,222,211,135,227,214,151,114,183,216,84,55,187,20,7,41,5,26,145,245
],[
157,157,107,134,213,118,149,37,221,235,207,229,146,50,12,62,151,49,36,248
],[
167,136,201,74,41,209,188,68,5,38,64,106,183,228,208,162,162,175,13,80
],[
166,183,250,191,244,57,107,195,33,72,187,156,122,205,190,30,152,205,246,15
],[
52,234,10,209,60,45,115,64,37,2,121,222,132,132,94,46,216,251,217,93
],[
170,163,198,39,217,176,27,249,47,142,30,83,55,109,213,113,83,253,190,42
],[
9,118,193,24,158,220,99,249,230,129,60,85,90,203,171,98,107,55,200,36
],[
22,158,154,216,185,184,139,147,37,222,24,39,244,20,205,70,29,70,113,234
],[
197,210,126,243,88,71,212,18,217,108,173,231,118,133,212,102,96,209,18,127
],[
217,87,233,254,143,227,133,176,40,75,240,199,30,246,133,127,205,159,167,2
],[
202,87,179,137,119,201,50,197,212,194,84,125,152,241,154,120,129,235,210,157
],[
232,113,72,89,152,246,59,65,224,92,142,249,231,255,192,84,64,244,30,188
],[
190,147,55,213,138,50,145,93,114,52,154,87,132,67,225,104,220,217,134,129
],[
186,5,240,190,216,108,189,142,250,142,255,21,198,74,165,206,214,164,55,117
],[
12,199,199,36,37,70,36,188,145,167,80,134,130,34,52,26,68,166,147,128
],[
204,29,61,150,147,241,133,177,165,207,244,135,244,171,63,77,243,4,119,28
]
]