aLevelData = [
[
6,2,2,2,2,2,2,2,47,207,133,208,26,101,253,1,254,150,18,7
],[
2,2,2,2,2,2,2,2,92,112,239,115,79,45,50,120,20,170,150,249
],[
201,27,207,230,117,254,182,201,73,77,166,156,38,248,38,222,95,146,200,230
],[
191,74,81,118,206,30,25,147,80,75,181,148,15,8,212,122,218,115,103,127
],[
206,204,5,242,212,225,141,65,107,201,13,88,168,213,226,41,122,196,33,140
],[
51,54,54,74,68,100,203,116,72,13,236,250,69,180,104,120,46,8,122,83
],[
172,164,168,5,29,248,236,181,222,135,18,11,197,84,97,66,242,150,125,127
],[
200,179,140,97,54,108,152,217,59,85,52,60,169,137,99,150,41,155,181,66
],[
127,208,179,183,15,139,125,165,160,8,178,65,97,77,144,220,41,94,93,187
],[
3,177,5,35,234,225,4,179,209,166,134,247,231,5,205,57,24,196,212,154
],[
215,33,50,98,27,196,64,149,167,241,126,199,143,2,51,48,248,21,84,3
],[
31,2,167,252,157,144,40,56,233,232,172,74,30,73,196,139,254,254,228,177
],[
55,141,197,164,230,50,7,141,90,139,27,47,26,149,96,122,41,215,140,93
],[
136,221,78,221,253,232,50,100,19,228,196,91,98,154,248,250,16,39,201,95
],[
152,173,33,222,202,72,249,153,20,68,193,80,255,141,2,122,252,102,66,148
],[
97,94,40,185,175,128,224,115,22,203,193,209,59,226,45,185,56,4,185,128
],[
228,61,142,184,86,222,16,73,164,44,189,196,240,85,87,243,166,168,69,181
],[
255,4,55,8,202,145,9,104,107,175,234,88,36,44,189,62,147,186,191,115
],[
124,160,106,155,201,175,154,50,207,120,239,104,211,188,114,47,205,36,123,146
],[
107,50,210,72,89,120,20,137,192,8,88,32,13,43,19,194,243,86,57,158
]
]