aLevelData = [
[
10,2,2,8,2,2,220,15,34,85,45,64,101,78,57,111,24,176,225,79
],[
2,2,2,2,2,2,55,87,33,54,207,236,138,195,17,173,242,195,164,113
],[
2,2,2,2,2,2,106,85,64,230,112,77,121,30,102,215,216,74,67,93
],[
9,2,2,2,2,2,48,197,137,170,47,84,119,79,52,172,127,69,96,52
],[
3,3,3,3,3,3,250,213,240,13,27,181,202,80,33,116,85,150,209,23
],[
2,2,2,2,2,2,142,190,36,5,89,234,61,32,20,203,157,53,114,31
],[
2,2,2,2,2,2,154,150,135,119,13,5,31,62,76,212,84,247,88,75
],[
2,2,2,2,2,2,96,198,87,74,175,50,68,47,57,41,229,250,14,68
],[
2,2,2,2,2,2,253,176,50,77,196,253,172,255,148,28,218,12,229,252
],[
2,2,2,2,3,3,7,101,123,155,63,181,222,182,98,46,11,165,120,137
],[
2,2,2,2,3,2,105,129,68,72,254,135,28,63,227,193,248,82,245,227
],[
2,2,2,2,3,2,200,128,206,115,11,33,244,44,157,107,79,165,208,59
],[
225,46,191,19,177,250,223,94,8,132,215,252,224,43,146,250,154,31,146,161
],[
239,129,135,179,41,198,32,241,147,93,33,224,46,145,182,205,165,176,6,15
],[
131,109,12,140,164,131,162,127,233,155,223,120,48,112,163,164,132,49,112,78
],[
144,39,124,166,90,151,4,193,46,234,226,226,215,11,98,248,22,17,82,103
],[
76,30,88,11,122,134,137,122,107,52,54,138,48,74,9,20,205,8,81,247
],[
50,239,155,95,109,38,130,71,29,28,200,60,42,111,165,100,179,13,94,192
],[
72,153,26,174,90,16,242,178,239,172,71,117,154,8,88,14,171,134,19,129
],[
163,238,44,133,235,87,109,139,197,75,77,251,130,38,195,193,246,191,92,8
]
]