aLevelData = [
[
6,2,2,2,2,2,2,2,2,2,62,160,5,166,4,21,145,127,65,70
],[
137,61,84,102,94,94,85,124,13,185,76,197,244,6,160,83,228,160,210,251
],[
119,138,106,110,164,176,50,166,144,112,163,132,167,89,157,183,236,51,91,223
],[
141,63,165,242,187,192,71,223,184,185,195,114,50,249,67,120,207,85,209,35
],[
9,53,202,176,60,82,144,70,253,189,128,34,174,36,36,241,79,81,169,125
],[
151,243,147,140,68,161,175,5,175,28,73,85,163,212,160,17,111,174,151,221
],[
58,5,173,140,151,239,47,137,90,193,173,117,169,213,170,17,86,138,151,95
],[
108,141,3,4,7,87,12,241,105,247,25,66,75,18,203,102,113,40,48,129
],[
129,24,58,14,21,231,112,201,15,189,228,204,45,48,101,248,221,197,245,150
],[
82,180,126,62,215,236,192,248,99,87,142,162,110,95,58,146,4,177,78,124
],[
24,65,124,149,26,142,216,248,204,39,69,73,81,110,45,153,134,156,118,138
],[
150,5,177,180,201,158,148,71,157,188,170,241,24,30,73,2,92,46,197,206
],[
124,132,227,82,142,172,144,27,2,41,211,100,50,185,1,127,57,219,48,118
],[
9,143,237,241,184,93,50,90,27,152,146,64,150,228,183,249,50,246,14,140
],[
240,155,193,206,94,252,230,202,103,32,246,102,111,178,128,68,160,5,30,231
],[
126,85,169,23,194,80,169,134,101,212,15,179,251,251,39,15,66,85,200,95
],[
251,116,206,97,248,174,201,178,119,30,247,239,174,236,112,26,167,206,161,64
],[
78,207,251,89,201,80,236,112,7,76,15,4,156,224,160,173,204,10,50,3
],[
229,177,164,187,211,229,81,19,238,105,135,113,22,110,59,70,2,162,250,57
],[
213,105,35,130,242,106,84,147,18,78,34,254,148,196,13,147,20,201,178,200
]
]