aLevelData = [
[
2,2,2,2,2,2,2,2,2,58,176,125,58,138,49,233,105,222,210,109
],[
2,2,2,2,2,2,2,2,3,231,135,179,123,236,41,243,133,180,100,198
],[
2,2,3,2,3,2,2,2,2,190,49,180,199,36,253,150,144,190,146,237
],[
2,2,3,2,3,2,2,2,2,136,34,189,163,253,59,80,147,115,73,24
],[
2,2,3,2,3,2,2,2,2,167,59,41,14,61,71,215,209,208,60,49
],[
2,2,3,2,2,2,2,2,2,84,212,201,254,212,225,56,46,14,20,66
],[
2,2,3,2,3,3,3,3,3,99,174,179,40,177,10,15,255,162,16,175
],[
75,126,125,170,208,201,81,85,165,12,127,30,138,217,232,184,123,9,138,121
],[
134,72,245,0,217,212,255,26,31,129,185,231,13,1,162,56,55,98,26,60
],[
41,216,25,92,179,189,32,99,132,214,112,226,250,216,123,211,57,42,152,124
],[
123,237,250,150,167,58,227,175,36,170,21,205,239,28,138,84,235,178,100,41
],[
121,29,39,24,73,27,38,115,112,61,59,252,186,238,187,5,65,177,169,214
],[
62,170,42,79,32,96,57,207,219,193,156,84,131,103,23,227,25,25,223,42
],[
165,149,81,100,132,140,228,125,4,239,93,118,46,105,66,12,227,45,144,148
],[
43,241,176,42,201,58,168,10,19,219,143,62,0,184,67,122,131,208,94,68
],[
23,123,101,87,155,239,67,74,97,9,246,109,130,75,137,244,116,33,66,87
],[
222,104,28,248,170,48,119,7,92,193,15,162,163,221,43,65,46,69,23,82
],[
193,127,211,32,136,213,13,249,171,161,77,144,34,200,112,160,203,133,87,210
],[
186,104,224,225,208,158,21,252,143,114,164,108,44,20,144,118,230,153,37,131
],[
151,68,49,126,137,4,113,126,138,61,74,165,67,203,185,72,197,69,141,79
]
]