aLevelData = [
[
2,2,2,2,215,0,195,178,111,11,107,161,52,72,84,74,71,36,194,56
],[
2,2,2,4,23,32,199,127,123,140,255,160,254,146,126,173,121,119,7,174
],[
5,3,3,3,232,30,126,66,118,206,160,138,218,52,242,66,230,172,247,49
],[
2,3,2,2,93,188,166,196,6,225,27,246,254,143,141,114,82,115,128,252
],[
2,3,2,2,205,251,60,13,15,24,125,189,223,67,108,230,195,190,206,135
],[
2,3,2,2,205,28,124,102,183,3,19,250,51,49,236,135,124,189,79,139
],[
2,3,2,2,49,159,227,89,99,115,105,4,237,122,170,126,3,226,174,1
],[
2,3,2,2,14,71,47,174,183,121,77,117,66,128,132,52,30,221,218,35
],[
2,3,3,2,186,19,93,111,154,102,204,37,169,227,149,82,209,160,255,105
],[
2,2,3,2,201,69,169,228,46,203,51,46,214,132,59,193,97,92,139,139
],[
2,2,3,2,16,94,144,151,219,122,15,233,189,133,19,170,83,129,42,133
],[
2,2,3,2,165,31,208,80,68,130,44,239,149,70,250,117,108,193,201,141
],[
2,2,2,2,220,136,102,25,78,53,152,24,209,104,13,205,177,12,149,30
],[
2,2,2,2,75,220,142,58,31,37,159,126,39,205,170,154,104,148,251,239
],[
2,2,2,2,198,154,198,60,28,34,208,122,140,149,108,4,20,202,169,251
],[
6,2,2,2,98,132,202,233,234,60,246,164,53,33,49,118,124,94,139,122
],[
8,2,2,2,117,155,151,73,109,198,31,214,151,19,22,151,164,65,206,230
],[
9,2,2,2,147,32,108,166,203,80,152,41,103,75,121,81,209,165,224,246
],[
146,147,195,136,104,171,238,246,153,234,245,206,136,251,109,165,134,182,91,185
],[
234,232,237,213,100,82,104,117,142,244,98,43,196,139,49,65,54,88,163,160
]
]