aLevelData = [
[
10,74,158,198,209,90,48,13,72,82,114,8,82,124,86,114,20,127,186,65
],[
2,244,49,234,33,70,172,103,32,40,164,231,171,170,248,156,185,51,134,185
],[
2,70,32,68,51,3,173,141,196,76,25,184,54,90,5,239,222,186,30,62
],[
9,103,253,251,235,209,178,72,6,184,145,37,64,218,249,201,1,212,157,107
],[
3,180,44,122,98,102,148,12,139,143,109,193,235,47,139,174,149,29,56,128
],[
2,206,156,123,182,112,48,154,14,140,176,221,61,83,155,149,227,55,175,93
],[
2,190,77,184,160,30,246,167,91,153,190,227,36,255,132,228,108,145,220,253
],[
2,1,109,177,121,214,77,47,234,7,113,223,190,24,218,20,19,126,185,135
],[
2,205,96,39,62,229,158,22,178,3,19,136,48,80,23,255,128,133,72,52
],[
2,197,73,139,11,164,185,77,199,168,72,15,122,229,201,33,192,220,202,173
],[
173,159,36,248,4,54,208,229,170,64,252,187,90,221,94,39,153,204,201,133
],[
237,209,254,91,74,90,196,38,205,97,59,90,173,148,109,164,110,180,38,114
],[
87,59,6,181,39,65,212,229,4,160,21,70,180,87,221,107,15,44,230,248
],[
180,150,223,172,252,217,6,158,44,115,249,198,239,183,201,192,3,184,81,205
],[
50,104,198,27,132,1,143,70,179,164,86,30,223,64,95,171,131,182,24,110
],[
168,59,242,234,88,253,112,99,86,9,125,230,12,108,3,137,197,152,185,244
],[
28,10,61,32,180,42,98,95,42,115,203,157,72,211,185,229,124,85,33,39
],[
136,253,2,56,122,243,245,26,223,229,6,126,52,166,194,135,157,27,145,209
],[
218,87,70,178,118,5,245,191,65,6,4,146,1,92,133,203,101,71,195,85
],[
58,173,27,235,225,191,14,218,1,218,148,8,121,171,178,53,153,151,78,129
]
]