aLevelData = [
[
2,2,2,2,2,2,2,2,2,6,5,2,2,2,2,2,234,209,40,44
],[
2,3,5,3,5,5,5,3,5,3,5,2,5,3,5,3,122,49,21,124
],[
2,3,2,3,2,2,2,3,5,3,5,2,5,3,5,3,123,148,250,229
],[
2,2,2,2,2,2,2,2,2,2,2,2,5,5,5,5,62,150,83,0
],[
2,3,5,3,5,5,5,3,2,3,5,5,5,3,2,3,196,198,196,235
],[
2,3,5,3,5,5,5,3,2,3,5,5,5,3,2,3,128,87,2,158
],[
2,5,5,5,5,5,5,5,5,5,5,5,5,2,2,5,93,24,241,124
],[
2,3,5,3,5,5,5,3,5,3,5,5,5,3,5,3,3,166,10,41
],[
2,3,5,3,5,5,5,3,5,3,5,5,5,3,5,3,86,223,0,156
],[
2,5,5,5,5,5,5,5,5,5,5,5,5,5,5,5,64,155,163,117
],[
177,151,4,144,228,178,218,218,227,92,36,99,77,75,16,181,87,111,28,101
],[
17,41,123,231,235,184,186,166,119,244,163,84,112,62,98,127,252,183,230,102
],[
46,176,138,10,207,98,245,136,94,223,62,165,85,73,84,171,174,66,158,116
],[
166,163,222,196,193,113,91,220,14,13,63,75,172,170,62,8,141,4,120,190
],[
122,80,161,103,87,110,95,28,169,102,243,43,85,18,28,107,170,24,56,204
],[
162,28,173,50,101,51,135,132,15,154,99,255,179,168,139,209,160,1,98,227
],[
227,13,3,246,13,168,37,241,54,27,66,121,65,75,248,195,98,49,175,166
],[
222,138,124,245,18,208,69,11,183,104,38,167,100,29,20,251,84,205,192,255
],[
106,98,190,11,114,4,231,165,170,142,252,152,129,62,140,70,158,176,23,62
],[
36,13,115,17,53,128,111,98,181,233,183,61,80,214,247,170,190,175,67,129
]
]