aLevelData = [
[
12,2,2,31,231,172,178,140,108,241,168,162,134,207,196,100,58,10,83,66
],[
2,2,2,69,57,23,63,175,18,132,83,163,231,47,14,126,113,131,127,38
],[
2,2,3,205,181,84,157,196,251,66,214,79,249,168,199,90,124,111,191,201
],[
11,2,3,107,52,250,185,251,169,115,8,33,56,249,23,77,234,133,206,85
],[
2,2,3,136,203,225,175,0,15,82,228,9,58,56,65,10,45,190,208,56
],[
85,110,135,255,127,176,190,164,238,141,231,40,171,185,121,111,29,209,45,162
],[
217,225,109,209,187,41,9,221,54,33,45,149,232,186,144,31,114,231,237,154
],[
134,92,183,1,66,149,9,82,188,27,220,240,222,3,124,70,116,183,61,174
],[
131,249,105,145,220,36,126,207,242,181,150,97,233,11,39,61,239,107,236,121
],[
207,71,35,180,195,192,249,178,138,105,67,70,187,78,110,117,89,53,185,216
],[
167,35,161,66,62,34,157,163,92,66,12,44,127,222,108,180,51,32,204,91
],[
40,199,132,109,135,40,35,137,134,115,169,2,59,56,247,133,173,42,131,252
],[
49,34,80,179,244,103,30,185,212,44,222,138,116,90,104,234,143,144,112,20
],[
140,104,182,20,83,253,126,114,96,170,64,16,21,20,160,85,85,106,160,139
],[
78,235,21,134,150,169,88,135,122,141,61,96,147,156,73,216,154,120,31,80
],[
124,42,60,167,177,30,228,92,202,111,92,242,74,102,90,153,183,61,186,10
],[
241,40,114,179,194,150,200,20,181,179,195,105,44,50,223,137,173,75,4,14
],[
125,255,185,182,112,163,150,9,255,156,247,60,155,104,248,86,65,222,157,145
],[
79,182,80,3,150,75,145,125,176,160,233,180,147,161,31,158,103,172,175,31
],[
149,80,120,229,33,85,181,145,57,252,46,23,14,135,176,103,226,252,186,77
]
]