aLevelData = [
[
5,158,129,2,249,213,108,208,23,28,239,128,161,238,107,120,183,248,168,241
],[
5,248,111,212,242,162,167,201,127,250,226,143,14,239,102,34,58,250,210,117
],[
187,72,177,182,150,27,80,212,145,110,205,63,234,216,113,239,72,178,63,167
],[
242,124,205,123,63,125,83,144,78,170,2,35,246,201,151,204,0,214,47,4
],[
148,166,93,230,242,202,122,50,99,182,60,151,110,35,138,50,78,177,143,82
],[
164,209,14,126,106,226,245,185,40,154,52,4,106,168,207,37,113,151,50,167
],[
41,246,198,34,91,182,193,188,36,211,66,240,166,55,157,142,253,219,243,3
],[
116,47,7,219,249,188,76,132,207,7,67,85,131,185,3,206,33,254,25,34
],[
167,43,147,242,186,163,88,92,152,251,187,52,78,92,79,145,43,41,252,140
],[
116,226,82,68,89,73,30,38,40,195,59,107,193,0,171,225,74,222,230,239
],[
36,139,114,211,29,234,180,47,231,57,6,196,201,240,10,125,148,236,61,175
],[
217,204,207,159,89,156,178,69,189,177,241,79,135,211,67,105,73,162,224,188
],[
20,50,147,180,52,249,16,7,26,235,137,243,154,227,124,199,87,69,207,164
],[
123,225,30,133,171,27,84,125,58,73,120,64,156,93,202,229,30,196,15,234
],[
213,142,41,121,212,206,234,233,162,68,42,136,236,57,23,152,118,171,205,151
],[
87,170,39,196,102,2,212,222,240,26,173,47,172,28,69,201,240,86,194,16
],[
36,225,236,120,120,128,132,144,210,202,215,64,10,140,147,78,90,105,216,39
],[
16,195,146,221,134,223,7,108,84,67,172,65,196,99,61,253,135,125,12,118
],[
166,194,154,254,187,182,100,233,96,217,255,73,232,135,103,252,77,29,149,233
],[
106,93,79,134,106,20,68,158,129,249,88,81,218,217,61,92,208,241,67,154
]
]