aLevelData = [
[
2,2,3,3,3,3,3,3,3,3,3,3,3,3,3,3,2,3,2,4
],[
2,2,2,2,2,2,2,2,2,2,2,2,2,2,2,2,2,2,3,184
],[
3,2,3,3,3,3,3,3,3,3,3,2,3,3,3,2,2,2,2,164
],[
2,2,2,2,2,2,2,2,2,2,2,2,2,2,3,2,2,2,2,179
],[
3,2,3,3,3,3,3,3,3,3,3,3,3,2,3,2,2,3,3,61
],[
2,2,3,2,2,2,2,2,2,2,2,2,3,2,3,2,3,2,3,232
],[
3,2,3,2,2,3,3,3,3,3,3,3,3,2,3,2,3,2,3,188
],[
2,2,3,2,2,3,2,2,2,2,2,3,3,2,3,2,3,2,2,181
],[
2,3,3,2,2,3,3,3,3,2,2,2,2,2,3,2,3,3,3,163
],[
2,2,2,2,2,2,2,2,2,3,2,3,2,2,3,2,2,2,3,191
],[
3,3,3,3,2,2,2,2,2,3,2,3,2,2,3,2,3,2,3,100
],[
8,2,6,3,2,3,3,3,3,3,2,3,2,2,3,2,3,2,3,115
],[
2,2,2,3,2,3,2,2,2,3,2,3,2,2,3,2,3,2,3,124
],[
2,2,2,2,2,3,2,2,2,3,2,3,3,3,3,2,3,2,3,50
],[
2,2,2,2,2,3,2,2,2,3,2,2,2,2,2,2,3,2,3,79
],[
9,2,12,3,2,2,2,2,3,2,3,3,3,3,3,2,3,2,3,46
],[
2,2,2,3,2,3,3,3,3,2,3,2,2,2,3,2,3,2,3,31
],[
2,2,2,3,2,2,2,2,3,13,3,1,2,2,3,2,3,2,3,16
],[
154,215,194,139,71,189,141,244,236,105,243,198,172,198,65,230,103,134,119,41
],[
46,192,88,23,250,222,189,239,157,182,46,235,248,247,179,196,111,199,232,121
]
]