aLevelData = [
[
10,2,2,8,2,2,2,2,2,2,174,159,228,58,123,225,96,61,72,51
],[
2,2,2,2,2,2,2,2,2,2,122,2,3,30,165,250,239,40,97,120
],[
2,2,2,2,2,2,3,3,3,3,153,248,200,0,13,186,100,193,73,197
],[
9,2,2,2,2,2,2,2,2,3,68,96,242,123,79,247,70,113,216,94
],[
3,3,3,3,3,3,3,2,2,3,82,209,114,169,101,252,5,241,196,115
],[
2,2,2,2,2,2,2,2,2,3,33,88,159,247,147,71,68,239,54,250
],[
2,2,2,2,2,2,2,2,2,3,147,11,12,63,178,39,141,122,2,114
],[
2,2,2,2,2,2,2,2,2,2,63,237,81,207,135,54,81,123,191,25
],[
2,2,2,2,2,2,2,2,2,2,72,240,136,128,10,10,98,192,37,105
],[
2,2,2,2,3,3,3,3,2,2,122,30,91,22,194,146,85,105,71,203
],[
2,2,2,2,3,2,2,3,2,2,149,42,192,114,173,246,98,179,174,228
],[
2,2,2,2,3,2,2,3,2,2,252,250,228,105,63,250,192,121,93,244
],[
22,239,215,54,137,47,143,226,67,10,37,240,233,226,128,118,205,14,171,39
],[
102,127,227,26,254,164,238,206,171,140,174,106,128,75,245,73,4,158,155,181
],[
227,210,206,243,228,225,170,129,27,223,9,155,96,148,157,3,0,107,60,2
],[
178,139,122,170,204,67,125,95,182,171,13,150,159,136,235,219,112,113,100,25
],[
254,48,37,22,132,107,81,61,80,132,209,160,188,189,236,61,96,160,23,128
],[
134,158,14,10,222,246,35,177,116,216,214,200,222,202,167,160,186,76,40,78
],[
88,183,86,175,179,107,41,170,166,41,106,181,92,190,197,155,9,226,31,124
],[
215,95,42,21,36,118,54,65,234,126,74,192,126,206,115,56,126,221,92,121
]
]