aLevelData = [
[
6,2,8,2,9,2,10,2,11,3,2,2,5,2,2,245,167,32,187,200
],[
2,2,2,2,2,2,2,2,12,3,5,2,2,2,5,50,176,179,38,138
],[
2,2,3,3,3,3,3,3,3,3,2,2,3,3,3,147,136,108,168,176
],[
2,2,3,2,2,2,2,2,2,2,5,2,3,2,2,21,92,82,125,133
],[
2,2,3,2,2,2,2,2,2,2,2,2,3,2,2,195,55,197,12,88
],[
2,2,3,2,3,3,3,3,3,3,2,5,3,2,2,59,168,213,232,16
],[
2,2,3,2,2,2,2,5,5,3,2,2,3,2,2,227,59,176,6,81
],[
2,2,3,5,5,5,2,3,3,3,5,2,3,3,3,59,11,36,178,41
],[
2,2,2,2,2,2,2,2,2,2,2,2,5,2,2,77,119,172,163,238
],[
2,3,2,2,3,1,3,2,2,2,2,2,5,2,2,170,15,196,235,215
],[
2,3,2,2,3,2,3,2,2,2,2,5,5,2,2,93,153,105,157,138
],[
2,3,2,3,2,2,2,3,2,2,2,2,5,2,2,217,155,115,0,208
],[
2,3,2,3,2,2,2,3,3,3,2,2,3,3,3,231,59,230,157,68
],[
2,3,2,3,2,2,2,3,2,2,5,2,5,2,2,27,162,157,231,136
],[
2,3,2,3,2,2,3,3,2,2,2,2,5,2,2,156,39,30,163,69
],[
2,3,2,3,2,2,3,3,2,2,2,5,5,2,2,122,124,201,89,243
],[
2,3,2,3,2,2,3,3,2,2,2,2,5,2,2,54,101,97,132,205
],[
9,123,97,237,190,93,252,150,152,152,52,121,141,26,201,165,134,247,20,98
],[
183,105,245,93,44,21,12,6,165,143,44,55,164,33,12,22,196,200,64,60
],[
76,128,104,23,4,193,168,140,72,74,88,225,90,29,252,219,253,203,118,35
]
]