aLevelData = [
[
5,5,186,193,216,197,87,197,127,244,149,223,235,186,99,91,13,212,212,7
],[
4,2,73,167,13,137,121,49,98,245,52,62,188,159,80,223,62,46,165,24
],[
2,2,40,242,20,217,251,120,201,47,222,91,188,188,64,92,126,101,191,181
],[
5,2,50,74,72,171,217,251,128,99,212,233,99,246,163,26,43,199,243,33
],[
2,2,116,21,216,78,157,204,87,34,113,161,39,5,7,93,184,59,230,121
],[
2,2,117,21,109,236,71,100,115,65,90,51,42,236,35,182,73,222,162,125
],[
2,2,106,87,228,237,176,252,205,241,174,41,20,237,132,136,143,244,75,227
],[
5,2,177,58,180,54,81,204,235,9,172,126,194,252,174,37,11,164,109,7
],[
2,2,69,149,247,144,124,192,77,71,106,0,175,0,226,239,26,82,111,254
],[
2,2,16,75,56,197,151,99,38,151,132,175,73,90,249,87,120,149,45,74
],[
2,2,56,203,107,48,224,8,94,161,250,185,139,148,235,192,31,26,215,200
],[
2,2,235,76,191,214,173,129,236,33,145,197,145,36,247,135,172,241,119,146
],[
2,2,45,200,34,63,90,232,11,232,114,165,7,159,144,187,176,32,211,226
],[
2,2,176,5,188,163,60,57,215,105,222,175,158,219,120,84,154,105,134,66
],[
2,2,203,37,163,54,74,213,79,68,45,70,239,201,171,227,21,162,129,133
],[
2,2,2,155,147,141,105,42,215,49,118,94,111,19,15,18,21,24,90,102
],[
188,119,127,112,116,16,175,46,143,0,101,191,2,114,235,211,14,183,33,97
],[
31,154,122,152,244,237,71,23,0,104,56,96,16,180,31,138,47,194,248,55
],[
198,97,39,198,8,16,0,202,141,16,140,186,61,190,138,234,112,32,181,185
],[
84,190,69,12,142,179,184,252,36,3,210,204,154,47,227,30,91,7,72,102
]
]