aLevelData = [
[
5,5,68,213,71,49,160,248,117,37,143,18,181,247,161,126,203,236,95,179
],[
4,2,27,103,233,97,108,164,222,189,237,169,124,24,117,122,9,183,15,141
],[
2,2,113,223,182,125,48,47,93,2,114,51,51,33,121,53,36,160,64,86
],[
5,2,163,189,94,222,167,32,44,209,243,13,42,195,155,222,159,236,196,177
],[
2,2,128,127,171,94,147,56,233,172,212,52,245,196,24,6,234,229,240,7
],[
2,2,138,90,208,237,131,169,113,160,242,14,115,73,38,39,71,171,166,241
],[
2,2,76,182,117,243,56,89,148,185,186,153,201,132,94,224,159,64,176,151
],[
5,2,174,182,164,246,28,3,53,27,100,73,77,90,86,164,229,213,96,96
],[
2,2,109,76,11,105,110,54,200,2,110,16,237,186,20,245,251,156,140,111
],[
2,2,34,167,45,141,7,126,89,53,196,96,165,188,48,89,58,180,98,186
],[
2,2,124,5,112,200,233,64,124,177,67,47,242,196,241,177,11,224,163,196
],[
2,2,150,45,53,228,247,11,214,148,112,72,105,58,159,150,43,47,72,60
],[
2,2,150,23,85,11,134,110,27,148,155,100,223,152,222,235,153,192,167,14
],[
2,2,247,142,190,132,165,148,192,133,204,228,196,220,217,199,63,62,127,178
],[
2,2,37,218,255,117,81,49,167,182,39,40,152,158,120,91,205,210,165,181
],[
2,2,89,165,8,62,240,140,143,51,169,210,170,92,2,140,104,154,37,208
],[
2,2,221,192,106,34,198,163,28,47,112,117,128,190,213,78,19,227,8,12
],[
2,2,20,117,212,93,66,195,160,26,231,131,150,215,21,11,5,184,48,196
],[
3,134,172,219,86,1,24,57,149,120,92,182,138,152,63,137,219,130,44,3
],[
233,32,53,126,249,184,88,144,146,193,1,132,37,246,209,10,244,170,158,45
]
]