aLevelData = [
[
2,2,2,2,2,2,2,2,2,2,2,2,2,2,2,104,62,31,194,177
],[
2,2,2,2,2,2,2,2,2,2,2,2,2,2,2,79,105,177,199,170
],[
2,2,2,2,2,2,2,2,2,2,2,2,2,2,2,193,172,11,122,182
],[
2,2,2,3,3,3,3,3,3,3,3,3,3,3,3,217,158,177,134,78
],[
2,2,2,2,2,2,2,2,2,2,2,2,2,2,2,209,167,52,209,221
],[
2,2,2,2,2,2,2,2,2,2,2,2,2,2,2,3,220,225,213,223
],[
2,2,2,2,2,3,2,2,3,2,2,3,2,2,2,68,251,216,39,179
],[
22,139,66,6,112,198,245,0,140,142,132,226,123,68,26,59,92,27,106,2
],[
31,208,151,226,142,149,81,213,141,78,66,244,160,255,168,142,175,133,67,119
],[
6,133,113,162,160,163,152,242,165,244,196,78,49,181,145,244,87,61,76,15
],[
102,48,85,139,106,246,199,40,246,107,91,205,33,216,138,32,207,35,242,83
],[
50,66,251,64,144,245,186,185,70,181,22,25,13,231,41,31,124,86,233,253
],[
206,224,7,171,230,112,23,129,144,44,242,5,10,239,88,2,195,249,218,218
],[
98,229,247,28,10,220,134,89,220,9,84,52,190,76,13,185,91,51,96,240
],[
107,38,94,177,53,225,35,185,82,40,185,254,179,181,57,64,230,118,51,225
],[
148,245,80,246,79,24,54,158,138,10,172,147,233,121,255,254,188,2,164,144
],[
198,233,30,206,66,14,35,172,40,28,250,94,172,4,39,107,7,170,74,3
],[
123,221,69,146,145,141,157,149,166,56,35,173,165,166,211,241,22,214,252,137
],[
88,56,161,121,42,29,31,186,113,107,17,143,53,149,113,22,236,202,0,29
],[
251,109,231,56,122,198,158,16,55,247,13,254,254,49,241,217,24,39,130,12
]
]