aLevelData = [
[
2,2,2,2,5,5,2,2,2,2,2,2,2,2,2,2,2,2,2,84
],[
2,2,2,4,2,2,2,2,2,2,2,5,2,2,2,5,2,5,2,108
],[
5,3,3,3,5,5,3,3,3,3,3,3,3,3,3,3,3,3,2,191
],[
2,3,2,2,2,2,2,2,2,3,2,2,2,2,3,2,2,2,2,98
],[
2,3,2,2,2,2,2,2,2,3,2,2,2,2,3,2,2,2,5,81
],[
2,3,2,2,3,2,2,2,2,3,2,2,2,2,3,2,2,2,5,236
],[
2,3,2,2,3,2,2,2,2,3,2,2,2,2,3,2,2,2,5,24
],[
2,3,2,2,3,5,5,3,3,3,3,3,2,2,3,2,2,2,5,13
],[
111,122,244,41,75,144,243,165,175,31,87,139,9,46,21,203,27,196,43,58
],[
243,9,53,218,30,168,59,92,25,119,206,227,8,90,83,11,170,101,158,42
],[
141,64,195,214,126,208,40,167,68,19,223,61,142,76,51,133,41,97,129,57
],[
118,129,74,166,28,9,133,178,250,169,58,29,96,195,76,7,126,19,151,179
],[
28,149,58,138,140,163,54,99,221,94,57,1,82,80,180,221,18,80,51,38
],[
33,165,238,7,143,110,155,40,240,65,135,119,12,18,229,40,215,86,102,250
],[
163,105,10,189,148,45,53,17,84,245,5,112,9,161,227,111,132,10,88,64
],[
187,160,34,124,122,81,136,31,85,173,234,213,225,72,156,116,36,96,245,201
],[
73,192,162,151,152,228,64,221,166,94,43,88,201,121,144,73,207,27,202,120
],[
240,240,235,121,0,196,152,46,234,49,27,141,89,123,179,163,184,184,46,217
],[
93,52,186,119,1,19,249,102,116,56,83,58,142,102,144,112,105,165,166,243
],[
205,232,207,229,236,236,223,157,80,99,213,236,17,82,176,165,75,184,132,92
]
]