aLevelData = [
[
2,2,2,5,2,2,2,5,2,2,136,72,82,128,131,132,81,173,198,159
],[
2,2,2,2,2,5,2,2,2,5,147,104,70,74,87,15,189,225,217,248
],[
2,2,3,3,3,3,3,3,3,3,245,157,187,78,67,11,169,27,81,189
],[
2,3,2,2,2,2,2,2,2,2,61,165,33,63,32,254,79,76,115,215
],[
2,3,2,2,2,2,2,2,2,2,151,66,109,149,150,212,69,167,213,255
],[
2,2,2,2,2,5,5,5,5,2,82,22,3,63,113,93,130,2,167,124
],[
38,93,7,72,57,254,214,5,194,98,238,54,6,72,96,180,80,101,93,254
],[
238,89,87,208,124,226,99,247,101,79,226,99,166,56,96,126,213,109,188,188
],[
98,44,137,115,30,151,181,238,249,100,104,189,16,215,47,78,231,237,90,194
],[
242,219,163,249,91,182,16,239,255,116,26,76,186,19,14,54,228,24,180,106
],[
27,59,47,139,67,97,36,185,204,202,30,102,51,140,49,101,204,64,222,68
],[
190,251,55,220,79,128,67,38,98,179,164,81,61,81,119,17,144,223,124,57
],[
179,224,119,140,48,75,214,208,129,60,147,37,27,234,92,149,171,217,242,236
],[
159,81,207,202,232,14,11,246,254,57,128,245,37,151,45,220,240,1,216,98
],[
3,20,247,57,28,41,209,159,85,135,225,48,163,216,123,254,163,218,178,227
],[
150,87,120,22,169,87,7,253,123,148,128,66,217,46,210,41,204,160,222,33
],[
213,243,217,153,119,50,241,20,246,29,51,128,95,33,172,195,200,136,206,152
],[
217,238,22,153,139,244,236,156,48,56,203,67,180,132,161,207,34,69,121,53
],[
105,63,87,116,97,128,99,37,9,146,74,84,19,245,226,142,162,204,13,59
],[
82,215,223,47,121,161,3,123,172,251,90,137,133,168,230,104,164,90,231,100
]
]