aLevelData = [
[
4,2,2,2,2,2,140,237,119,67,85,179,10,33,57,197,212,1,30,199
],[
5,2,5,3,2,2,253,62,131,140,24,237,179,126,248,102,62,65,197,0
],[
2,5,5,3,3,3,169,147,80,27,101,119,164,100,254,146,222,84,149,213
],[
3,3,5,5,5,5,62,250,144,92,125,251,144,150,97,215,163,167,144,109
],[
2,3,5,5,5,5,188,10,162,194,96,123,121,254,161,20,213,183,80,182
],[
3,3,5,5,5,5,35,114,111,170,150,103,229,136,121,133,117,88,196,182
],[
3,5,5,5,5,5,241,248,237,100,171,190,0,60,45,93,242,50,42,13
],[
3,5,5,3,3,3,51,197,180,230,130,132,174,141,5,209,133,19,153,229
],[
3,5,5,3,2,2,27,26,103,20,4,58,184,82,245,163,10,247,121,3
],[
3,5,5,3,2,2,98,191,230,170,229,21,144,236,162,145,60,198,179,191
],[
3,5,5,3,2,2,216,197,132,34,105,36,114,120,68,52,152,64,129,1
],[
5,5,5,3,2,2,229,122,173,51,114,174,191,50,19,47,77,142,45,161
],[
5,5,5,3,2,2,0,157,199,185,70,102,227,68,70,189,14,107,25,176
],[
5,3,3,3,2,2,54,53,55,34,188,77,47,182,202,6,156,239,231,156
],[
5,3,2,2,2,2,84,149,200,189,226,90,105,71,55,189,93,84,156,47
],[
5,3,3,2,2,2,99,116,235,116,57,57,255,77,181,249,105,84,17,207
],[
5,5,3,3,2,2,100,39,135,227,12,200,29,235,202,68,195,242,19,147
],[
5,5,5,5,3,3,155,88,82,192,152,27,34,74,74,84,193,201,248,5
],[
5,5,5,5,5,5,193,212,240,17,1,35,27,140,220,241,212,53,160,164
],[
250,65,66,176,68,91,80,185,213,232,38,248,17,143,101,223,174,249,161,0
]
]