aLevelData = [
[
2,2,2,2,2,11,2,2,2,2,2,2,2,2,9,2,2,2,2,2
],[
2,2,2,2,2,2,2,2,2,2,2,2,2,2,2,2,2,2,2,2
],[
5,2,5,2,5,5,5,2,5,5,5,2,5,5,5,2,5,2,5,2
],[
5,2,5,2,5,2,5,2,5,2,5,2,5,2,5,2,2,5,2,2
],[
5,5,5,2,5,5,5,2,5,5,5,2,5,5,5,2,2,5,2,2
],[
5,2,5,2,5,2,5,2,5,2,2,2,5,2,2,2,2,5,2,2
],[
5,2,5,2,5,2,5,2,5,2,2,2,5,2,2,2,5,5,5,2
],[
2,2,2,12,2,2,2,2,2,2,2,2,2,10,2,2,2,2,2,2
],[
2,2,7,2,2,2,2,2,8,2,2,2,2,2,2,2,7,2,2,6
],[
2,2,7,2,5,5,5,2,5,5,5,2,5,5,2,2,7,2,2,2
],[
2,2,7,2,5,2,2,2,2,5,2,2,5,2,5,2,7,2,2,2
],[
2,2,7,2,5,5,5,2,2,5,2,2,5,2,5,2,7,2,2,2
],[
133,48,180,204,11,107,231,205,121,15,108,40,241,74,15,129,89,252,127,227
],[
92,176,104,88,178,209,220,183,162,27,247,190,197,79,195,96,12,43,89,96
],[
4,153,73,31,89,39,60,179,154,183,216,56,59,119,228,107,224,20,173,117
],[
217,43,168,4,232,1,88,160,75,115,114,61,246,48,64,12,33,37,67,151
],[
2,57,28,13,220,59,173,218,56,24,123,123,114,82,86,145,120,173,61,52
],[
207,44,124,137,215,59,23,151,79,46,107,86,27,234,19,9,69,226,9,206
],[
67,70,13,116,120,118,75,140,253,189,56,195,160,60,189,111,45,36,151,103
],[
237,41,254,24,109,51,132,213,128,86,65,111,135,4,45,6,240,129,205,30
]
]