aLevelData = [
[
10,2,2,163,167,70,21,148,133,215,33,118,13,242,241,219,152,95,194,96
],[
2,2,2,98,56,214,141,224,237,105,253,84,138,231,191,158,61,92,251,85
],[
2,2,2,19,44,217,22,2,4,158,28,44,16,25,17,98,111,61,36,231
],[
9,2,2,228,15,92,119,206,195,44,136,90,33,71,208,247,46,181,7,10
],[
3,3,3,9,39,238,227,19,136,144,240,82,212,200,49,24,45,3,236,223
],[
2,2,2,44,71,162,120,117,117,65,101,142,203,155,131,241,172,23,236,95
],[
2,2,2,164,167,27,120,167,250,81,137,153,242,56,165,20,88,198,247,101
],[
2,2,2,207,101,86,215,6,81,26,53,50,65,46,138,188,73,103,43,54
],[
2,2,2,255,20,247,148,221,215,222,153,230,179,160,143,140,101,215,59,210
],[
248,56,16,174,148,22,163,177,151,39,95,233,230,139,122,7,134,10,39,189
],[
102,158,14,106,127,49,249,249,31,167,208,6,130,31,199,67,163,118,214,27
],[
81,13,106,149,133,205,90,122,243,104,28,186,223,225,57,12,50,78,254,213
],[
205,221,116,75,29,21,147,218,240,94,179,199,135,196,67,19,236,248,189,162
],[
134,151,217,156,234,175,2,20,244,128,6,231,23,127,17,231,241,161,220,57
],[
34,213,34,252,95,210,84,43,194,20,141,197,100,33,200,43,46,17,81,201
],[
236,77,121,248,163,151,142,35,37,75,10,41,226,228,11,3,1,193,3,167
],[
176,42,177,44,184,142,80,46,84,14,14,116,67,64,191,208,28,44,211,71
],[
226,155,133,114,216,146,86,36,150,25,186,78,93,64,17,31,168,100,216,111
],[
3,175,33,93,32,222,64,55,40,71,200,155,79,26,182,220,171,231,235,167
],[
70,96,224,231,114,97,149,229,92,45,202,180,228,251,114,204,172,177,101,245
]
]