aLevelData = [
[
2,2,2,2,2,246,179,15,244,70,124,198,214,206,156,131,138,50,52,175
],[
2,2,13,5,5,101,191,108,166,229,82,194,188,159,117,162,126,120,204,54
],[
2,2,2,5,5,58,24,176,127,193,156,25,165,107,139,193,139,92,12,134
],[
2,2,2,2,2,167,6,86,16,17,239,103,181,217,180,249,153,158,79,178
],[
2,2,2,2,2,26,92,149,155,107,134,2,211,126,85,185,133,40,95,199
],[
2,2,2,2,2,23,128,107,168,164,136,132,12,173,15,76,219,11,213,147
],[
2,2,2,2,2,118,40,241,40,64,111,112,239,93,1,63,52,185,170,75
],[
2,2,2,2,2,63,76,19,230,41,157,57,109,238,133,29,39,194,54,190
],[
2,2,2,2,2,113,169,123,68,24,66,66,126,7,227,87,142,34,235,114
],[
227,113,84,116,104,129,136,238,251,7,118,227,33,199,228,207,248,180,7,231
],[
109,89,81,163,174,119,138,122,227,240,34,236,25,227,198,198,126,25,49,162
],[
212,160,69,173,32,181,90,173,162,232,214,66,10,122,253,107,233,10,11,77
],[
102,112,128,48,50,234,188,203,190,118,203,193,171,126,130,107,130,186,203,216
],[
165,83,61,18,133,68,240,163,22,6,143,88,128,108,174,69,24,204,94,9
],[
142,95,255,84,103,234,86,166,174,158,224,89,231,61,101,225,69,127,207,83
],[
29,180,61,36,153,170,84,51,177,209,213,10,87,157,117,97,242,44,233,228
],[
14,41,64,55,82,240,117,54,178,243,69,129,230,92,62,56,26,244,25,3
],[
231,67,73,86,130,249,212,243,51,140,98,176,9,35,147,122,205,179,150,154
],[
52,103,248,55,88,70,185,28,105,16,165,188,160,104,225,115,117,56,197,15
],[
18,82,233,143,7,83,131,43,63,205,240,148,51,165,144,124,93,185,215,89
]
]