aLevelData = [
[
2,2,2,2,5,5,2,2,2,2,2,2,2,190,211,90,224,173,27,125
],[
2,2,2,4,2,2,2,2,2,2,2,5,2,198,82,100,59,1,127,134
],[
5,3,3,3,5,5,3,3,3,3,3,3,3,27,209,1,107,109,19,209
],[
2,3,2,2,2,2,2,2,2,3,2,2,2,116,35,195,143,24,226,191
],[
2,3,2,2,2,2,2,2,2,3,2,2,2,43,207,89,205,230,46,210
],[
2,3,2,2,3,2,2,2,2,3,2,2,2,224,121,83,6,151,147,131
],[
2,3,2,2,3,2,2,2,2,3,2,2,2,54,7,137,18,119,186,73
],[
2,3,2,2,3,5,5,3,3,3,3,3,2,131,78,247,145,241,124,68
],[
2,3,3,2,3,2,2,3,2,2,2,3,2,94,174,27,42,166,41,234
],[
2,2,3,2,3,2,2,3,2,1,2,3,2,56,73,21,230,75,70,199
],[
2,2,3,2,3,2,2,3,2,2,2,3,2,26,12,42,224,183,185,207
],[
2,2,3,2,3,2,2,3,2,2,2,3,2,45,103,41,66,203,223,10
],[
2,2,2,2,3,2,2,3,2,2,2,3,2,5,143,179,110,119,164,111
],[
2,2,2,2,3,2,2,3,2,2,2,3,2,134,144,118,227,172,209,207
],[
2,2,2,2,3,2,2,3,2,2,2,3,2,190,167,123,64,95,43,0
],[
195,231,160,183,158,147,36,211,139,73,211,150,21,112,70,194,69,5,89,81
],[
126,235,50,101,166,131,127,130,134,125,254,251,116,238,67,170,47,162,182,228
],[
10,179,219,172,77,90,214,39,216,6,46,81,9,171,209,237,224,93,88,194
],[
97,29,141,4,58,243,42,17,166,61,228,94,145,70,168,176,253,26,37,143
],[
164,153,138,247,223,203,145,82,198,115,188,163,153,231,222,4,95,30,222,82
]
]