aLevelData = [
[
12,2,2,2,2,2,2,2,2,2,98,61,20,201,177,213,4,16,206,225
],[
2,2,2,2,2,2,2,2,2,2,246,61,128,96,249,240,117,149,89,20
],[
2,2,3,3,3,3,3,3,3,3,125,102,115,100,246,2,199,45,135,198
],[
11,2,3,2,2,2,2,2,2,3,79,85,18,98,16,156,227,55,238,34
],[
2,2,3,2,2,2,2,2,2,3,46,4,196,42,184,194,180,29,212,204
],[
2,2,3,2,2,2,2,2,2,3,188,210,145,67,138,12,50,177,146,68
],[
10,2,3,2,2,2,2,2,2,2,222,236,93,169,153,62,36,102,115,194
],[
2,2,3,2,2,2,2,2,3,3,157,35,255,17,21,206,7,30,191,155
],[
2,2,3,2,2,2,2,3,2,2,126,95,76,73,182,46,187,168,212,110
],[
9,2,3,2,2,2,2,3,2,2,115,88,128,113,143,211,225,25,121,173
],[
2,2,3,2,2,2,3,2,2,2,200,62,186,27,43,80,16,179,214,62
],[
2,2,3,2,2,3,2,2,2,2,193,114,93,150,48,3,85,237,174,62
],[
195,129,146,240,213,29,140,218,208,61,54,252,74,115,236,19,153,9,222,96
],[
139,232,99,171,88,184,145,136,212,73,10,217,233,50,24,148,69,184,253,198
],[
80,241,132,216,97,41,220,17,49,132,166,93,144,229,77,77,86,15,150,94
],[
157,10,120,126,45,201,45,204,56,9,137,160,72,124,139,203,117,39,50,32
],[
219,8,145,51,75,253,38,96,65,225,104,15,22,248,159,55,119,141,248,33
],[
22,217,217,111,159,39,114,92,238,54,149,69,127,223,199,105,38,247,151,237
],[
0,119,46,35,169,218,40,11,175,199,162,26,71,240,148,59,63,58,98,20
],[
52,30,173,138,5,79,111,135,135,157,71,250,123,25,17,32,189,122,186,3
]
]