aLevelData = [
[
5,5,5,5,5,2,2,2,2,2,2,2,2,2,2,2,2,228,135,170
],[
5,2,2,2,2,2,2,2,2,2,2,2,2,2,2,2,2,14,165,8
],[
5,2,5,3,3,3,3,3,3,3,2,2,3,3,3,3,3,26,39,102
],[
2,2,5,2,3,2,2,2,2,2,2,2,3,2,2,2,2,227,113,170
],[
2,2,3,2,3,2,2,2,2,2,2,2,3,2,2,2,2,135,197,54
],[
2,2,3,2,3,3,3,3,3,3,2,2,3,5,5,5,5,83,226,245
],[
4,2,3,2,2,2,2,2,2,3,2,2,3,2,2,2,2,42,48,91
],[
2,2,3,2,2,3,3,3,3,3,2,2,3,3,3,2,2,145,124,6
],[
2,2,2,2,2,3,2,2,2,2,2,2,2,2,3,2,2,184,27,60
],[
2,3,2,2,2,3,2,2,2,3,2,2,3,3,3,2,2,242,180,52
],[
2,3,2,2,2,3,2,2,2,3,2,2,3,5,5,5,5,18,76,78
],[
2,3,2,3,3,2,2,3,2,3,2,2,3,2,2,2,2,166,48,208
],[
2,3,2,3,6,2,2,3,3,3,2,2,3,3,3,3,2,103,168,133
],[
2,3,2,3,8,2,2,3,2,2,2,2,2,2,3,2,2,0,140,94
],[
2,3,2,3,9,2,3,3,2,2,2,2,2,2,3,2,3,51,196,17
],[
2,3,2,3,10,2,3,3,3,2,2,2,2,2,3,2,2,160,68,84
],[
2,3,2,3,11,2,3,3,3,2,2,2,2,2,3,3,2,95,252,152
],[
2,3,3,3,12,2,2,2,3,3,2,2,3,3,3,2,2,87,142,254
],[
2,2,2,2,5,2,5,2,2,3,2,2,2,2,2,2,3,34,77,55
],[
174,85,42,131,91,216,67,136,151,129,110,214,131,129,101,76,77,220,108,49
]
]