aLevelData = [
[
2,2,2,5,2,2,2,5,2,2,2,148,201,78,199,242,154,86,120,193
],[
2,2,2,2,2,5,2,2,2,5,2,201,49,233,163,194,174,129,247,181
],[
2,2,3,3,3,3,3,3,3,3,3,73,147,80,59,71,41,37,60,2
],[
2,3,2,2,2,2,2,2,2,2,2,0,202,16,129,211,158,228,75,220
],[
2,3,2,2,2,2,2,2,2,2,8,135,96,125,153,155,135,27,204,32
],[
222,164,197,183,208,233,227,212,81,30,89,113,194,50,46,4,20,92,136,174
],[
49,247,41,181,151,143,58,52,70,60,71,17,221,46,140,48,0,138,111,230
],[
252,117,77,177,174,109,121,38,161,224,130,42,118,247,181,101,137,179,227,244
],[
209,60,101,94,8,118,92,202,12,212,61,111,134,113,142,75,201,93,234,24
],[
253,52,75,124,124,246,137,128,124,18,29,67,239,196,43,240,167,161,192,237
],[
190,113,88,85,53,60,163,169,219,168,136,194,112,130,107,10,11,154,171,236
],[
185,212,111,137,103,124,163,173,2,218,61,1,220,6,197,130,82,254,20,49
],[
172,246,92,12,68,239,104,62,235,139,37,147,136,32,98,46,2,11,212,126
],[
96,71,93,110,47,62,141,220,36,222,106,77,3,240,108,223,191,165,204,127
],[
227,114,255,91,48,30,125,154,136,26,198,75,11,16,167,156,127,190,185,77
],[
245,5,44,100,169,61,194,33,43,204,30,52,188,247,63,46,251,248,72,54
],[
193,80,130,253,73,94,163,244,148,49,81,188,11,155,226,221,103,134,102,188
],[
206,139,231,199,62,193,239,243,47,211,75,104,116,86,15,122,99,89,218,220
],[
53,61,91,16,176,199,20,34,3,115,94,150,241,11,174,159,49,121,22,146
],[
21,218,15,153,107,211,117,172,161,40,211,189,44,138,225,51,41,177,75,154
]
]