aLevelData = [
[
2,2,2,2,2,2,2,2,2,2,2,2,2,2,2,2,225,168,31,198
],[
2,2,2,2,2,2,2,2,2,2,2,2,2,2,2,2,92,235,126,114
],[
2,2,2,2,2,2,2,2,2,2,2,2,2,2,2,2,61,218,52,1
],[
2,2,2,13,2,2,2,2,2,2,2,2,2,2,2,2,183,50,29,178
],[
2,2,2,2,2,2,2,2,2,2,2,2,2,2,2,2,164,176,18,202
],[
2,2,2,2,2,2,2,2,2,2,2,2,2,2,2,2,191,119,185,32
],[
2,2,2,2,2,2,2,2,2,2,2,2,2,2,2,2,19,178,161,223
],[
2,2,2,2,2,2,2,2,2,1,2,2,2,2,2,2,179,122,142,136
],[
2,2,11,2,2,2,2,2,2,2,2,2,2,2,2,2,172,250,17,54
],[
2,2,2,2,2,2,2,2,2,2,2,2,2,2,2,2,56,209,92,38
],[
2,2,2,2,2,2,2,2,2,2,2,2,2,2,2,2,52,183,85,118
],[
2,2,2,2,2,2,2,2,2,2,2,2,2,2,2,2,212,100,233,45
],[
2,2,2,2,2,2,2,2,2,2,2,2,2,2,2,2,150,174,163,124
],[
116,241,125,68,94,179,246,215,231,136,100,3,63,52,140,77,97,16,112,122
],[
141,175,104,84,249,192,116,170,196,54,209,153,43,167,202,10,255,242,209,124
],[
86,37,206,4,130,158,183,145,63,112,97,117,48,8,150,33,141,16,103,48
],[
22,147,195,168,75,98,73,124,222,183,91,85,105,25,116,145,93,127,187,140
],[
58,184,216,31,6,10,6,103,248,26,105,200,116,11,163,49,60,234,162,161
],[
228,74,187,234,134,43,253,181,184,33,191,198,187,178,124,129,245,255,225,173
],[
161,167,35,121,198,232,150,188,101,7,124,129,247,242,26,195,23,37,18,117
]
]