aLevelData = [
[
4,2,5,5,2,2,2,2,2,2,2,2,181,250,92,148,7,204,209,182
],[
2,2,2,2,2,2,5,2,2,2,5,2,92,221,174,51,236,87,4,34
],[
2,2,2,2,2,2,3,3,3,3,3,3,130,166,31,248,211,128,112,169
],[
3,3,3,3,3,3,3,2,2,2,2,2,14,34,203,16,180,221,211,145
],[
2,2,3,2,2,2,2,2,2,2,2,2,170,210,178,253,141,250,13,181
],[
13,2,3,2,2,2,2,2,2,3,2,2,69,105,54,19,221,211,164,5
],[
2,5,3,2,2,2,2,2,2,3,2,2,145,79,161,251,41,91,67,4
],[
2,12,3,2,2,2,2,2,2,3,2,2,134,32,157,51,123,248,54,72
],[
5,2,3,3,3,3,3,3,3,3,2,2,222,46,187,140,222,5,240,253
],[
11,2,3,2,2,2,2,2,2,2,2,2,150,251,236,171,227,78,134,98
],[
2,5,3,2,2,2,2,2,2,2,2,2,115,192,11,137,31,151,50,74
],[
123,233,81,244,171,22,208,157,120,150,222,11,163,245,100,213,120,27,55,197
],[
167,209,146,129,80,129,195,106,93,61,36,197,20,3,77,25,236,64,136,215
],[
160,146,134,64,131,210,80,132,19,82,127,39,208,99,176,169,79,27,51,102
],[
138,85,3,187,122,248,251,106,232,125,70,64,128,171,24,245,39,165,155,83
],[
142,39,45,154,7,13,200,36,152,21,193,69,78,229,182,117,212,80,194,177
],[
68,213,242,30,61,104,253,240,54,118,47,138,18,35,167,230,244,214,194,56
],[
84,247,215,206,83,247,37,59,75,145,9,180,171,80,117,186,2,82,157,250
],[
89,75,243,113,198,204,86,211,62,198,134,46,171,74,220,202,62,146,56,85
],[
7,69,58,60,195,247,181,92,245,239,96,218,56,46,207,79,211,173,162,41
]
]