aLevelData = [
[
4,2,5,5,2,2,2,2,2,2,2,44,124,145,119,198,132,60,107,78
],[
2,2,2,2,2,2,5,2,2,2,5,4,176,111,93,196,232,167,88,41
],[
2,2,2,2,2,2,3,3,3,3,3,0,201,239,171,226,45,233,136,33
],[
36,36,186,37,139,215,39,137,160,27,25,193,20,170,237,0,97,230,15,88
],[
93,29,38,36,15,11,139,163,194,160,0,229,89,4,159,235,226,217,16,10
],[
110,192,255,144,31,30,205,170,130,32,134,133,31,252,20,180,79,122,178,210
],[
78,180,163,104,145,25,35,16,90,184,158,219,137,188,32,241,181,50,13,119
],[
123,19,18,182,22,126,91,121,48,69,6,182,248,171,216,113,117,108,47,222
],[
26,254,56,198,154,23,98,43,254,111,19,47,244,199,153,50,106,42,99,59
],[
91,115,113,153,233,15,9,202,173,4,172,155,75,50,72,145,73,217,175,136
],[
33,92,72,154,148,69,4,66,66,136,148,193,120,12,218,193,73,103,157,57
],[
224,234,128,144,20,221,53,5,61,11,238,78,70,130,20,127,4,148,60,46
],[
198,33,87,213,46,25,40,119,63,60,252,135,182,36,149,5,158,134,103,234
],[
31,181,7,198,151,103,224,168,236,188,40,62,32,124,18,61,37,160,69,3
],[
243,21,142,124,217,188,209,66,16,181,70,8,150,221,225,56,57,149,18,219
],[
242,198,175,186,117,34,47,194,6,172,24,173,142,122,186,223,238,185,30,142
],[
147,243,58,38,75,141,102,236,87,148,20,225,193,185,187,233,240,153,20,44
],[
121,66,137,189,56,243,235,122,160,36,99,51,79,198,171,14,229,204,125,41
],[
23,234,76,130,255,157,51,20,182,107,43,67,37,108,128,122,24,9,134,19
],[
148,4,136,119,107,185,1,134,13,163,14,57,161,33,36,133,85,122,254,131
]
]