aLevelData = [
[
2,2,2,2,2,2,2,2,2,2,2,2,2,2,2,2,2,2,2,143
],[
2,2,13,5,5,2,2,12,5,5,2,3,2,5,5,2,2,2,2,242
],[
2,2,2,5,5,2,2,2,5,5,2,3,2,5,5,2,2,2,2,126
],[
2,2,2,2,2,2,2,2,2,2,2,3,2,2,2,2,2,2,2,44
],[
2,2,2,2,2,2,2,2,2,2,2,3,3,3,3,3,3,3,3,221
],[
2,2,2,2,2,2,2,2,2,2,2,2,2,2,6,2,2,2,2,142
],[
2,2,2,2,2,2,2,2,2,2,2,2,2,3,3,3,2,3,3,96
],[
2,2,2,2,2,2,2,2,2,2,2,2,2,2,2,2,2,2,2,168
],[
2,2,2,2,2,2,2,2,2,2,3,2,2,2,2,2,2,2,2,65
],[
2,2,2,2,2,2,2,2,2,3,3,2,3,2,2,2,2,2,3,22
],[
2,2,2,2,2,2,2,2,3,3,2,9,3,3,2,2,2,2,3,234
],[
2,2,2,2,2,2,2,2,3,2,2,2,3,3,2,2,2,2,3,231
],[
4,2,2,2,2,2,2,3,2,2,2,2,3,2,2,2,2,2,3,52
],[
2,2,2,2,2,3,3,2,2,2,2,3,3,2,2,2,2,2,3,115
],[
2,2,2,3,2,2,11,2,2,2,3,3,2,2,3,3,3,3,3,112
],[
187,203,181,213,71,46,179,164,193,76,242,92,119,205,201,12,16,72,194,32
],[
21,183,66,123,176,40,109,198,179,181,68,7,219,181,16,117,87,52,4,139
],[
132,161,30,91,251,199,78,37,205,255,218,40,13,163,1,184,143,197,223,145
],[
240,33,144,107,214,81,152,206,121,64,130,40,99,225,200,29,116,33,243,30
],[
40,26,3,61,29,137,17,63,207,130,51,243,166,98,160,195,52,6,21,137
]
]