aLevelData = [
[
2,2,2,2,2,196,228,14,35,153,199,130,175,120,222,90,14,232,41,230
],[
2,2,2,2,2,94,93,220,223,130,254,13,77,118,171,175,168,223,63,195
],[
2,2,2,2,2,62,231,18,205,212,71,195,133,144,165,52,208,23,33,213
],[
2,2,2,3,3,238,242,43,38,245,54,151,119,126,100,243,242,158,142,24
],[
2,2,2,2,2,220,24,187,255,24,208,141,214,237,131,33,83,9,182,55
],[
2,2,2,2,2,73,197,236,147,121,170,28,163,170,52,98,97,252,215,245
],[
2,2,2,2,2,123,121,64,89,177,237,221,214,127,247,159,40,253,97,255
],[
2,2,2,3,3,120,3,173,63,139,144,240,242,58,109,228,190,34,13,56
],[
2,2,2,2,2,97,156,184,42,242,240,233,88,105,197,244,211,98,220,235
],[
2,2,2,2,2,118,30,254,195,118,203,51,179,57,5,53,221,108,156,36
],[
2,2,3,3,3,48,80,152,123,141,84,122,67,40,233,197,135,50,146,189
],[
2,2,2,2,2,7,181,58,111,48,191,203,241,76,194,252,235,247,59,107
],[
2,2,2,2,2,86,210,146,235,132,123,65,31,97,188,57,72,248,2,129
],[
2,2,3,3,3,91,57,17,33,87,249,247,62,213,58,62,134,224,173,102
],[
2,2,3,2,2,207,8,117,147,250,178,46,130,30,178,46,193,227,28,10
],[
2,2,3,2,2,32,43,86,92,99,248,114,196,57,138,187,45,114,199,142
],[
2,2,3,3,3,82,108,224,108,128,206,50,76,157,121,106,54,105,188,237
],[
2,2,2,2,2,13,4,199,119,173,177,99,1,54,217,224,233,166,83,78
],[
77,174,226,240,183,190,255,237,0,99,217,73,110,210,155,20,32,197,237,225
],[
172,133,189,122,6,72,63,210,164,190,50,59,223,231,102,217,157,39,123,87
]
]