aLevelData = [
[
2,2,2,2,2,11,2,2,2,2,2,2,2,2,9,2,2,2,2,2
],[
2,2,2,2,2,2,2,2,2,2,2,2,2,2,2,2,2,2,2,2
],[
5,2,5,2,5,5,5,2,5,5,5,2,5,5,5,2,5,2,5,2
],[
5,2,5,2,5,2,5,2,5,2,5,2,5,2,5,2,2,5,2,2
],[
5,5,5,2,5,5,5,2,5,5,5,2,5,5,5,2,2,5,2,2
],[
5,2,5,2,5,2,5,2,5,2,2,2,5,2,2,2,2,5,2,2
],[
5,2,5,2,5,2,5,2,5,2,2,2,5,2,2,2,5,5,5,2
],[
12,163,75,55,52,172,234,110,154,163,209,152,188,152,29,112,62,51,41,248
],[
234,166,174,14,245,224,47,64,131,3,148,225,110,25,21,92,67,3,89,201
],[
142,177,223,190,88,153,158,104,237,97,232,218,227,223,148,164,87,68,92,168
],[
122,148,132,41,77,90,189,37,168,153,72,229,129,5,94,210,107,115,208,138
],[
93,143,235,51,181,205,158,16,124,162,223,81,236,243,74,48,47,206,11,57
],[
106,88,255,233,250,6,22,123,254,16,252,255,21,35,248,172,105,87,20,119
],[
236,96,126,229,225,8,46,29,159,221,201,65,145,38,197,254,130,28,207,98
],[
23,87,105,238,157,135,216,237,5,100,61,4,45,232,2,9,98,187,119,24
],[
34,239,189,228,38,237,228,76,160,175,80,47,193,48,97,128,126,33,83,157
],[
148,222,98,220,201,160,50,103,117,244,111,75,66,108,176,203,48,148,162,250
],[
220,39,98,137,1,131,42,221,63,91,48,100,27,172,203,42,72,242,216,167
],[
37,155,92,220,134,188,107,158,183,3,72,49,190,237,205,24,225,56,13,44
],[
104,156,57,236,164,182,192,20,48,69,186,113,119,152,135,243,118,71,179,4
]
]