aLevelData = [
[
10,2,2,8,2,2,2,2,2,2,207,214,175,197,83,44,68,126,250,252
],[
2,2,2,2,2,2,2,2,2,2,202,79,160,253,41,79,142,169,4,98
],[
2,2,2,2,2,2,3,3,3,3,169,158,144,186,234,68,167,157,14,176
],[
9,2,2,2,2,2,2,2,2,3,24,104,143,200,66,212,210,168,225,120
],[
3,3,3,3,3,3,3,2,2,3,162,69,39,143,221,80,15,252,109,94
],[
2,2,2,2,2,2,2,2,2,3,238,139,122,69,74,122,222,201,240,56
],[
2,2,2,2,2,2,2,2,2,3,218,120,65,108,7,210,205,57,143,173
],[
2,2,2,2,2,2,2,2,2,2,35,192,156,216,230,231,17,255,36,89
],[
2,2,2,2,2,2,2,2,2,2,121,206,228,207,60,89,254,141,25,188
],[
2,2,2,2,3,3,3,3,2,2,48,47,208,254,109,165,31,60,120,125
],[
2,2,2,2,3,2,2,3,2,2,240,3,178,96,209,253,49,224,164,208
],[
2,2,2,2,3,2,2,3,2,2,17,113,152,67,15,180,88,163,83,252
],[
2,2,2,2,3,2,2,3,2,2,130,101,142,11,90,12,69,28,192,77
],[
2,2,2,2,3,2,2,3,2,2,109,39,95,113,55,96,40,252,45,0
],[
255,140,126,73,179,3,150,196,52,232,242,206,0,11,51,82,223,104,113,216
],[
208,78,209,191,67,193,90,198,136,28,4,210,136,251,18,235,179,87,162,135
],[
57,243,131,11,125,247,70,143,199,219,152,225,56,135,207,205,4,185,194,156
],[
219,166,222,219,168,228,118,94,126,135,91,132,207,139,173,187,224,114,240,71
],[
121,45,98,64,225,64,140,218,10,34,24,234,8,226,226,165,199,16,82,170
],[
254,219,232,67,95,119,24,231,17,194,89,4,95,38,121,252,178,193,51,109
]
]