aLevelData = [
[
10,2,2,8,2,2,2,2,2,2,2,2,2,2,2,2,102,53,65,160
],[
2,2,2,2,2,2,2,2,2,2,2,2,2,2,2,2,44,2,195,162
],[
2,2,2,2,2,2,3,3,3,3,2,2,2,2,2,3,206,98,15,183
],[
9,2,2,2,2,2,2,2,2,3,2,2,2,2,2,3,229,91,166,172
],[
3,3,3,3,3,3,3,2,2,3,2,2,2,2,2,2,23,206,118,6
],[
2,2,2,2,2,2,2,2,2,3,2,2,2,2,2,3,233,249,81,161
],[
2,2,2,2,2,2,2,2,2,3,3,2,2,2,2,3,213,63,158,151
],[
2,2,2,2,2,2,2,2,2,2,3,2,2,2,2,3,157,44,79,99
],[
2,2,2,2,2,2,2,2,2,2,3,2,2,2,2,3,222,180,19,71
],[
2,2,2,2,3,3,3,3,2,2,3,2,2,2,2,3,232,187,204,235
],[
2,2,2,2,3,2,2,3,2,2,3,2,2,2,2,3,205,219,67,70
],[
2,2,2,2,3,2,2,3,2,2,3,3,3,5,2,3,184,97,26,193
],[
2,2,2,2,3,2,2,3,2,2,2,2,3,2,2,3,128,152,3,154
],[
2,2,2,2,3,2,2,3,2,2,2,2,3,2,2,3,125,75,48,135
],[
2,2,2,2,3,2,2,3,2,2,2,2,3,2,2,3,155,133,11,157
],[
172,155,38,111,3,108,117,122,62,232,187,193,99,207,66,180,47,187,207,86
],[
170,97,213,159,255,20,233,31,139,139,118,229,52,227,178,159,252,231,208,3
],[
213,144,120,109,184,200,116,201,241,115,172,179,189,176,84,221,22,92,100,177
],[
206,217,72,56,219,13,217,59,242,173,141,168,87,187,234,54,243,77,65,76
],[
167,145,152,32,224,14,232,28,107,44,137,133,139,247,234,94,73,32,133,138
]
]