aLevelData = [
[
2,2,2,2,2,2,2,2,2,2,2,2,108,43,121,29,250,187,95,235
],[
2,2,13,5,5,2,2,12,5,5,2,3,73,218,23,195,6,23,70,193
],[
2,2,2,5,5,2,2,2,5,5,2,3,170,146,221,37,68,177,248,168
],[
2,2,2,2,2,2,2,2,2,2,2,3,121,21,7,17,201,205,43,3
],[
20,201,227,25,92,145,231,53,204,55,84,20,249,137,10,38,105,140,82,157
],[
82,38,197,196,163,27,105,147,72,59,28,128,170,217,54,151,118,126,106,205
],[
160,223,237,146,167,13,218,165,26,236,214,44,91,230,240,4,163,224,202,86
],[
70,109,254,107,57,66,187,193,209,235,175,94,205,188,42,100,151,9,128,230
],[
199,154,175,250,233,89,65,15,128,78,116,129,75,205,153,107,198,238,186,189
],[
244,62,127,142,92,180,82,179,81,231,194,144,119,125,37,46,131,231,130,142
],[
66,76,174,61,221,194,180,41,91,196,122,179,103,225,162,5,84,177,175,166
],[
94,13,105,75,51,127,130,241,178,248,121,40,242,193,191,178,134,180,25,76
],[
255,172,69,204,179,58,224,108,189,154,135,102,69,229,61,193,2,135,12,106
],[
252,244,239,134,151,151,240,7,205,11,142,125,187,142,97,47,95,179,1,107
],[
160,87,35,26,142,213,5,151,236,126,13,194,236,67,173,80,57,181,137,101
],[
58,48,220,100,150,82,23,6,243,178,204,169,4,207,203,235,194,71,139,120
],[
249,74,203,32,7,77,120,45,224,3,210,243,86,137,203,168,152,225,175,118
],[
248,161,10,207,241,236,199,1,104,162,149,10,50,212,143,173,215,123,27,197
],[
149,105,18,218,168,127,34,242,201,33,113,169,245,231,131,132,111,149,94,131
],[
8,78,236,245,158,4,160,144,227,51,92,193,95,207,147,65,185,123,171,233
]
]