aLevelData = [
[
2,2,2,2,2,2,107,9,13,153,154,93,176,16,82,27,6,156,69,186
],[
2,2,13,5,5,2,251,136,99,255,145,222,90,111,130,127,89,10,39,114
],[
2,2,2,5,5,2,26,54,152,125,31,250,21,242,60,108,165,204,85,109
],[
2,2,2,2,2,2,252,250,105,147,162,251,207,103,82,171,192,209,161,93
],[
22,208,224,41,83,110,66,136,229,244,66,30,169,90,63,214,173,1,105,52
],[
58,165,225,231,18,141,28,158,246,4,137,29,107,13,115,144,190,83,40,31
],[
70,95,91,194,233,13,199,87,225,65,21,242,192,214,0,116,178,215,183,95
],[
3,242,130,232,225,41,169,78,98,203,146,107,201,163,41,137,5,111,132,118
],[
122,148,200,219,4,15,70,201,57,175,234,149,239,129,214,230,255,140,74,12
],[
72,191,199,147,246,40,116,24,4,103,192,92,255,97,73,151,13,57,253,15
],[
47,124,126,232,195,155,203,62,77,159,30,113,118,24,16,192,85,86,3,26
],[
238,220,193,48,248,18,97,207,228,58,107,109,26,165,60,2,134,39,171,25
],[
83,200,236,38,246,188,181,26,111,150,160,53,203,184,209,27,238,14,216,43
],[
143,252,216,12,132,148,233,136,64,13,188,158,154,112,126,210,208,149,254,200
],[
203,78,17,17,164,226,54,69,104,189,118,82,24,101,142,19,244,176,80,37
],[
249,53,71,246,169,0,154,30,10,138,50,243,241,232,31,87,128,66,56,213
],[
238,135,2,237,134,95,212,171,243,97,56,127,186,135,147,72,8,222,9,178
],[
174,130,155,194,106,202,146,175,104,192,33,244,8,212,70,163,226,209,241,252
],[
8,15,104,62,138,235,234,189,64,116,146,53,195,103,127,94,189,94,50,192
],[
99,68,55,201,63,12,8,29,51,162,46,45,187,34,169,11,114,73,146,125
]
]