aLevelData = [
[
4,2,2,2,2,2,2,2,2,2,8,47,121,11,49,154,125,110,255,141
],[
2,2,3,2,9,2,2,2,2,2,2,207,54,171,192,214,129,234,223,30
],[
2,3,2,2,2,2,3,2,2,3,2,250,205,141,78,253,79,169,90,252
],[
2,3,2,2,2,3,2,2,3,2,2,43,208,249,33,240,35,90,52,86
],[
2,3,2,2,3,2,2,3,2,2,2,74,18,192,211,185,90,113,106,49
],[
2,3,2,3,2,2,3,2,2,3,2,119,193,196,138,121,211,129,177,40
],[
2,2,3,2,2,3,2,2,3,2,2,159,208,237,60,80,61,102,204,234
],[
2,2,2,2,3,2,2,3,2,2,2,203,231,9,48,67,227,44,197,203
],[
2,2,2,3,2,2,3,2,2,3,2,182,173,145,186,46,182,102,171,74
],[
2,2,3,2,2,3,2,2,3,2,2,215,228,209,65,251,154,138,198,155
],[
2,2,5,2,3,2,2,3,2,2,2,109,54,139,49,62,73,4,240,199
],[
2,2,2,3,2,2,3,2,2,3,2,159,109,178,198,16,14,50,94,69
],[
2,2,3,2,5,3,2,2,3,2,2,190,123,186,201,166,160,243,99,71
],[
2,3,2,2,3,5,2,3,2,2,2,174,52,164,191,223,28,188,71,16
],[
2,2,2,3,2,2,3,2,2,3,2,99,146,1,117,193,19,241,140,11
],[
201,72,79,160,176,233,174,3,70,38,60,201,226,202,41,182,70,93,112,35
],[
119,163,81,162,205,102,2,229,70,117,162,220,31,237,110,30,166,183,55,138
],[
74,82,20,46,244,211,84,104,154,42,182,74,17,166,221,67,34,188,254,252
],[
225,4,220,129,58,132,246,161,205,49,254,151,252,179,142,234,65,105,23,145
],[
197,173,26,91,47,89,154,142,186,137,209,206,139,163,34,65,65,149,79,241
]
]