aLevelData = [
[
2,2,2,2,2,2,2,2,2,6,5,2,194,246,16,79,218,147,203,167
],[
2,3,5,3,5,5,5,3,5,3,5,2,118,17,158,141,235,127,40,177
],[
2,3,2,3,2,2,2,3,5,3,5,2,117,62,24,153,214,19,240,78
],[
64,122,10,85,117,61,216,224,45,70,111,70,184,177,71,177,228,38,60,22
],[
33,102,217,107,227,35,214,20,72,21,223,158,251,74,152,175,88,190,221,61
],[
209,43,78,255,144,34,11,33,93,91,188,60,195,74,213,133,110,242,24,69
],[
216,254,91,137,37,14,139,26,75,79,241,175,117,78,180,98,170,14,159,97
],[
169,88,37,230,24,82,162,105,222,83,228,20,206,246,234,119,133,109,235,125
],[
149,24,155,158,227,86,169,87,77,156,140,215,144,196,127,252,105,167,202,125
],[
251,237,68,105,113,36,22,208,228,16,193,191,127,66,99,114,225,236,54,198
],[
194,244,89,237,218,71,211,101,254,112,213,43,141,105,63,44,10,177,102,252
],[
10,158,20,202,81,245,209,148,56,184,97,151,82,63,142,10,78,138,40,11
],[
31,214,73,218,91,110,221,69,225,196,98,99,191,192,237,133,83,88,110,106
],[
176,97,52,178,66,165,180,149,182,53,134,213,20,1,176,241,46,165,39,156
],[
62,134,147,109,203,30,83,216,204,148,193,93,16,144,183,255,221,77,82,248
],[
216,240,245,171,36,24,145,218,206,182,36,25,105,31,128,131,245,95,78,171
],[
6,208,82,214,34,236,241,103,106,96,240,154,124,97,126,117,153,67,117,252
],[
3,72,221,165,169,182,178,11,6,44,230,230,71,53,170,59,172,30,234,208
],[
48,5,22,227,108,51,40,27,185,172,227,191,149,3,88,38,72,115,175,111
],[
199,44,36,114,216,235,80,245,119,205,170,36,120,101,77,59,111,12,252,134
]
]