aLevelData = [
[
2,2,2,2,2,2,105,34,171,168,216,255,212,44,144,80,184,50,162,238
],[
2,2,2,2,2,2,162,111,63,88,224,131,217,74,14,44,133,145,151,185
],[
2,2,2,2,2,2,164,29,120,194,194,88,71,23,190,182,116,246,43,141
],[
2,2,2,3,3,3,208,129,247,40,75,110,74,23,2,1,177,200,121,55
],[
2,2,2,2,2,2,124,92,36,69,101,179,45,64,114,201,113,30,28,70
],[
2,2,2,2,2,2,204,221,176,80,150,2,246,164,109,69,17,229,53,139
],[
2,2,2,2,2,3,166,51,94,20,64,0,101,246,243,31,158,202,64,30
],[
2,2,2,3,3,3,48,165,57,214,97,74,229,64,20,157,230,139,143,91
],[
89,107,130,9,254,179,69,42,153,38,98,181,152,138,83,198,245,255,141,148
],[
94,143,189,163,148,6,81,59,17,4,58,24,237,80,240,99,2,111,183,225
],[
79,118,34,107,154,28,213,158,89,19,142,211,211,153,103,81,131,74,85,194
],[
189,56,245,228,148,61,136,129,250,144,59,161,41,151,173,254,66,252,171,184
],[
52,3,62,74,224,27,231,189,123,179,41,28,51,78,72,39,21,218,81,75
],[
46,61,90,210,240,50,11,88,216,83,93,126,78,118,162,226,205,61,198,78
],[
67,233,212,47,187,111,187,73,57,206,83,170,229,159,155,220,108,238,69,95
],[
164,72,116,86,111,21,196,129,225,41,139,107,165,149,94,229,156,195,215,178
],[
200,194,150,132,105,222,134,40,101,116,97,253,237,4,119,170,94,136,171,16
],[
101,4,190,126,103,95,208,36,32,113,35,203,138,93,35,195,0,33,163,28
],[
163,107,106,25,253,175,238,225,228,118,95,120,161,249,231,238,82,238,49,214
],[
141,162,40,250,70,72,1,77,243,144,123,33,237,124,101,154,26,112,97,99
]
]