aLevelData = [
[
2,138,29,141,182,1,61,220,248,235,175,61,247,202,185,105,212,78,29,170
],[
2,4,38,158,75,246,22,193,76,245,74,209,91,79,234,37,0,183,238,166
],[
3,24,232,52,139,132,139,207,103,34,91,163,102,252,135,47,211,192,87,169
],[
2,222,113,19,80,157,91,33,254,80,76,109,252,233,1,14,27,204,223,38
],[
3,0,211,228,9,192,149,220,162,173,232,216,19,111,164,220,156,86,170,216
],[
2,190,238,37,217,160,212,16,129,177,201,249,181,143,5,4,149,40,205,50
],[
3,177,31,72,227,121,113,143,154,246,88,3,1,184,111,227,45,16,23,30
],[
2,34,127,26,101,154,109,143,133,2,30,254,244,198,227,196,169,206,141,184
],[
2,49,73,39,14,0,169,229,124,5,238,87,156,129,40,226,146,24,55,113
],[
238,41,214,104,212,91,216,218,90,120,176,251,49,127,55,216,136,244,170,69
],[
45,123,242,23,245,165,41,148,95,10,89,40,116,152,135,90,241,42,240,253
],[
168,92,146,171,36,158,238,111,140,136,13,194,201,110,193,185,235,51,45,124
],[
201,98,135,250,232,122,29,219,159,138,150,182,120,254,123,133,216,185,246,86
],[
227,100,217,67,154,5,225,163,70,211,61,130,26,73,74,79,20,121,161,213
],[
36,163,83,109,144,6,115,113,151,246,213,243,85,47,22,175,230,105,220,63
],[
206,44,95,142,152,230,41,143,190,59,26,47,201,156,174,136,185,27,131,87
],[
167,125,21,176,169,145,204,240,246,193,58,244,75,231,157,136,141,98,172,34
],[
175,104,144,209,214,157,48,112,187,229,177,31,81,119,61,244,169,52,4,237
],[
18,54,129,41,132,171,255,88,63,228,91,113,175,169,11,163,147,208,95,141
],[
94,14,7,177,221,12,214,38,27,189,198,142,130,240,59,72,66,33,140,231
]
]