aLevelData = [
[
2,2,2,2,2,2,2,2,2,6,5,2,2,2,2,167,221,109,146,81
],[
2,3,5,3,5,5,5,3,5,3,5,2,5,3,5,122,0,221,166,24
],[
2,3,2,3,2,2,2,3,5,3,5,2,5,3,5,140,71,134,104,15
],[
2,2,2,2,2,2,2,2,2,2,2,2,5,5,5,163,2,132,76,121
],[
2,3,5,3,5,5,5,3,2,3,5,5,5,3,2,19,211,30,10,139
],[
2,3,5,3,5,5,5,3,2,3,5,5,5,3,2,44,13,143,75,62
],[
2,5,5,5,5,5,5,5,5,5,5,5,5,2,2,31,194,183,47,240
],[
2,3,5,3,5,5,5,3,5,3,5,5,5,3,5,159,103,131,5,108
],[
2,3,5,3,5,5,5,3,5,3,5,5,5,3,5,31,64,94,247,2
],[
2,5,5,5,5,5,5,5,5,5,5,5,5,5,5,79,74,31,2,38
],[
2,3,5,3,2,2,2,3,2,3,2,2,2,3,2,128,149,155,164,106
],[
5,3,5,3,2,2,2,3,2,3,2,2,2,3,2,228,193,60,196,175
],[
5,5,5,5,5,5,5,5,5,5,5,5,5,5,5,23,86,102,58,97
],[
5,3,5,3,5,5,5,3,5,3,5,5,2,3,2,242,94,45,60,143
],[
5,3,5,3,5,5,5,3,5,3,5,5,2,3,2,66,148,13,75,197
],[
1,5,5,5,5,5,5,5,5,5,5,5,5,5,5,41,55,75,135,214
],[
5,3,2,3,2,2,2,3,2,3,2,2,2,3,2,145,93,50,118,23
],[
220,194,220,223,213,36,22,79,103,3,242,142,112,223,194,56,102,95,93,86
],[
130,232,102,141,36,110,209,149,115,138,162,237,67,205,248,205,61,85,75,93
],[
57,157,242,36,239,153,232,195,207,3,207,227,45,240,53,108,161,166,23,247
]
]