aLevelData = [
[
6,2,225,216,66,135,221,95,120,192,225,127,209,199,211,215,129,212,151,11
],[
2,2,169,80,130,104,113,151,18,203,87,253,220,190,199,15,197,229,235,27
],[
2,2,117,153,196,242,9,210,122,236,8,74,240,45,153,223,156,39,243,57
],[
3,3,150,96,20,174,238,117,182,98,67,96,127,179,145,246,120,212,75,179
],[
2,2,192,183,170,186,130,49,68,24,36,89,224,73,193,49,137,253,218,136
],[
2,2,225,28,72,30,184,7,117,10,221,33,204,89,52,142,110,248,9,58
],[
2,2,39,212,164,29,160,63,30,190,214,150,115,246,202,32,215,247,123,58
],[
2,2,78,140,17,177,119,163,91,112,168,8,123,91,64,115,224,122,57,197
],[
2,2,117,90,253,143,24,176,123,212,78,64,121,16,53,253,44,120,186,114
],[
2,2,6,132,11,96,207,171,80,169,247,109,150,108,43,151,11,114,38,195
],[
3,3,113,201,202,30,205,174,111,110,95,177,123,83,215,19,50,204,198,115
],[
2,2,208,254,83,169,213,49,47,243,161,28,203,79,64,98,200,39,135,92
],[
2,2,175,51,96,25,226,156,98,163,210,93,165,132,115,239,212,137,237,37
],[
2,2,131,198,149,85,195,218,27,184,244,117,4,19,219,23,91,151,245,26
],[
2,2,164,6,10,242,18,24,4,180,250,29,2,213,134,227,169,52,174,218
],[
2,2,186,91,100,118,234,2,15,213,238,213,59,162,213,120,143,57,154,199
],[
2,2,255,12,250,98,67,69,131,105,135,173,238,132,100,204,174,39,15,82
],[
2,2,201,20,208,181,231,33,182,28,168,59,138,124,59,171,1,0,45,152
],[
3,3,53,175,126,205,86,73,250,189,157,113,198,196,130,17,58,176,47,251
],[
238,128,52,204,24,108,124,22,21,37,128,190,69,93,186,162,28,138,93,127
]
]