aLevelData = [
[
5,5,5,5,5,2,2,2,2,2,2,2,2,2,2,2,2,2,2,125
],[
5,2,2,2,2,2,2,2,2,2,2,2,2,2,2,2,2,2,2,154
],[
5,2,5,3,3,3,3,3,3,3,2,2,3,3,3,3,3,3,2,49
],[
2,2,5,2,3,2,2,2,2,2,2,2,3,2,2,2,2,3,2,19
],[
41,166,30,93,96,3,69,111,212,233,14,227,70,101,97,211,250,254,185,156
],[
104,153,123,226,52,154,135,213,96,76,12,178,193,131,160,140,175,128,144,76
],[
1,20,116,247,57,9,7,47,251,189,54,253,196,16,119,205,216,128,92,186
],[
124,147,104,12,102,118,33,255,114,227,102,199,150,71,3,208,24,37,131,74
],[
254,181,70,229,199,210,211,217,88,19,110,42,57,55,238,42,1,198,201,63
],[
15,245,113,230,123,202,227,248,76,130,124,45,236,48,15,222,217,166,54,15
],[
156,152,229,172,255,255,69,19,123,188,191,211,240,126,86,179,153,229,59,247
],[
62,232,155,222,171,116,188,111,98,85,72,117,141,90,233,201,54,180,21,207
],[
186,160,44,67,123,70,192,54,214,224,51,83,85,30,136,103,37,201,115,33
],[
202,168,178,22,17,160,160,7,70,30,8,103,168,186,55,24,26,20,85,118
],[
27,2,245,150,248,238,234,207,64,121,92,122,121,100,28,247,17,177,53,241
],[
152,5,196,226,44,81,9,217,52,177,189,123,81,149,166,71,145,30,106,31
],[
230,203,161,4,215,84,45,34,118,214,206,12,146,49,241,72,45,174,201,14
],[
48,230,161,77,94,223,113,239,135,119,175,94,254,6,103,71,77,63,142,158
],[
38,87,148,226,157,106,56,162,149,26,160,64,120,121,169,245,44,41,124,21
],[
66,193,98,148,112,115,217,202,65,236,231,115,11,124,174,250,34,119,65,247
]
]