aLevelData = [
[
2,2,2,2,2,11,2,2,2,2,2,2,2,9,231,174,228,151,172,82
],[
2,2,2,2,2,2,2,2,2,2,2,2,2,97,26,112,96,105,175,234
],[
5,2,5,2,5,5,5,2,5,5,5,2,5,133,129,22,236,26,44,19
],[
5,2,5,2,5,2,5,2,5,2,5,2,5,57,168,97,19,152,172,60
],[
5,5,5,2,5,5,5,2,5,5,5,2,5,19,38,151,244,190,240,25
],[
5,2,5,2,5,2,5,2,5,2,2,2,5,13,213,193,159,207,212,57
],[
5,2,5,2,5,2,5,2,5,2,2,2,5,27,246,211,31,3,171,170
],[
2,2,2,12,2,2,2,2,2,2,2,2,2,248,156,179,88,217,120,231
],[
2,2,7,2,2,2,2,2,8,2,2,2,2,166,121,61,228,7,138,169
],[
2,2,7,2,5,5,5,2,5,5,5,2,5,3,195,74,211,140,84,85
],[
180,38,16,189,229,146,9,92,170,153,50,105,48,67,195,74,19,74,222,169
],[
35,206,114,202,104,74,96,28,100,199,220,14,151,80,22,35,73,165,26,73
],[
131,52,245,103,95,68,26,53,129,116,4,80,230,100,28,142,221,178,220,142
],[
82,40,53,148,82,51,46,148,204,151,207,141,149,98,61,25,175,30,38,65
],[
203,75,95,149,12,13,204,125,14,33,129,202,39,21,38,144,237,185,160,56
],[
248,209,238,209,233,12,80,167,170,58,175,23,248,185,57,161,31,48,76,63
],[
5,128,149,245,106,248,121,170,110,201,179,54,84,185,63,188,133,27,119,58
],[
216,254,125,94,16,165,216,156,167,55,98,125,202,184,97,58,164,56,244,137
],[
223,74,177,183,104,184,140,247,115,117,250,250,192,211,87,191,28,246,133,173
],[
42,137,215,223,99,175,45,191,92,61,96,214,71,38,224,226,189,55,155,41
]
]