aLevelData = [
[
2,2,3,3,3,3,3,21,158,185,244,142,13,29,245,61,38,154,101,129
],[
2,2,2,2,2,2,2,223,34,245,150,146,115,1,185,153,83,194,140,27
],[
3,2,3,3,3,3,3,26,197,187,37,114,156,224,253,91,211,164,179,114
],[
2,2,2,2,2,2,2,38,39,248,114,240,163,51,251,231,76,210,146,7
],[
3,2,3,3,3,3,3,122,222,234,204,9,211,97,164,0,174,206,164,114
],[
2,2,3,2,2,2,2,71,122,122,162,225,108,163,106,0,234,222,222,123
],[
3,2,3,2,2,3,3,60,224,44,209,179,73,199,192,234,215,196,20,76
],[
2,2,3,2,2,3,2,217,132,190,214,231,147,37,30,209,208,193,149,213
],[
2,3,3,2,2,3,3,206,229,9,21,123,220,110,72,255,56,221,175,231
],[
2,2,2,2,2,2,2,103,221,74,131,135,226,77,140,123,19,206,10,63
],[
3,3,3,3,2,2,2,80,192,117,120,116,36,27,80,215,126,193,128,24
],[
8,2,6,3,2,3,3,134,141,174,25,33,36,250,74,143,15,212,43,230
],[
2,2,2,3,2,3,2,99,16,12,191,161,60,23,47,219,49,145,249,24
],[
2,2,2,2,2,3,2,232,93,1,250,143,194,4,158,220,110,135,196,162
],[
2,2,2,2,2,3,2,186,13,48,162,47,141,80,163,73,35,30,197,124
],[
6,72,18,117,186,142,86,162,135,108,48,244,41,250,106,228,201,16,134,180
],[
44,173,153,247,43,154,93,83,99,74,129,134,45,5,67,167,209,70,65,174
],[
246,97,140,55,93,104,255,131,207,80,207,192,84,80,98,138,166,138,101,177
],[
229,237,25,61,140,90,237,175,164,5,82,138,56,31,203,18,8,178,67,84
],[
129,204,164,102,237,223,165,240,232,104,228,235,19,207,52,169,12,142,56,22
]
]