aLevelData = [
[
5,5,3,5,5,5,5,5,5,5,3,5,5,5,51,225,198,57,168,119
],[
4,2,3,5,5,5,5,5,5,5,3,5,5,5,104,107,12,151,95,190
],[
2,2,3,2,3,3,3,3,3,2,3,3,3,3,173,44,126,10,14,118
],[
5,2,2,2,3,2,2,2,2,2,5,5,5,5,145,58,131,82,148,172
],[
2,2,2,3,2,2,2,2,2,2,5,5,5,5,250,188,35,219,28,146
],[
2,2,2,3,2,2,5,3,3,2,3,3,3,3,50,59,149,154,254,100
],[
2,2,2,2,2,2,5,5,3,2,2,2,2,2,175,199,67,115,38,184
],[
5,2,2,2,2,2,5,5,3,2,2,2,2,2,176,173,56,130,152,102
],[
2,2,5,5,3,2,5,5,3,2,3,3,3,5,251,175,234,34,243,135
],[
2,2,5,5,3,2,5,5,3,6,3,3,5,5,99,249,228,142,2,64
],[
2,2,3,3,3,2,5,5,3,5,5,3,5,5,229,77,189,101,182,85
],[
2,2,3,2,2,2,5,5,3,5,5,5,3,5,114,27,83,130,32,183
],[
2,2,3,2,2,2,5,5,3,5,5,5,3,3,201,125,87,218,73,132
],[
2,2,3,2,5,2,3,3,3,5,5,5,3,3,237,81,123,110,243,57
],[
2,2,2,2,5,2,3,5,5,5,5,5,5,3,20,233,231,103,171,7
],[
2,2,2,2,5,2,5,5,5,5,5,5,5,5,43,7,201,249,182,130
],[
2,2,3,3,3,2,3,3,5,5,5,5,3,5,63,26,10,166,188,47
],[
102,1,158,236,60,141,9,187,229,147,54,186,148,201,14,2,137,189,248,47
],[
135,119,239,29,135,90,215,239,174,76,17,86,125,23,77,16,72,14,159,174
],[
233,243,214,155,181,24,9,90,175,197,114,15,252,218,127,65,151,181,39,222
]
]