aLevelData = [
[
2,2,2,2,5,5,210,224,147,79,80,162,221,13,134,238,113,36,8,85
],[
2,2,2,4,2,2,178,60,107,107,243,46,180,110,139,198,17,41,39,200
],[
5,3,3,3,5,5,199,24,101,48,108,205,158,190,86,146,2,178,83,80
],[
2,3,2,2,2,2,235,213,154,176,107,184,2,127,39,64,114,87,105,98
],[
2,3,2,2,2,2,153,124,112,44,223,4,11,5,155,59,102,53,134,69
],[
2,3,2,2,3,2,35,168,112,5,172,238,49,62,200,135,227,248,109,94
],[
2,3,2,2,3,2,78,38,214,147,164,133,212,125,111,199,105,240,199,241
],[
2,3,2,2,3,5,147,187,200,2,102,117,67,213,93,122,180,72,242,48
],[
116,158,108,143,48,34,249,224,154,13,252,196,94,170,168,121,88,184,206,89
],[
4,16,243,163,54,136,166,126,11,22,17,59,31,57,205,219,0,148,251,209
],[
227,220,144,9,150,245,240,40,182,88,191,22,34,184,243,186,175,229,46,4
],[
30,240,76,49,75,144,55,74,166,196,3,238,231,186,55,82,254,240,104,134
],[
73,153,13,250,10,66,142,64,24,181,158,19,213,30,203,153,95,108,83,229
],[
11,250,58,192,15,111,153,169,126,227,57,26,122,67,96,13,165,246,235,191
],[
216,192,157,180,24,231,183,251,197,149,201,179,21,126,199,206,193,194,95,21
],[
254,21,138,108,175,29,98,88,217,27,51,190,87,206,212,238,207,149,56,223
],[
228,211,64,188,173,151,211,160,102,125,49,159,102,207,132,5,81,240,185,226
],[
143,251,141,198,253,167,235,201,226,110,117,206,36,238,97,9,188,143,134,191
],[
103,102,182,77,158,89,79,108,201,132,13,179,176,220,34,94,50,18,137,77
],[
57,187,151,80,237,173,211,161,40,172,7,178,42,70,151,41,143,251,18,41
]
]