aLevelData = [
[
2,2,2,2,2,2,2,2,2,2,2,2,2,2,2,2,2,2,2,2
],[
2,2,2,2,2,2,2,2,2,2,2,2,2,2,2,2,2,2,2,2
],[
2,2,2,2,2,2,2,2,2,2,2,2,2,2,2,2,2,4,2,2
],[
2,2,2,13,2,2,2,2,2,2,2,2,2,2,2,2,2,2,2,2
],[
96,41,156,77,205,130,246,86,180,13,213,117,90,77,193,232,156,247,174,163
],[
41,85,205,222,238,232,168,207,210,81,110,185,164,114,139,37,81,208,124,111
],[
91,59,226,133,134,178,213,236,213,129,122,4,180,172,216,140,119,144,231,104
],[
3,200,234,162,203,78,255,176,255,226,245,245,255,176,93,138,22,45,228,61
],[
101,66,224,218,29,172,40,170,242,163,41,58,204,185,54,93,191,6,32,116
],[
61,130,7,237,138,178,111,10,113,135,150,228,54,131,6,175,203,29,102,63
],[
70,103,149,203,147,238,250,242,102,225,21,251,116,118,90,97,227,138,64,143
],[
255,136,149,232,46,139,20,10,38,199,57,84,93,37,84,166,193,45,221,103
],[
170,41,7,205,13,135,151,88,242,128,247,160,40,247,134,81,55,164,51,116
],[
150,113,74,240,30,36,141,80,191,63,135,198,114,36,29,112,110,125,102,219
],[
159,219,189,198,84,157,20,40,56,20,139,116,131,229,65,27,113,174,105,82
],[
244,236,161,23,165,28,128,110,1,32,110,241,210,229,185,135,235,67,229,116
],[
24,36,67,146,85,233,197,221,62,9,16,53,199,251,211,96,45,87,87,79
],[
45,56,88,162,115,228,20,110,85,175,161,61,193,28,131,86,116,70,126,63
],[
109,126,169,129,162,54,196,171,241,30,203,153,89,140,203,246,106,33,245,0
],[
250,170,241,139,26,68,117,73,73,196,21,72,231,85,93,188,236,99,29,255
]
]