aLevelData = [
[
2,2,2,2,2,11,2,2,2,2,6,33,142,57,209,236,228,86,97,208
],[
2,2,2,2,2,2,2,2,2,2,188,120,55,216,79,10,232,207,128,107
],[
5,2,5,2,5,5,5,2,5,5,35,64,7,138,240,162,206,179,54,204
],[
5,2,5,2,5,2,5,2,5,2,155,168,128,175,240,244,0,67,48,124
],[
5,5,5,2,5,5,5,2,5,5,213,194,2,87,137,21,250,223,222,139
],[
5,2,5,2,5,2,5,2,5,2,119,8,202,209,199,241,192,31,146,185
],[
5,2,5,2,5,2,5,2,5,2,49,175,117,148,83,115,237,30,33,7
],[
2,2,2,12,2,2,2,2,2,2,119,239,163,229,245,111,111,216,84,235
],[
2,2,7,2,2,2,2,2,8,2,112,179,108,233,230,66,39,185,174,129
],[
2,2,7,2,5,5,5,2,5,5,230,77,196,12,32,75,6,215,76,95
],[
2,2,7,2,5,2,2,2,2,5,58,31,2,214,83,160,93,105,240,9
],[
2,2,7,2,5,5,5,2,2,5,163,86,38,173,40,182,127,123,111,10
],[
2,2,7,2,5,2,2,2,2,5,66,48,147,23,245,203,229,244,33,65
],[
2,2,7,2,5,5,5,2,5,5,215,97,85,115,25,90,109,93,1,236
],[
20,144,48,72,136,226,115,22,158,100,231,11,5,148,97,190,206,212,12,183
],[
44,27,84,201,121,235,3,163,122,131,170,161,228,85,67,232,31,186,20,177
],[
73,229,215,229,126,21,23,235,87,15,221,189,176,204,140,66,175,111,10,216
],[
2,122,32,47,103,64,36,94,114,158,213,48,139,230,134,191,54,28,127,69
],[
151,101,160,46,53,188,71,114,254,231,116,33,139,169,43,64,166,58,26,211
],[
9,244,124,59,105,79,61,194,179,15,95,117,150,188,156,50,65,83,77,1
]
]