aLevelData = [
[
5,5,5,5,5,2,223,239,72,16,243,137,58,62,156,53,129,199,41,84
],[
5,2,2,2,2,2,13,168,50,114,72,119,135,110,166,164,102,219,125,0
],[
241,167,24,123,222,250,7,50,113,97,184,169,167,44,76,84,181,21,163,93
],[
176,34,185,161,142,204,54,252,77,96,64,198,114,166,148,157,181,193,213,101
],[
251,86,35,142,132,240,240,149,102,163,15,206,58,240,14,96,21,233,198,145
],[
186,149,48,68,13,150,123,191,203,9,91,178,121,174,163,117,154,73,22,146
],[
37,72,122,131,54,165,239,189,4,14,127,237,19,68,246,129,171,193,244,106
],[
136,157,64,32,211,178,95,231,81,255,102,82,219,74,12,5,14,9,3,190
],[
67,131,137,151,193,51,58,133,50,109,40,37,84,68,45,184,241,170,128,107
],[
17,217,135,221,110,242,236,219,40,228,243,110,186,144,11,23,45,43,163,89
],[
140,227,62,120,151,197,202,129,187,222,45,138,66,160,34,59,200,136,67,141
],[
238,254,102,210,82,125,45,246,190,243,217,4,159,107,95,235,185,233,190,131
],[
26,149,143,203,76,28,222,117,207,84,56,164,198,31,5,244,241,145,25,187
],[
219,85,133,142,85,76,179,7,34,120,178,198,244,25,206,182,152,21,100,145
],[
109,157,244,167,26,14,120,219,128,21,244,238,238,23,79,0,148,208,97,83
],[
59,58,77,83,51,176,17,211,140,83,91,154,137,173,159,30,81,148,102,143
],[
232,81,233,23,94,2,222,97,70,61,146,88,106,246,56,49,189,163,128,171
],[
145,157,108,149,10,202,96,145,211,121,120,25,15,141,29,191,147,222,219,185
],[
82,220,109,156,24,118,26,104,124,58,69,197,16,189,63,140,218,61,95,137
],[
8,133,85,128,223,17,187,109,245,115,237,16,160,245,27,169,174,128,156,1
]
]