aLevelData = [
[
4,2,59,83,78,137,133,248,25,61,106,132,2,24,87,132,246,162,199,81
],[
2,2,118,168,91,218,73,42,45,163,110,116,98,14,85,138,254,218,79,201
],[
2,3,252,233,66,204,159,70,161,141,3,102,155,204,247,174,147,181,15,54
],[
2,3,209,189,244,205,119,205,255,61,182,162,6,208,65,116,118,18,2,213
],[
2,3,162,217,13,221,91,131,210,132,193,127,150,79,88,15,36,47,95,75
],[
2,3,191,166,93,106,92,43,252,61,14,208,26,252,194,34,30,69,44,80
],[
2,2,136,98,1,144,205,203,103,191,97,235,170,71,21,39,48,70,163,29
],[
2,2,175,237,135,41,157,38,17,46,232,121,185,147,232,48,178,139,146,185
],[
2,2,194,154,238,77,80,85,203,207,191,105,177,247,250,222,23,175,80,157
],[
2,2,214,189,131,48,222,163,27,202,39,195,0,135,235,199,72,244,19,64
],[
2,2,78,210,239,141,4,23,41,255,138,54,252,59,255,160,161,223,151,139
],[
2,2,10,104,237,242,211,83,155,221,118,130,9,226,190,226,130,236,126,75
],[
2,2,141,59,130,167,122,172,198,87,59,59,230,210,117,198,214,143,215,20
],[
2,3,211,38,171,21,153,178,170,107,215,121,21,42,224,207,1,220,163,55
],[
2,2,243,201,221,204,172,117,141,223,70,105,169,226,128,54,15,132,87,184
],[
2,2,190,30,214,152,70,78,46,20,125,225,9,3,116,247,28,19,169,97
],[
2,3,251,86,126,78,50,253,234,39,145,99,111,183,199,77,76,143,51,112
],[
2,2,243,169,246,51,189,75,77,183,221,46,30,20,147,224,208,230,162,103
],[
2,2,96,9,3,39,177,160,219,6,36,92,171,205,105,251,198,209,149,14
],[
2,2,9,212,116,0,198,38,32,84,1,15,210,46,223,114,249,21,91,170
]
]