aLevelData = [
[
4,2,5,5,2,2,59,224,133,198,170,124,58,81,70,39,243,49,194,158
],[
2,2,2,2,2,2,16,152,151,66,250,153,156,97,88,140,214,183,134,179
],[
2,2,2,2,2,2,145,53,66,30,175,1,169,203,65,189,99,18,84,12
],[
3,3,3,3,3,3,26,64,13,82,48,131,249,188,177,6,158,129,134,92
],[
2,2,3,2,2,2,86,103,236,34,93,136,37,224,40,86,109,49,248,221
],[
13,2,3,2,2,2,48,36,176,72,122,225,227,167,175,144,50,239,124,118
],[
2,5,3,2,2,2,213,66,13,97,119,113,129,71,71,192,155,42,76,233
],[
2,12,3,2,2,2,186,62,248,99,11,78,1,227,253,92,108,36,245,136
],[
235,228,68,51,104,47,86,99,226,223,43,105,120,100,11,194,195,193,118,60
],[
105,215,91,89,239,230,138,248,207,81,106,50,203,161,239,131,128,205,199,42
],[
62,185,212,210,23,252,223,113,54,230,139,113,115,194,135,14,36,88,8,255
],[
53,182,119,88,123,48,102,175,69,166,201,125,52,5,99,200,77,16,126,255
],[
77,97,223,38,60,170,249,50,69,65,97,183,197,220,130,192,162,153,146,254
],[
222,65,197,38,108,205,192,148,66,41,80,52,175,57,92,162,239,26,24,144
],[
253,170,124,105,168,74,245,51,233,226,90,186,116,38,33,235,141,24,211,126
],[
29,206,189,216,5,118,233,47,178,151,76,239,241,154,65,92,5,136,54,121
],[
248,21,165,41,46,222,71,149,64,239,132,205,7,136,45,178,246,33,109,19
],[
173,171,253,22,204,25,152,218,5,31,175,90,118,57,93,149,53,240,157,236
],[
44,89,187,203,39,222,8,139,43,64,210,151,10,221,147,206,52,47,105,41
],[
208,150,198,158,11,87,105,68,176,228,141,183,250,94,96,190,166,88,182,43
]
]