aLevelData = [
[
5,5,5,5,5,2,2,2,2,2,2,2,2,2,2,2,2,179,242,255
],[
5,2,2,2,2,2,2,2,2,2,2,2,2,2,2,2,2,238,143,78
],[
5,2,5,3,3,3,3,3,3,3,2,2,3,3,3,3,3,94,182,199
],[
2,2,5,2,3,2,2,2,2,2,2,2,3,2,2,2,2,54,55,185
],[
2,2,3,2,3,2,2,2,2,2,2,2,3,2,2,2,2,84,16,101
],[
2,2,3,2,3,3,3,3,3,3,2,2,3,5,5,5,5,54,8,182
],[
4,2,3,2,2,2,2,2,2,3,2,2,3,2,2,2,2,112,103,196
],[
2,2,3,2,2,3,3,3,3,3,2,2,3,3,3,2,2,212,94,5
],[
2,2,2,2,2,3,2,2,2,2,2,2,2,2,3,2,2,236,145,203
],[
2,3,2,2,2,3,2,2,2,3,2,2,3,3,3,2,2,15,24,113
],[
2,3,2,2,2,3,2,2,2,3,2,2,3,5,5,5,5,60,200,12
],[
2,3,2,3,3,2,2,3,2,3,2,2,3,2,2,2,2,121,177,255
],[
2,3,2,3,6,2,2,3,3,3,2,2,3,3,3,3,2,235,149,121
],[
2,3,2,3,8,2,2,3,2,2,2,2,2,2,3,2,2,146,167,56
],[
2,3,2,3,9,2,3,3,2,2,2,2,2,2,3,2,3,74,53,188
],[
2,3,2,3,10,2,3,3,3,2,2,2,2,2,3,2,2,66,145,112
],[
2,3,2,3,11,2,3,3,3,2,2,2,2,2,3,3,2,30,38,7
],[
2,3,3,3,12,2,2,2,3,3,2,2,3,3,3,2,2,231,111,76
],[
2,2,2,2,5,2,5,2,2,3,2,2,2,2,2,2,3,133,222,118
],[
2,2,2,2,2,5,2,13,2,3,2,2,3,3,3,3,2,180,25,252
]
]