aLevelData = [
[
2,2,2,2,2,2,2,2,2,2,2,2,2,2,220,118,140,202,254,80
],[
2,2,2,2,2,2,2,2,3,3,3,3,3,3,126,183,52,242,9,2
],[
202,10,115,238,198,20,150,255,110,209,131,11,10,245,107,148,235,32,192,85
],[
172,16,151,27,184,21,81,214,12,197,122,240,63,240,241,221,191,215,73,244
],[
93,152,112,125,12,237,142,11,229,22,48,12,111,20,166,158,30,24,169,164
],[
25,59,66,25,64,111,231,165,110,182,230,110,251,146,7,49,134,188,108,145
],[
241,24,189,175,172,233,130,250,55,66,208,73,226,189,40,39,216,110,156,109
],[
91,26,51,23,81,165,143,80,0,202,205,207,22,15,173,102,236,247,243,216
],[
11,121,13,236,240,177,245,191,12,214,89,94,15,108,250,148,102,186,82,1
],[
2,127,121,108,92,225,73,91,182,166,193,224,163,166,167,181,201,128,113,139
],[
230,141,102,160,17,18,1,144,67,186,150,109,21,67,55,17,203,119,217,179
],[
146,94,179,185,6,178,231,205,247,147,100,51,109,124,11,90,233,118,17,177
],[
238,139,164,187,192,126,209,102,108,185,165,153,8,135,146,12,60,131,21,92
],[
2,81,150,95,169,139,144,181,32,254,241,159,113,23,196,20,140,152,13,18
],[
70,143,244,51,161,137,38,128,78,3,121,137,112,33,207,182,163,163,60,216
],[
61,20,107,3,212,68,61,160,0,249,180,190,97,226,16,169,228,204,55,190
],[
67,24,90,125,203,109,214,224,98,170,88,235,200,31,69,133,29,252,89,134
],[
164,9,142,17,198,152,63,36,90,185,141,109,35,172,2,96,154,156,116,134
],[
238,138,44,24,74,135,72,204,86,38,94,239,0,49,98,180,124,155,202,204
],[
137,182,239,54,247,166,183,89,102,22,113,80,80,41,0,133,74,179,60,129
]
]