aLevelData = [
[
6,2,8,2,9,2,10,2,11,3,2,2,5,2,2,2,5,227,38,218
],[
2,2,2,2,2,2,2,2,12,3,5,2,2,2,5,2,2,182,233,236
],[
2,2,3,3,3,3,3,3,3,3,2,2,3,3,3,3,3,58,190,152
],[
2,2,3,2,2,2,2,2,2,2,5,2,3,2,2,2,2,203,29,215
],[
2,2,3,2,2,2,2,2,2,2,2,2,3,2,2,2,2,72,8,196
],[
2,2,3,2,3,3,3,3,3,3,2,5,3,2,2,2,2,13,104,164
],[
2,2,3,2,2,2,2,5,5,3,2,2,3,2,2,2,2,57,17,114
],[
2,2,3,5,5,5,2,3,3,3,5,2,3,3,3,2,2,131,227,128
],[
2,2,2,2,2,2,2,2,2,2,2,2,5,2,2,2,2,30,205,87
],[
2,3,2,2,3,1,3,2,2,2,2,2,5,2,2,2,2,104,215,149
],[
2,3,2,2,3,2,3,2,2,2,2,5,5,2,2,2,2,113,9,107
],[
2,3,2,3,2,2,2,3,2,2,2,2,5,2,2,2,2,184,164,216
],[
2,3,2,3,2,2,2,3,3,3,2,2,3,3,3,2,2,6,8,142
],[
2,3,2,3,2,2,2,3,2,2,5,2,5,2,2,2,2,202,97,170
],[
2,3,2,3,2,2,3,3,2,2,2,2,5,2,2,2,2,207,206,55
],[
2,3,2,3,2,2,3,3,2,2,2,5,5,2,2,2,2,189,28,155
],[
2,3,2,3,2,2,3,3,2,2,2,2,5,2,2,2,2,249,60,143
],[
5,3,3,3,2,2,3,3,3,3,2,2,3,3,3,2,2,173,194,38
],[
65,138,141,220,27,74,166,202,233,86,94,73,176,112,3,196,66,244,15,26
],[
15,93,160,68,62,10,40,56,253,67,102,13,21,119,149,95,193,199,227,245
]
]