aLevelData = [
[
10,2,2,8,2,2,2,2,2,2,2,2,2,2,2,2,148,66,181,90
],[
2,2,2,2,2,2,2,2,2,2,2,2,2,2,2,2,31,159,232,35
],[
2,2,2,2,2,2,3,3,3,3,2,2,2,2,2,3,220,102,216,191
],[
9,2,2,2,2,2,2,2,2,3,2,2,2,2,2,3,2,65,155,188
],[
3,3,3,3,3,3,3,2,2,3,2,2,2,2,2,2,125,193,140,216
],[
2,2,2,2,2,2,2,2,2,3,2,2,2,2,2,3,156,69,157,12
],[
2,2,2,2,2,2,2,2,2,3,3,2,2,2,2,3,10,30,238,202
],[
2,2,2,2,2,2,2,2,2,2,3,2,2,2,2,3,255,240,158,132
],[
2,2,2,2,2,2,2,2,2,2,3,2,2,2,2,3,183,91,225,109
],[
2,2,2,2,3,3,3,3,2,2,3,2,2,2,2,3,36,219,82,131
],[
2,2,2,2,3,2,2,3,2,2,3,2,2,2,2,3,224,237,139,205
],[
2,2,2,2,3,2,2,3,2,2,3,3,3,5,2,3,101,116,243,225
],[
2,2,2,2,3,2,2,3,2,2,2,2,3,2,2,3,128,90,216,170
],[
3,122,190,104,187,190,246,248,161,132,114,86,84,71,215,96,199,123,212,221
],[
55,184,179,189,97,27,45,162,241,234,131,160,61,118,202,65,51,70,134,205
],[
144,113,123,200,84,76,192,187,114,69,21,56,203,15,118,24,93,0,241,7
],[
184,183,180,67,178,1,106,160,92,254,200,208,53,127,98,225,157,179,196,7
],[
140,3,190,156,131,58,255,101,195,233,229,23,190,10,148,25,203,227,70,140
],[
29,45,226,137,246,118,207,169,24,196,10,203,125,123,118,17,71,128,116,44
],[
250,159,180,218,233,42,75,172,238,227,5,13,94,28,252,128,60,29,105,41
]
]