aLevelData = [
[
5,5,5,5,5,65,123,73,218,231,115,232,172,162,235,195,150,190,83,154
],[
5,2,2,2,2,33,39,52,228,190,32,20,30,195,56,154,99,177,122,242
],[
5,2,5,3,3,61,184,229,115,187,125,28,127,195,26,94,171,170,102,183
],[
2,2,5,2,3,32,2,120,120,66,179,102,230,143,78,82,47,201,157,168
],[
162,87,127,161,30,233,242,12,203,91,114,77,9,220,130,166,166,79,136,181
],[
84,241,221,62,90,60,37,43,137,12,220,209,114,1,50,117,214,36,25,15
],[
94,205,156,77,140,196,114,219,242,166,211,226,162,138,138,207,229,229,76,85
],[
48,171,72,181,83,183,255,61,244,109,86,14,60,158,233,35,208,171,163,143
],[
3,238,140,6,74,85,225,159,240,80,106,216,10,238,8,219,174,67,142,0
],[
96,12,209,146,205,150,3,214,188,219,60,73,65,238,90,42,51,154,11,56
],[
225,70,40,189,1,28,69,203,233,107,134,198,2,73,180,34,121,124,143,110
],[
55,155,102,146,20,112,230,85,71,161,48,34,33,143,46,11,252,127,38,14
],[
110,248,143,151,194,107,36,71,168,26,56,244,43,50,73,241,228,58,215,143
],[
109,177,118,227,25,243,35,202,226,93,212,43,163,177,83,124,136,188,75,136
],[
194,54,163,111,127,233,12,238,25,22,214,224,141,20,8,5,48,58,175,3
],[
157,255,118,170,242,96,119,124,60,130,81,109,47,153,123,231,27,8,216,17
],[
27,202,139,81,144,16,12,16,205,43,123,189,20,173,53,20,194,203,166,160
],[
198,6,94,126,87,11,102,101,231,215,212,227,82,30,157,233,92,238,171,138
],[
90,144,47,0,47,175,57,240,122,187,134,239,14,144,152,68,163,83,12,239
],[
203,157,41,235,39,220,181,177,218,246,12,253,62,47,115,212,214,76,169,198
]
]