aLevelData = [
[
2,2,2,5,106,54,40,4,73,27,49,1,78,94,185,180,144,197,63,49
],[
2,2,2,2,37,29,43,213,70,208,12,125,175,186,36,245,69,57,38,180
],[
251,131,62,198,246,61,82,9,240,73,136,156,218,223,8,149,197,223,3,242
],[
2,101,244,211,136,158,37,230,151,219,117,34,155,228,90,184,83,143,34,70
],[
50,145,126,78,6,147,64,232,215,137,100,179,18,63,77,17,231,52,82,148
],[
239,172,121,179,18,1,130,194,168,58,40,33,222,222,163,179,91,11,113,145
],[
36,194,86,0,189,133,162,161,146,36,178,232,149,212,185,207,39,129,193,204
],[
60,101,236,0,186,218,0,177,35,108,34,250,116,51,226,193,77,96,120,234
],[
81,21,77,202,208,122,190,223,164,13,28,190,88,57,247,76,144,43,156,49
],[
164,225,220,138,143,131,15,222,8,247,89,84,238,176,44,35,233,198,14,73
],[
79,76,157,128,68,222,208,110,38,121,127,28,40,143,38,169,60,91,230,64
],[
55,115,204,71,47,156,86,217,40,225,51,119,240,231,75,250,72,123,255,204
],[
68,109,178,88,245,161,136,191,69,99,109,205,33,251,90,43,222,129,211,214
],[
213,243,181,207,81,133,46,21,172,56,13,208,180,174,60,207,83,61,138,52
],[
112,66,174,110,16,184,137,104,193,9,172,0,56,35,26,187,57,207,79,183
],[
183,62,129,225,61,229,37,103,140,140,181,113,134,161,177,12,74,209,228,102
],[
161,218,232,65,153,154,236,162,111,108,181,201,178,181,227,102,166,186,118,10
],[
231,181,144,220,78,39,124,141,24,111,240,142,69,156,143,128,63,128,178,236
],[
188,5,104,52,229,197,188,201,184,212,54,159,171,224,164,222,146,125,25,219
],[
194,186,55,70,119,248,170,165,115,252,245,0,232,66,113,222,152,148,146,113
]
]