aLevelData = [
[
10,2,2,8,2,2,2,2,2,2,2,2,2,2,2,144,45,86,72,224
],[
2,2,2,2,2,2,2,2,2,2,2,2,2,2,2,193,78,140,208,249
],[
211,176,135,169,127,186,132,172,207,2,71,204,118,59,77,225,247,177,66,61
],[
114,208,115,72,190,230,130,104,185,42,93,36,220,252,112,136,19,110,26,203
],[
203,4,94,47,76,184,220,41,73,65,255,194,181,149,119,61,217,173,234,250
],[
164,136,230,154,66,114,27,100,240,134,199,231,14,114,113,225,117,122,218,96
],[
12,192,49,39,150,194,134,83,206,36,129,63,182,176,84,164,44,155,238,5
],[
190,9,113,74,191,212,231,171,154,137,49,207,103,180,63,53,188,94,135,212
],[
198,211,175,254,152,169,141,138,194,253,82,50,38,0,2,58,7,179,40,83
],[
99,238,199,190,131,167,147,180,208,113,97,6,232,67,221,1,241,123,123,148
],[
46,34,176,181,207,114,97,0,14,149,156,161,119,176,134,117,135,32,148,108
],[
121,4,254,50,93,251,113,14,106,47,5,10,149,146,110,84,99,103,118,228
],[
251,5,171,95,127,215,84,59,156,168,170,37,96,29,69,159,76,131,213,238
],[
171,203,18,51,34,211,246,216,135,232,41,45,246,136,189,83,34,108,27,90
],[
234,198,61,166,45,199,30,151,222,100,111,105,91,90,140,88,250,111,174,8
],[
229,251,98,37,41,168,58,70,9,118,194,24,152,2,181,184,135,7,113,96
],[
59,37,169,70,34,225,90,193,72,238,0,174,37,171,9,18,186,236,138,1
],[
220,253,49,190,207,228,123,35,22,231,38,67,138,78,234,79,170,106,100,182
],[
50,214,83,144,239,253,6,61,209,220,21,73,66,10,80,147,182,245,245,175
],[
131,110,38,136,244,104,153,74,152,252,146,127,224,177,14,120,233,251,65,238
]
]