aLevelData = [
[
5,5,5,5,5,2,2,2,2,2,2,2,2,2,2,2,2,2,2,2
],[
5,2,2,2,2,2,2,2,2,2,2,2,2,2,2,2,2,2,2,2
],[
5,2,5,3,3,3,3,3,3,3,2,2,3,3,3,3,3,3,2,2
],[
2,2,5,2,3,2,2,2,2,2,2,2,3,2,2,2,2,3,2,2
],[
2,2,3,2,3,2,2,2,2,2,2,2,3,2,2,2,2,3,3,3
],[
2,2,3,2,3,3,3,3,3,3,2,2,3,5,5,5,5,5,5,5
],[
4,2,3,2,2,2,2,2,2,3,2,2,3,2,2,2,2,2,2,1
],[
2,2,3,2,2,3,3,3,3,3,2,2,3,3,3,2,2,3,3,3
],[
2,2,2,2,2,3,2,2,2,2,2,2,2,2,3,2,2,3,2,2
],[
2,3,2,2,2,3,2,2,2,3,2,2,3,3,3,2,2,3,3,3
],[
2,3,2,2,2,3,2,2,2,3,2,2,3,5,5,5,5,5,2,5
],[
2,3,2,3,3,2,2,3,2,3,2,2,3,2,2,2,2,2,2,2
],[
2,3,2,3,6,2,2,3,3,3,2,2,3,3,3,3,2,3,3,3
],[
2,3,2,3,8,2,2,3,2,2,2,2,2,2,3,2,2,3,2,2
],[
2,3,2,3,9,2,3,3,2,2,2,2,2,2,3,2,3,3,2,2
],[
2,3,2,3,10,2,3,3,3,2,2,2,2,2,3,2,2,3,2,2
],[
2,3,2,3,11,2,3,3,3,2,2,2,2,2,3,3,2,3,2,2
],[
2,3,3,3,12,2,2,2,3,3,2,2,3,3,3,2,2,3,2,2
],[
149,80,183,170,138,49,19,217,116,78,113,227,41,239,134,249,43,101,242,138
],[
53,75,115,174,20,12,89,197,184,166,58,91,139,173,230,80,2,146,157,53
]
]