aLevelData = [
[
6,2,2,2,2,2,2,2,2,2,2,2,2,139,231,219,148,161,4,169
],[
2,2,2,2,2,2,2,2,2,2,2,2,2,253,42,84,54,31,174,80
],[
2,2,2,2,2,2,2,2,2,2,2,2,2,232,85,98,105,60,187,77
],[
157,11,85,169,71,12,141,140,59,155,227,199,18,184,224,14,195,83,75,90
],[
116,199,160,140,143,164,190,83,23,177,224,79,61,49,206,119,46,102,85,184
],[
48,84,244,222,237,199,216,184,14,151,11,119,12,43,232,88,67,60,210,131
],[
73,219,37,50,125,182,109,21,227,151,214,246,47,45,228,153,31,15,100,230
],[
14,254,163,73,199,106,221,90,151,56,248,185,166,195,114,60,134,33,153,77
],[
13,167,250,141,96,175,27,190,81,152,109,223,235,15,124,152,74,141,105,217
],[
177,33,154,191,214,112,176,183,128,250,185,229,84,159,167,199,236,97,2,21
],[
42,107,217,236,204,83,254,44,64,156,115,31,185,127,31,91,130,234,197,233
],[
147,202,55,166,98,134,199,234,251,203,255,104,83,143,146,85,217,80,145,205
],[
79,157,226,114,216,216,239,86,82,58,155,27,229,23,122,88,220,100,65,63
],[
180,118,123,125,115,12,126,98,60,144,158,66,31,154,160,27,53,182,114,119
],[
237,103,25,148,161,108,234,195,109,65,253,14,64,233,223,29,51,235,135,91
],[
26,155,139,84,89,154,148,97,250,160,16,136,252,121,38,158,237,78,239,174
],[
187,38,227,159,199,172,145,16,59,51,148,135,158,247,194,203,165,166,166,142
],[
76,31,49,79,38,121,172,127,241,71,241,227,110,26,219,57,112,72,251,30
],[
50,236,140,47,237,46,169,111,170,197,190,233,85,186,61,150,20,110,146,128
],[
215,222,88,40,47,38,205,37,99,68,131,15,193,31,89,155,50,200,170,7
]
]