aLevelData = [
[
2,2,2,2,2,2,2,2,2,2,2,2,2,2,2,41,226,202,9,217
],[
2,2,2,2,2,2,2,2,3,3,3,3,3,3,3,111,137,217,126,132
],[
2,2,3,2,3,2,2,2,2,3,2,2,2,2,2,130,139,214,116,7
],[
2,2,3,2,3,2,2,2,2,2,3,2,2,2,2,51,115,28,218,159
],[
2,2,3,2,3,2,2,2,2,2,2,3,2,2,2,189,206,78,232,58
],[
2,2,3,2,2,2,2,2,2,2,2,2,3,2,2,142,168,72,13,129
],[
2,2,3,2,3,3,3,3,3,3,3,3,3,2,2,203,43,189,162,21
],[
2,2,3,2,2,2,2,2,2,2,2,2,2,2,2,137,56,183,132,114
],[
24,132,29,235,36,62,142,248,26,66,18,250,172,7,149,59,200,81,25,200
],[
28,168,88,127,218,9,170,104,184,219,42,73,60,36,20,116,54,253,114,228
],[
142,68,248,136,63,144,44,223,164,106,202,197,243,186,102,141,7,127,83,79
],[
98,195,196,131,114,207,49,207,19,155,252,30,86,136,85,242,128,81,91,251
],[
86,63,131,232,152,157,62,125,204,108,214,230,60,88,153,75,66,234,58,164
],[
195,254,116,207,250,120,240,223,119,51,105,184,103,58,14,217,21,59,40,120
],[
177,56,252,212,81,128,243,199,53,222,248,154,79,16,34,30,2,122,147,248
],[
43,28,160,61,94,194,50,63,114,122,107,166,63,75,141,194,166,36,24,31
],[
210,19,51,90,190,183,77,52,247,248,4,229,164,245,70,179,195,62,182,194
],[
181,68,81,46,253,14,81,87,69,45,81,124,161,241,179,140,24,221,63,56
],[
97,89,12,77,234,167,164,65,31,24,99,11,232,128,32,56,115,231,16,60
],[
53,129,230,6,43,225,63,215,102,105,62,83,198,5,115,217,6,25,2,16
]
]