aLevelData = [
[
2,2,2,2,2,2,2,2,2,178,56,52,203,211,6,125,23,183,62,103
],[
2,2,13,5,5,2,2,12,5,223,19,83,237,61,99,96,14,74,48,93
],[
2,2,2,5,5,2,2,2,5,42,239,142,153,176,248,234,100,246,106,2
],[
2,2,2,2,2,2,2,2,2,12,104,23,53,12,229,111,253,127,102,153
],[
2,2,2,2,2,2,2,2,2,186,219,225,195,177,219,109,182,84,189,166
],[
2,2,2,2,2,2,2,2,2,173,196,174,83,103,148,131,70,123,208,169
],[
2,2,2,2,2,2,2,2,2,132,236,61,95,166,253,227,34,127,70,201
],[
2,2,2,2,2,2,2,2,2,105,255,8,0,147,87,190,226,30,94,244
],[
2,2,2,2,2,2,2,2,2,156,25,52,92,234,220,37,31,34,246,208
],[
113,116,103,136,104,112,16,250,14,200,103,16,181,88,111,22,138,99,232,28
],[
109,32,194,155,0,117,216,91,254,2,219,147,207,97,140,83,89,172,47,31
],[
24,64,60,220,113,193,87,241,67,95,130,166,192,87,146,207,123,188,223,175
],[
193,119,64,23,45,141,55,206,119,160,104,53,141,185,80,43,229,68,51,47
],[
17,92,86,196,148,73,111,26,244,71,90,234,16,137,13,162,180,126,206,194
],[
107,83,164,134,148,185,11,197,184,232,235,25,27,228,203,64,145,255,66,194
],[
147,159,175,212,146,65,42,125,139,190,187,247,220,205,201,88,86,202,213,114
],[
147,182,104,247,138,126,73,225,96,128,244,16,130,75,72,53,240,166,128,240
],[
220,213,100,53,115,23,192,244,251,115,22,249,30,180,144,17,133,179,56,110
],[
169,212,107,76,230,211,139,213,210,193,245,66,204,73,51,68,216,56,114,162
],[
170,61,54,35,0,236,76,174,53,9,1,176,19,4,145,190,234,192,226,124
]
]