aLevelData = [
[
2,2,2,2,2,2,2,34,125,16,221,150,250,83,44,166,19,111,231,135
],[
2,3,5,3,5,5,5,121,94,243,28,213,57,210,106,104,78,108,76,238
],[
2,3,2,3,2,2,2,116,16,104,201,155,182,97,91,167,135,79,180,127
],[
2,2,2,2,2,2,2,159,108,109,96,17,15,211,120,43,223,73,176,252
],[
2,3,5,3,5,5,5,64,231,201,20,18,103,170,139,155,66,248,69,193
],[
2,3,5,3,5,5,5,22,232,115,125,75,81,93,140,246,6,96,104,253
],[
2,5,5,5,5,5,5,98,50,118,125,36,110,129,104,125,76,103,115,104
],[
2,3,5,3,5,5,5,175,18,47,58,102,170,117,122,171,9,8,242,240
],[
2,3,5,3,5,5,5,112,118,6,220,120,63,69,144,75,57,62,46,19
],[
2,5,5,5,5,5,5,51,149,156,179,217,86,133,182,216,136,161,132,66
],[
2,3,5,3,2,2,2,6,55,220,51,138,224,126,181,11,141,40,225,73
],[
5,3,5,3,2,2,2,203,196,71,166,70,224,144,55,140,94,98,27,20
],[
5,5,5,5,5,5,5,109,132,11,127,184,67,51,29,221,20,64,179,32
],[
5,3,5,3,5,5,5,122,187,124,97,42,149,109,75,110,3,189,207,199
],[
5,3,5,3,5,5,5,140,165,208,214,95,101,32,124,235,135,172,65,170
],[
103,243,242,61,243,189,142,190,176,9,100,82,254,71,117,253,156,199,31,187
],[
110,114,253,204,126,184,9,79,66,201,3,18,29,8,23,169,39,188,186,189
],[
49,9,213,167,4,32,37,61,234,178,225,236,112,170,158,8,105,27,113,95
],[
54,119,83,20,69,3,201,171,216,135,196,96,8,74,197,189,9,61,70,107
],[
175,119,86,73,49,225,131,187,46,51,252,69,237,31,247,88,233,203,81,107
]
]