aLevelData = [
[
5,5,3,5,5,5,5,5,5,5,3,5,5,5,5,5,5,5,5,5
],[
4,2,3,5,5,5,5,5,5,5,3,5,5,5,5,5,5,5,5,5
],[
2,2,3,2,3,3,3,3,3,2,3,3,3,3,3,5,5,3,5,5
],[
5,2,2,2,3,2,2,2,2,2,5,5,5,5,5,5,5,3,5,5
],[
2,2,2,3,2,2,2,2,2,2,5,5,5,5,5,5,5,3,5,5
],[
2,2,2,3,2,2,5,3,3,2,3,3,3,3,3,5,5,3,5,5
],[
2,2,2,2,2,2,5,5,3,2,2,2,2,2,2,2,2,3,5,5
],[
5,2,2,2,2,2,5,5,3,2,2,2,2,2,2,2,2,3,5,5
],[
2,2,5,5,3,2,5,5,3,2,3,3,3,5,5,3,5,3,5,5
],[
2,2,5,5,3,2,5,5,3,6,3,3,5,5,5,3,5,3,5,5
],[
16,240,218,177,218,2,147,245,252,16,73,114,238,69,203,198,161,90,63,145
],[
8,10,196,136,215,198,85,197,139,169,240,97,170,174,248,69,76,33,217,61
],[
218,83,234,79,22,146,151,74,91,88,191,161,38,195,91,122,214,69,97,3
],[
176,157,232,5,38,6,140,187,89,174,20,228,220,105,82,23,187,167,75,87
],[
188,164,152,231,228,222,12,95,61,204,151,0,215,205,106,69,13,95,92,186
],[
9,145,141,17,139,187,73,115,229,108,47,20,75,164,146,10,73,67,31,95
],[
149,194,192,101,7,33,193,73,230,32,50,235,101,178,140,237,109,175,151,11
],[
157,201,138,170,144,193,116,179,94,219,220,161,101,143,164,217,73,129,52,58
],[
57,179,212,246,116,249,88,160,12,174,3,134,234,166,166,64,19,99,8,137
],[
42,140,138,78,53,154,11,5,164,213,10,64,143,127,10,130,63,79,59,81
]
]