aLevelData = [
[
6,2,2,2,2,2,2,2,14,244,241,157,166,147,34,37,252,5,177,6
],[
2,2,2,2,2,2,2,2,233,205,232,247,150,134,196,140,153,119,65,101
],[
2,2,2,2,2,2,2,2,96,104,215,166,211,180,69,166,53,160,141,236
],[
3,3,3,3,3,3,3,3,75,235,64,87,193,166,251,156,201,70,50,246
],[
2,2,2,2,2,2,2,2,5,248,44,24,167,52,79,103,215,149,158,102
],[
2,2,2,2,2,2,2,2,85,232,128,113,95,131,195,175,213,216,224,66
],[
2,2,2,2,2,3,2,2,155,73,129,192,63,62,64,231,219,117,178,140
],[
2,2,3,3,3,3,3,3,61,154,164,213,70,24,164,168,144,46,196,99
],[
2,2,2,2,2,2,2,2,83,69,154,206,138,129,139,78,81,150,74,91
],[
2,2,2,2,2,2,2,2,146,221,155,51,224,167,93,208,163,209,199,24
],[
3,3,3,3,3,3,3,3,118,152,242,85,205,175,151,228,219,143,27,49
],[
2,2,2,2,2,2,2,2,179,15,200,227,173,52,94,83,11,74,202,67
],[
2,2,2,2,2,2,2,2,220,51,53,205,33,0,64,153,47,190,142,83
],[
2,2,3,3,3,3,3,3,84,146,132,92,189,9,76,192,151,169,32,105
],[
2,2,3,2,2,2,2,2,117,204,197,146,242,174,85,126,151,196,66,105
],[
2,2,3,2,2,2,2,2,255,79,152,191,56,50,130,140,109,0,16,51
],[
194,90,55,100,128,120,26,72,114,5,135,254,143,48,197,75,216,0,141,141
],[
132,231,86,241,91,155,214,230,96,33,197,210,178,42,228,3,180,163,62,232
],[
108,136,173,129,41,249,161,20,105,143,29,34,249,240,2,153,94,161,144,75
],[
116,28,42,159,85,35,89,134,124,83,20,177,43,252,63,2,9,48,113,64
]
]