aLevelData = [
[
2,2,2,2,2,11,2,2,2,2,2,2,2,2,9,2,2,82,120,82
],[
2,2,2,2,2,2,2,2,2,2,2,2,2,2,2,2,2,15,106,79
],[
5,2,5,2,5,5,5,2,5,5,5,2,5,5,5,2,5,173,158,29
],[
5,2,5,2,5,2,5,2,5,2,5,2,5,2,5,2,2,93,84,118
],[
5,5,5,2,5,5,5,2,5,5,5,2,5,5,5,2,2,108,41,4
],[
5,2,5,2,5,2,5,2,5,2,2,2,5,2,2,2,2,114,151,135
],[
5,2,5,2,5,2,5,2,5,2,2,2,5,2,2,2,5,141,47,156
],[
2,2,2,12,2,2,2,2,2,2,2,2,2,10,2,2,2,14,122,27
],[
2,2,7,2,2,2,2,2,8,2,2,2,2,2,2,2,7,250,204,244
],[
2,2,7,2,5,5,5,2,5,5,5,2,5,5,2,2,7,206,186,57
],[
2,2,7,2,5,2,2,2,2,5,2,2,5,2,5,2,7,228,158,176
],[
2,2,7,2,5,5,5,2,2,5,2,2,5,2,5,2,7,106,88,109
],[
2,2,7,2,5,2,2,2,2,5,2,2,5,2,5,2,7,255,135,40
],[
198,219,127,217,41,147,250,193,162,206,144,108,160,20,56,63,5,145,3,91
],[
122,22,10,197,5,97,164,195,221,158,221,137,125,46,36,20,247,166,68,87
],[
139,27,150,149,120,157,116,14,18,1,240,221,21,228,198,33,57,236,144,91
],[
6,81,57,23,234,156,180,207,137,175,238,12,84,6,1,206,93,60,170,46
],[
105,209,253,66,71,42,87,65,97,217,149,231,145,31,131,27,54,175,151,208
],[
134,181,224,41,38,23,57,224,248,251,194,232,52,137,145,81,186,242,164,109
],[
166,177,26,49,37,17,163,221,136,239,54,224,151,193,2,245,40,215,166,147
]
]