aLevelData = [
[
6,2,8,2,9,2,10,2,11,3,2,2,5,2,2,2,5,2,195,193
],[
2,2,2,2,2,2,2,2,12,3,5,2,2,2,5,2,2,2,199,104
],[
2,2,3,3,3,3,3,3,3,3,2,2,3,3,3,3,3,3,89,59
],[
232,147,107,138,165,162,179,153,9,254,66,61,105,60,175,197,165,77,115,211
],[
170,244,148,106,59,125,129,71,242,173,61,117,129,245,192,28,62,234,155,154
],[
223,250,218,212,129,87,46,206,240,56,76,122,34,65,144,206,4,63,230,25
],[
122,25,234,151,160,4,78,67,87,245,124,236,253,92,125,139,123,15,26,212
],[
133,132,65,11,29,68,170,25,89,156,185,223,103,150,167,202,206,40,221,168
],[
246,170,160,186,235,141,243,10,94,75,185,254,237,154,27,46,164,229,41,115
],[
195,252,196,64,193,11,187,54,146,201,52,242,38,241,78,42,50,246,4,248
],[
50,243,85,117,175,224,161,138,189,12,87,3,201,199,205,229,145,95,111,2
],[
116,79,28,202,236,178,205,100,89,254,120,254,0,238,52,97,83,192,157,200
],[
115,161,122,242,243,102,157,118,223,124,11,87,252,34,93,216,82,213,102,145
],[
232,12,22,195,207,38,158,233,97,161,213,143,203,140,219,103,201,63,252,154
],[
177,73,215,92,179,170,191,195,95,67,97,217,103,138,167,240,167,130,221,53
],[
98,235,19,136,207,181,194,139,212,187,178,249,17,174,26,58,32,79,10,52
],[
27,226,6,99,95,223,243,44,144,234,56,110,222,5,29,91,134,5,118,134
],[
155,66,134,60,6,147,30,24,204,122,5,210,143,155,156,88,88,115,194,32
],[
147,70,246,188,91,89,187,175,248,98,65,127,166,61,65,11,152,224,41,31
],[
61,145,121,70,194,87,109,223,216,174,220,115,183,126,96,70,99,78,183,44
]
]