aLevelData = [
[
2,2,3,3,3,3,3,3,3,3,3,3,3,3,3,3,2,3,243,224
],[
2,2,2,2,2,2,2,2,2,2,2,2,2,2,2,2,2,2,26,30
],[
3,2,3,3,3,3,3,3,3,3,3,2,3,3,3,2,2,2,231,58
],[
2,2,2,2,2,2,2,2,2,2,2,2,2,2,3,2,2,2,170,209
],[
3,2,3,3,3,3,3,3,3,3,3,3,3,2,3,2,2,3,233,39
],[
76,241,181,131,57,103,223,160,75,50,186,153,4,92,121,227,210,45,148,37
],[
145,160,110,74,82,19,52,212,91,66,8,115,111,118,95,214,79,250,167,193
],[
128,207,46,96,79,160,63,219,19,248,142,42,178,179,213,43,102,179,192,241
],[
193,212,7,95,239,33,217,246,60,72,129,236,213,75,68,126,211,121,136,135
],[
117,157,60,80,173,117,115,170,223,101,82,58,229,109,45,21,86,89,237,141
],[
8,55,181,74,211,14,197,156,152,205,158,15,130,130,102,64,140,204,143,240
],[
68,147,180,87,206,246,195,186,43,133,97,64,188,177,138,2,1,128,120,97
],[
167,134,199,156,194,16,214,162,87,162,112,36,29,164,172,239,132,88,17,121
],[
247,15,254,185,94,157,73,60,232,10,39,118,7,138,76,86,188,175,83,29
],[
20,222,95,111,243,0,3,170,16,121,95,120,65,94,140,160,249,226,59,34
],[
14,18,152,130,192,195,117,100,248,200,164,89,205,104,164,249,76,15,129,50
],[
121,67,245,223,145,218,211,156,146,106,165,217,253,2,148,46,219,23,137,238
],[
254,193,146,255,137,40,135,233,179,56,237,44,199,157,26,215,111,235,154,86
],[
51,28,210,140,61,64,227,34,95,112,210,30,87,4,229,183,81,6,80,103
],[
173,230,16,67,3,110,24,136,100,249,171,118,227,224,9,97,84,54,77,5
]
]