aLevelData = [
[
2,2,3,3,3,3,20,148,234,88,234,21,163,185,100,15,182,190,222,68
],[
2,2,2,2,2,2,108,219,14,99,76,200,217,134,145,40,107,255,220,105
],[
3,2,3,3,3,3,134,84,39,235,26,136,250,100,23,156,225,131,127,86
],[
2,2,2,2,2,2,29,211,191,65,154,227,63,245,33,164,56,152,207,18
],[
198,165,198,22,62,236,34,171,193,219,47,65,17,251,217,94,164,189,99,139
],[
247,119,92,110,37,170,207,52,184,134,187,50,191,176,194,203,33,66,37,148
],[
48,20,240,182,129,58,114,148,252,205,240,174,47,239,155,197,231,9,190,65
],[
2,87,60,207,127,167,58,78,215,93,25,236,144,187,167,140,15,95,150,108
],[
174,13,45,4,14,175,61,49,175,154,87,146,189,19,60,50,45,18,149,104
],[
9,70,228,252,8,88,187,139,98,116,44,45,226,6,128,84,61,193,43,248
],[
162,230,0,241,146,195,162,164,242,122,59,225,95,3,112,12,193,116,148,123
],[
35,128,27,32,194,62,82,104,99,44,78,98,234,116,34,36,41,110,86,107
],[
246,101,148,129,128,158,163,100,227,150,154,36,249,140,77,141,115,63,12,6
],[
41,249,141,185,175,204,38,244,41,28,63,207,96,94,8,16,21,30,103,75
],[
149,71,53,78,141,159,169,188,32,145,20,247,55,47,207,67,24,119,114,41
],[
59,213,71,26,88,234,255,85,197,140,163,11,255,14,205,192,135,193,23,244
],[
239,186,212,3,52,214,254,74,78,252,112,139,6,162,85,146,8,147,225,25
],[
57,239,63,234,74,115,202,67,142,250,127,126,8,68,178,241,201,247,1,20
],[
121,227,135,225,51,138,82,129,150,224,22,36,24,79,34,49,158,254,148,159
],[
74,83,201,162,148,183,24,139,157,153,192,233,191,181,30,245,105,150,36,45
]
]