aLevelData = [
[
5,5,5,5,5,16,175,17,154,162,151,192,155,186,61,66,250,43,122,26
],[
5,2,2,2,2,1,172,119,227,173,209,202,228,250,58,225,229,96,11,164
],[
5,2,5,3,3,65,158,155,86,61,182,113,188,152,57,108,130,99,196,65
],[
2,2,5,2,3,218,19,203,43,102,213,149,221,88,33,136,188,216,146,167
],[
2,2,3,2,3,75,166,245,89,230,0,160,108,180,198,5,89,215,220,134
],[
2,2,3,2,3,202,229,208,139,89,156,188,210,155,209,110,7,93,170,199
],[
4,2,3,2,2,149,45,13,97,187,29,88,116,226,195,83,251,46,132,99
],[
18,83,19,0,163,170,52,104,65,132,198,149,84,190,0,109,119,149,251,58
],[
30,188,112,89,124,172,196,54,164,60,65,120,238,113,167,120,156,151,227,248
],[
189,144,30,18,82,109,249,110,176,59,23,184,37,31,221,81,222,166,117,69
],[
8,86,25,126,54,137,142,55,3,123,238,179,248,161,171,46,176,60,209,20
],[
57,47,139,113,190,13,233,168,99,119,224,105,113,165,147,221,179,66,208,35
],[
32,125,222,0,185,93,118,210,181,84,15,198,220,24,95,75,49,174,30,199
],[
211,199,13,136,37,80,55,253,45,69,118,38,58,198,58,73,202,108,134,231
],[
170,221,59,238,95,158,153,48,197,41,3,20,246,64,2,139,109,128,141,70
],[
108,57,136,39,154,125,138,245,241,119,227,83,215,254,222,243,139,106,67,7
],[
195,167,32,248,148,136,201,91,145,93,30,33,55,199,12,13,137,203,87,108
],[
247,38,150,0,132,224,127,61,40,36,100,184,115,79,254,220,116,71,106,222
],[
217,14,113,244,87,151,12,194,77,216,39,21,164,32,166,212,249,171,166,52
],[
254,116,5,42,29,74,36,38,95,38,235,254,141,188,14,40,149,80,143,45
]
]