aLevelData = [
[
2,2,2,2,5,5,2,2,2,2,2,2,2,2,2,2,2,2,2,55
],[
2,2,2,4,2,2,2,2,2,2,2,5,2,2,2,5,2,5,2,207
],[
239,74,185,218,87,178,224,137,33,13,226,135,92,252,109,27,66,168,152,79
],[
197,3,26,81,106,81,185,25,90,230,6,76,183,49,72,97,44,249,182,2
],[
200,231,233,181,12,69,144,187,66,5,102,56,17,5,97,149,79,145,44,35
],[
22,42,216,1,26,133,207,63,57,215,9,67,84,80,130,108,94,229,235,246
],[
178,83,159,30,170,97,218,134,109,101,37,218,8,9,21,180,193,79,53,189
],[
167,211,65,22,110,81,149,246,122,102,228,148,58,155,45,71,183,159,235,235
],[
109,212,141,136,89,13,37,46,83,151,100,35,158,118,198,65,190,240,10,153
],[
137,80,229,92,129,228,247,252,97,72,254,142,246,230,74,115,48,190,113,55
],[
121,99,67,185,69,70,0,140,235,55,201,158,179,41,85,23,48,54,229,132
],[
208,227,122,53,177,164,69,227,182,163,95,151,219,189,186,198,197,205,88,193
],[
158,46,186,77,31,123,156,141,238,153,223,41,43,248,199,169,69,21,102,34
],[
19,68,88,21,32,172,177,148,70,147,52,166,126,220,198,237,246,205,34,134
],[
100,22,205,49,155,15,77,178,91,66,150,119,110,41,197,122,240,57,16,105
],[
239,31,253,5,52,73,211,200,95,168,78,202,58,180,151,229,71,177,115,23
],[
155,49,187,41,239,219,12,142,245,106,191,142,232,249,28,164,103,125,202,36
],[
131,147,138,32,23,124,38,141,88,101,163,162,172,236,190,129,192,225,151,25
],[
212,73,167,75,90,169,247,75,192,129,148,74,138,22,62,82,163,116,96,113
],[
245,180,69,25,55,123,136,199,6,195,204,227,56,222,174,231,109,183,248,196
]
]