aLevelData = [
[
2,2,2,2,5,5,2,2,2,2,2,2,2,249,251,178,71,144,8,84
],[
2,2,2,4,2,2,2,2,2,2,2,5,2,67,45,190,209,50,111,12
],[
5,3,3,3,5,5,3,3,3,3,3,3,3,234,30,71,241,51,154,10
],[
2,3,2,2,2,2,2,2,2,3,2,2,2,63,199,169,196,159,57,219
],[
2,3,2,2,2,2,2,2,2,3,2,2,2,208,213,206,185,165,69,233
],[
2,3,2,2,3,2,2,2,2,3,2,2,2,99,243,182,198,120,239,87
],[
2,3,2,2,3,2,2,2,2,3,2,2,2,107,54,234,255,220,227,41
],[
2,3,2,2,3,5,5,3,3,3,3,3,2,185,143,107,241,128,31,74
],[
2,3,3,2,3,2,2,3,2,2,2,3,2,225,71,68,172,133,61,3
],[
2,2,3,2,3,2,2,3,2,1,2,3,2,211,39,78,34,186,232,237
],[
2,2,3,2,3,2,2,3,2,2,2,3,2,223,248,16,17,226,230,163
],[
2,2,3,2,3,2,2,3,2,2,2,3,2,125,111,4,53,69,224,153
],[
2,2,2,2,3,2,2,3,2,2,2,3,2,254,142,83,154,49,149,160
],[
2,2,2,2,3,2,2,3,2,2,2,3,2,205,138,243,142,46,38,31
],[
2,2,2,2,3,2,2,3,2,2,2,3,2,70,146,152,52,7,138,57
],[
6,2,2,2,3,2,2,3,5,5,5,3,2,244,28,138,191,13,11,75
],[
8,2,2,2,3,2,2,3,5,5,5,3,2,18,156,16,109,91,240,201
],[
97,93,144,51,134,8,127,213,146,75,190,59,52,43,19,166,248,18,9,2
],[
106,105,56,24,126,104,198,5,47,45,46,235,103,12,64,230,31,39,106,66
],[
199,62,53,235,232,200,18,36,8,66,87,124,206,199,133,254,102,225,204,169
]
]