aLevelData = [
[
12,2,2,2,2,2,2,2,2,2,2,2,2,2,2,2,2,2,2,2
],[
2,2,2,2,2,2,2,2,2,2,2,2,13,2,2,2,2,2,2,2
],[
2,2,3,3,3,3,3,3,3,3,2,3,3,3,2,3,3,3,2,2
],[
11,2,3,2,2,2,2,2,2,3,2,3,2,3,2,3,2,3,2,2
],[
2,2,3,2,2,2,2,2,2,3,2,3,2,3,2,3,2,3,2,2
],[
2,2,3,2,2,2,2,2,2,3,2,3,2,3,2,3,2,3,2,2
],[
10,2,3,2,2,2,2,2,2,2,2,2,2,2,2,2,2,3,2,2
],[
2,2,3,2,2,2,2,2,3,3,3,3,3,2,2,2,2,3,2,2
],[
2,2,3,2,2,2,2,3,2,2,2,2,1,3,2,2,2,3,2,2
],[
9,2,3,2,2,2,2,3,2,2,2,2,2,2,3,2,2,2,3,2
],[
2,2,3,2,2,2,3,2,2,2,2,2,2,2,2,3,3,2,3,2
],[
2,2,3,2,2,3,2,2,2,2,2,2,2,2,2,2,3,2,3,2
],[
8,2,3,2,2,3,2,2,2,2,2,2,2,2,2,2,3,2,3,2
],[
125,172,110,41,39,14,102,36,205,147,172,20,241,139,222,114,57,205,4,119
],[
10,255,195,128,88,17,212,183,189,11,180,240,200,9,156,209,151,131,179,54
],[
168,210,131,211,236,240,169,28,29,128,209,97,82,14,226,62,209,151,118,50
],[
36,76,141,142,111,147,130,145,0,79,62,209,40,97,171,220,73,111,107,32
],[
49,227,203,8,166,55,242,104,66,113,95,27,130,233,146,235,25,82,8,176
],[
138,248,109,188,245,71,14,119,49,141,141,71,28,1,216,179,47,3,91,199
],[
86,165,117,186,254,107,41,206,111,79,23,120,92,8,170,193,184,140,146,236
]
]