aLevelData = [
[
6,2,2,2,2,180,152,36,6,64,163,53,132,242,66,118,157,80,114,74
],[
2,2,2,2,2,62,93,186,100,87,27,166,115,236,77,119,5,106,129,25
],[
2,2,2,2,2,165,55,78,85,71,140,219,72,231,135,160,20,108,124,113
],[
3,3,3,3,3,213,210,141,184,215,136,122,2,6,23,186,189,165,5,202
],[
2,2,2,2,2,63,67,249,197,11,235,31,53,80,156,206,40,179,248,105
],[
2,2,2,2,2,135,78,64,131,164,249,128,70,18,200,7,21,185,213,26
],[
2,2,2,2,2,112,41,63,234,24,47,114,195,116,166,169,133,52,144,178
],[
2,2,3,3,3,88,52,102,241,156,163,172,168,31,100,199,118,147,180,19
],[
2,2,2,2,2,29,63,14,49,136,244,75,158,12,67,14,138,238,237,95
],[
2,2,2,2,2,231,37,155,150,192,98,207,123,204,78,27,171,67,18,145
],[
3,3,3,3,3,62,240,29,122,166,136,33,75,218,58,95,212,181,135,37
],[
2,2,2,2,2,187,152,84,149,41,87,61,167,195,83,45,114,220,227,43
],[
2,2,2,2,2,167,232,249,119,94,52,2,214,21,213,13,42,245,223,48
],[
2,2,3,3,3,69,88,215,39,255,137,106,63,134,202,94,115,246,156,202
],[
2,2,3,2,2,212,42,58,130,46,209,103,214,232,196,105,124,44,151,86
],[
2,2,3,2,2,202,72,109,142,40,84,17,137,198,21,67,211,138,34,80
],[
2,2,3,3,3,84,77,69,230,213,70,36,37,192,198,33,249,39,38,126
],[
168,8,254,197,167,208,152,103,178,29,165,163,27,200,46,169,99,35,205,0
],[
7,127,28,37,156,242,110,117,30,87,189,76,134,149,228,111,154,37,14,167
],[
9,206,111,175,183,179,50,80,86,144,178,203,54,65,236,119,94,132,53,171
]
]