aLevelData = [
[
5,5,5,5,5,2,2,2,2,2,2,2,2,2,2,2,2,2,2,2
],[
5,2,2,2,2,2,2,2,2,2,2,2,2,2,2,2,2,2,2,2
],[
5,2,5,3,3,3,3,3,3,3,2,2,3,3,3,3,3,3,2,2
],[
2,2,5,2,3,2,2,2,2,2,2,2,3,2,2,2,2,3,2,2
],[
2,2,3,2,3,2,2,2,2,2,2,2,3,2,2,2,2,3,3,3
],[
2,2,3,2,3,3,3,3,3,3,2,2,3,5,5,5,5,5,5,5
],[
4,2,3,2,2,2,2,2,2,3,2,2,3,2,2,2,2,2,2,1
],[
2,2,3,2,2,3,3,3,3,3,2,2,3,3,3,2,2,3,3,3
],[
2,2,2,2,2,3,2,2,2,2,2,2,2,2,3,2,2,3,2,2
],[
136,33,202,99,7,62,227,5,157,79,117,60,108,190,212,95,135,35,197,107
],[
4,10,54,235,83,246,44,27,206,166,252,76,144,150,190,138,139,201,255,125
],[
213,198,182,141,67,225,121,73,57,187,241,10,192,12,140,211,217,160,113,124
],[
18,160,185,16,86,19,220,115,9,164,105,72,85,166,251,17,190,85,104,152
],[
253,95,59,143,11,163,101,115,124,56,47,182,14,177,115,28,130,159,12,102
],[
170,88,139,46,196,247,43,18,6,164,8,20,122,22,139,65,12,85,41,145
],[
226,197,77,15,235,96,146,57,187,67,54,170,150,108,204,246,202,194,48,214
],[
66,85,192,133,89,232,201,105,236,173,64,246,179,79,179,208,209,53,126,47
],[
169,6,66,136,244,104,147,106,16,14,241,166,155,241,250,178,65,221,221,79
],[
210,48,18,106,152,223,73,64,231,185,160,198,245,240,24,72,236,213,74,80
],[
62,227,86,201,57,255,29,100,219,254,176,59,231,104,7,181,56,123,247,169
]
]