aLevelData = [
[
6,2,8,2,195,126,204,82,161,126,57,1,242,175,121,8,202,164,100,45
],[
2,2,2,2,227,1,153,231,236,133,113,122,35,71,49,100,38,63,132,248
],[
2,2,3,3,6,9,40,73,158,230,231,73,35,4,201,50,252,255,136,37
],[
2,2,3,2,211,167,68,17,236,4,120,215,181,151,45,172,159,227,109,190
],[
2,2,3,2,45,44,251,26,74,127,65,205,224,242,138,73,166,45,113,11
],[
2,2,3,2,58,41,153,123,111,56,159,20,232,70,77,196,230,94,17,150
],[
2,2,3,2,94,112,173,142,79,81,47,212,82,3,36,22,115,55,9,39
],[
2,2,3,5,63,16,2,236,30,42,207,120,227,219,251,118,162,184,86,199
],[
2,2,2,2,193,91,166,109,82,100,154,168,160,190,255,94,8,36,54,192
],[
2,3,2,2,11,227,230,43,161,225,238,76,207,222,158,136,123,250,38,155
],[
2,3,2,2,128,119,78,127,254,193,104,143,243,171,131,236,16,252,226,32
],[
2,3,2,3,197,42,173,1,159,101,229,216,211,215,157,195,27,43,104,88
],[
2,3,2,3,192,76,14,139,248,111,131,210,115,83,25,135,49,199,244,141
],[
2,3,2,3,150,110,190,54,192,191,157,100,24,79,98,239,39,83,4,71
],[
2,3,2,3,172,96,76,91,235,118,209,185,71,61,39,246,19,142,84,80
],[
2,3,2,3,166,53,131,146,173,246,253,56,198,206,84,212,74,122,225,176
],[
2,3,2,3,105,62,113,181,125,223,60,139,152,241,23,2,95,89,234,177
],[
5,3,3,3,28,10,99,221,14,18,236,156,4,218,219,57,42,169,233,219
],[
2,2,2,5,34,107,230,98,86,177,171,146,141,248,79,115,189,46,158,247
],[
2,2,2,2,32,114,198,222,138,28,84,215,250,253,95,232,111,232,3,15
]
]