aLevelData = [
[
2,2,2,2,128,19,183,98,145,165,245,17,135,242,184,5,49,163,216,72
],[
2,2,13,5,192,49,188,53,113,248,29,47,108,142,12,146,235,82,55,234
],[
2,2,2,5,158,72,104,99,79,36,78,129,194,164,128,17,223,35,191,96
],[
2,2,2,2,18,108,123,170,243,204,153,213,34,107,116,95,117,219,34,150
],[
2,2,2,2,86,242,248,7,102,213,80,56,103,86,137,154,88,128,80,185
],[
2,2,2,2,225,111,30,182,242,102,2,247,168,27,161,29,112,85,123,54
],[
2,2,2,2,110,185,112,52,32,225,130,159,62,175,220,134,229,225,20,187
],[
2,2,2,2,245,229,173,64,184,238,224,252,196,71,155,178,34,232,203,52
],[
2,2,2,2,175,71,215,212,195,112,108,28,17,88,128,191,206,110,145,206
],[
2,2,2,2,22,116,46,47,139,141,185,76,63,151,107,8,212,186,152,247
],[
2,2,2,2,225,65,53,206,152,169,151,24,166,248,125,43,91,81,81,91
],[
2,2,2,2,11,196,171,109,180,106,23,79,224,178,24,6,205,246,109,231
],[
4,2,2,2,204,82,146,10,231,181,138,252,198,56,220,180,212,175,220,200
],[
2,2,2,2,157,126,43,225,122,175,129,109,113,65,170,147,87,194,207,108
],[
2,2,2,3,55,32,247,112,248,188,205,46,57,192,164,65,128,179,184,127
],[
2,2,2,3,148,74,183,115,39,129,128,14,184,235,42,153,184,70,72,238
],[
2,2,2,5,236,83,107,232,18,229,233,24,199,55,221,185,168,130,111,230
],[
184,207,86,11,2,10,155,154,127,89,159,255,57,172,95,213,177,148,247,90
],[
126,88,101,32,56,70,144,6,148,71,137,103,208,182,16,145,82,114,90,121
],[
140,50,17,173,34,25,157,137,79,139,162,174,133,62,201,176,83,148,196,15
]
]