aLevelData = [
[
2,2,2,75,251,245,85,252,165,0,86,206,237,47,246,168,107,200,50,38
],[
2,2,2,162,85,57,71,223,250,114,102,100,5,191,108,198,199,4,67,148
],[
5,2,5,163,227,142,57,100,202,151,36,211,48,136,38,138,27,223,27,3
],[
5,2,5,230,28,204,244,65,188,20,223,121,107,66,228,250,118,191,219,18
],[
5,5,5,127,241,159,247,116,94,172,12,194,21,237,96,197,74,207,119,131
],[
5,2,5,64,154,78,155,108,1,153,120,215,248,79,202,196,197,104,55,147
],[
5,2,5,90,230,77,229,226,18,188,1,154,8,194,118,226,117,230,2,148
],[
2,2,2,160,233,179,148,167,250,76,168,11,41,234,138,111,30,231,60,157
],[
2,2,7,11,255,156,202,223,177,56,27,189,232,99,104,172,219,137,63,144
],[
2,2,7,50,191,44,89,106,158,55,122,122,82,175,156,183,238,38,148,245
],[
2,2,7,2,189,147,239,112,162,157,233,123,214,61,147,33,52,118,49,171
],[
2,2,7,175,252,249,130,219,165,188,68,175,26,201,23,137,210,15,62,114
],[
2,2,7,65,129,234,163,76,191,82,73,1,242,5,134,133,247,127,184,77
],[
2,2,7,193,251,253,145,248,137,247,254,230,96,204,172,148,117,113,79,48
],[
2,2,2,77,41,177,178,15,72,96,192,221,61,163,206,100,207,179,137,178
],[
167,40,118,72,15,178,214,113,249,9,206,210,67,39,196,65,57,180,12,219
],[
92,194,196,80,98,186,252,130,125,150,27,79,224,81,125,170,128,156,97,241
],[
23,211,3,122,111,47,5,112,221,61,19,221,11,143,199,7,251,177,202,0
],[
73,94,61,121,177,244,87,215,208,38,79,137,47,241,124,152,125,209,187,127
],[
28,52,17,62,224,47,145,170,19,112,128,7,188,116,184,216,32,250,74,246
]
]