aLevelData = [
[
2,2,2,2,2,2,2,2,2,2,2,2,2,2,2,2,2,2,5,165
],[
2,2,2,2,2,2,2,2,3,3,3,3,3,3,3,3,3,2,5,234
],[
2,2,3,2,3,2,2,2,2,3,2,2,2,2,2,2,2,2,5,172
],[
2,2,3,2,3,2,2,2,2,2,3,2,2,2,2,2,2,2,5,38
],[
2,2,3,2,3,2,2,2,2,2,2,3,2,2,2,2,2,3,2,39
],[
2,2,3,2,2,2,2,2,2,2,2,2,3,2,2,3,3,2,2,198
],[
2,2,3,2,3,3,3,3,3,3,3,3,3,2,2,2,2,2,2,46
],[
2,2,3,2,2,2,2,2,2,2,2,2,2,2,2,2,2,2,2,153
],[
2,2,3,2,3,3,3,3,3,3,3,3,3,3,3,3,3,3,2,34
],[
26,167,17,83,254,222,7,224,74,88,189,146,253,42,198,62,224,11,200,132
],[
102,173,129,188,215,78,8,46,173,138,85,129,63,115,4,119,156,227,86,215
],[
186,17,121,170,208,99,9,169,0,131,214,247,57,181,232,12,92,104,192,241
],[
157,10,225,179,45,33,143,18,22,152,215,121,102,86,207,51,143,22,31,219
],[
14,114,192,20,75,64,4,123,192,34,215,218,94,89,68,159,44,218,59,140
],[
50,164,145,175,149,80,72,149,3,234,17,187,81,255,15,69,99,247,222,242
],[
77,165,212,80,183,29,134,44,134,198,142,77,185,176,140,98,144,39,107,56
],[
244,136,230,48,19,83,74,241,75,130,125,90,73,25,63,186,114,255,176,68
],[
129,12,18,189,114,99,209,120,160,2,192,132,42,151,166,36,154,149,249,127
],[
201,136,233,153,253,166,161,130,85,166,201,206,103,213,79,68,39,102,103,219
],[
11,9,208,226,108,192,89,126,48,238,165,89,166,177,43,153,177,114,128,15
]
]