aLevelData = [
[
6,2,8,2,9,2,10,2,11,3,2,6,230,65,46,153,48,149,217,229
],[
2,2,2,2,2,2,2,2,12,3,5,169,82,106,27,143,78,174,227,182
],[
154,197,242,208,180,128,223,235,254,14,50,59,111,216,191,26,137,169,50,77
],[
139,18,234,137,231,13,11,53,246,224,206,114,235,68,28,89,6,199,92,131
],[
10,111,137,207,240,160,135,95,221,63,183,228,82,24,201,28,162,125,209,153
],[
170,48,157,195,188,132,70,32,220,190,6,211,47,193,73,99,176,235,7,190
],[
37,58,80,126,82,179,41,106,108,4,150,64,208,104,248,178,245,203,153,174
],[
159,47,134,226,86,78,157,128,23,128,230,62,73,224,39,162,242,170,178,124
],[
43,232,130,180,210,78,134,69,126,98,61,138,184,224,131,185,104,92,171,173
],[
141,41,205,232,49,122,97,216,157,199,13,89,201,114,188,124,22,171,240,134
],[
63,145,89,60,141,153,166,94,75,52,155,114,122,172,100,194,198,79,41,168
],[
184,208,226,9,44,234,109,32,6,70,221,125,33,159,22,77,136,36,151,219
],[
233,30,150,87,70,210,82,215,238,169,165,155,172,142,216,149,62,152,188,40
],[
8,233,246,49,10,214,155,68,16,72,253,56,40,97,196,229,89,99,64,44
],[
146,206,253,56,225,201,152,4,229,195,210,29,134,90,227,170,227,124,17,169
],[
140,204,128,123,242,71,76,163,28,39,213,203,155,7,90,7,191,73,202,94
],[
11,181,214,135,231,98,75,240,149,218,159,5,102,121,201,174,46,22,86,25
],[
245,230,186,187,239,156,228,145,175,213,21,172,151,180,241,236,147,201,215,12
],[
7,56,110,222,5,23,128,216,196,23,12,208,77,103,150,4,120,213,194,93
],[
23,55,33,245,113,9,75,214,242,87,46,5,32,222,165,191,209,110,77,2
]
]