aLevelData = [
[
4,2,2,2,2,101,216,28,234,102,47,73,10,77,229,39,177,211,30,87
],[
2,2,3,2,9,202,199,189,68,232,4,133,179,136,161,126,155,150,103,155
],[
2,3,2,2,2,54,50,136,153,88,179,141,42,0,236,145,83,44,175,173
],[
2,3,2,2,2,19,242,144,179,69,205,235,31,199,53,41,74,220,114,62
],[
2,3,2,2,3,225,207,177,118,150,218,88,114,21,69,151,109,58,210,63
],[
2,3,2,3,2,197,129,89,216,182,190,176,238,104,14,205,171,44,13,47
],[
171,2,73,122,11,96,247,97,195,46,229,200,54,21,176,42,8,249,55,57
],[
48,196,79,197,78,102,185,223,62,26,81,62,237,234,135,226,107,117,19,246
],[
66,240,229,251,7,107,91,35,46,85,183,251,34,67,208,77,150,237,8,69
],[
21,121,125,210,225,253,132,79,250,63,83,99,125,191,253,38,47,247,164,133
],[
90,225,233,231,216,186,168,17,109,6,227,70,90,212,251,179,46,67,38,11
],[
224,69,29,111,27,163,21,144,217,65,241,23,51,164,182,69,119,177,63,214
],[
124,183,50,44,50,176,50,169,125,196,86,93,68,15,218,225,197,164,21,130
],[
43,210,171,162,98,166,4,92,42,176,253,103,106,10,221,61,199,151,138,124
],[
118,137,253,140,78,38,243,130,34,203,229,68,77,49,59,238,142,239,189,117
],[
23,64,74,139,224,7,204,194,65,16,107,243,192,153,1,225,40,17,206,26
],[
219,31,110,30,104,230,7,195,96,136,199,216,102,232,142,9,134,181,231,2
],[
200,164,61,216,4,252,76,164,247,88,213,113,151,168,150,88,164,122,121,233
],[
128,120,12,205,64,49,49,170,3,28,23,71,130,217,104,241,233,187,196,29
],[
230,132,111,78,255,111,70,57,40,116,248,39,149,199,114,156,205,162,155,54
]
]