aLevelData = [
[
2,2,2,5,2,187,13,106,134,11,161,96,209,224,59,130,215,208,170,185
],[
2,2,2,2,2,233,177,252,39,177,91,54,14,127,175,72,238,221,217,63
],[
2,2,3,3,3,238,105,209,189,125,228,40,166,57,134,1,29,16,148,94
],[
175,165,53,157,205,245,130,66,128,58,220,246,88,16,130,208,166,214,98,212
],[
234,87,48,185,143,169,182,240,214,86,107,225,17,186,70,120,17,172,212,224
],[
225,97,137,142,181,140,84,130,29,202,117,201,126,62,147,71,195,120,9,179
],[
80,156,130,227,55,192,197,74,175,149,210,191,194,74,45,127,69,173,122,118
],[
13,148,74,186,96,123,53,89,170,110,41,84,113,42,1,235,139,127,89,27
],[
143,248,161,102,137,190,113,210,242,186,28,52,223,250,136,174,120,86,61,119
],[
172,83,187,218,35,71,17,130,116,190,171,244,153,29,108,93,160,133,253,142
],[
162,250,100,69,249,197,216,174,174,22,211,41,49,238,106,78,77,60,218,46
],[
90,71,99,220,181,75,89,45,109,103,120,187,63,182,120,48,197,189,225,193
],[
234,5,33,248,161,8,219,183,215,82,131,122,165,224,40,220,203,204,144,93
],[
90,44,138,98,176,55,128,125,169,169,76,239,20,105,76,107,100,105,185,29
],[
168,206,52,235,190,82,162,251,195,230,58,117,205,155,220,138,221,194,165,181
],[
15,82,192,64,20,139,127,11,226,217,170,137,170,251,23,11,11,100,122,65
],[
133,226,127,253,48,125,22,59,174,162,14,95,94,129,230,189,210,179,224,94
],[
132,32,86,1,196,32,81,97,245,224,88,182,249,8,134,126,234,154,224,125
],[
11,29,229,3,254,252,102,109,55,41,151,238,176,5,103,144,222,132,13,117
],[
229,140,227,99,8,159,120,128,99,186,224,89,220,125,79,41,87,139,231,89
]
]