aLevelData = [
[
5,5,3,5,5,5,5,5,5,5,3,5,5,5,5,5,5,5,5,81
],[
4,2,3,5,5,5,5,5,5,5,3,5,5,5,5,5,5,5,5,121
],[
2,2,3,2,3,3,3,3,3,2,3,3,3,3,3,5,5,3,5,59
],[
5,2,2,2,3,2,2,2,2,2,5,5,5,5,5,5,5,3,5,245
],[
2,2,2,3,2,2,2,2,2,2,5,5,5,5,5,5,5,3,5,186
],[
2,2,2,3,2,2,5,3,3,2,3,3,3,3,3,5,5,3,5,195
],[
2,2,2,2,2,2,5,5,3,2,2,2,2,2,2,2,2,3,5,13
],[
5,2,2,2,2,2,5,5,3,2,2,2,2,2,2,2,2,3,5,177
],[
2,2,5,5,3,2,5,5,3,2,3,3,3,5,5,3,5,3,5,48
],[
2,2,5,5,3,2,5,5,3,6,3,3,5,5,5,3,5,3,5,164
],[
2,2,3,3,3,2,5,5,3,5,5,3,5,5,5,3,5,3,5,226
],[
2,2,3,2,2,2,5,5,3,5,5,5,3,5,5,3,5,3,5,9
],[
2,2,3,2,2,2,5,5,3,5,5,5,3,3,5,3,5,3,5,226
],[
2,2,3,2,5,2,3,3,3,5,5,5,3,3,5,3,5,3,5,158
],[
2,2,2,2,5,2,3,5,5,5,5,5,5,3,5,3,5,3,5,5
],[
2,2,2,2,5,2,5,5,5,5,5,5,5,5,5,3,5,3,5,171
],[
24,230,166,153,26,187,219,34,78,247,228,17,160,228,179,36,38,80,172,191
],[
4,228,169,226,142,177,65,89,173,12,74,50,132,156,156,116,83,177,24,14
],[
155,215,233,14,131,172,10,19,122,238,8,5,30,216,10,3,92,175,14,157
],[
217,152,117,68,145,172,194,254,191,78,159,95,252,188,33,180,170,229,76,129
]
]