aLevelData = [
[
4,2,5,5,2,63,32,197,107,107,133,25,39,76,219,103,143,96,251,52
],[
2,2,2,2,2,226,122,186,15,69,183,17,33,10,179,123,6,49,253,159
],[
2,2,2,2,2,219,47,200,47,152,239,227,16,160,23,235,187,151,140,191
],[
3,3,3,3,3,227,116,56,52,88,215,11,10,43,156,63,31,19,176,225
],[
2,2,3,2,2,227,15,35,141,12,77,127,121,139,75,89,180,190,60,37
],[
13,2,3,2,2,176,231,173,79,255,221,104,135,90,1,152,92,231,116,47
],[
2,5,3,2,2,12,188,135,133,154,159,115,65,34,15,75,125,106,137,46
],[
2,12,3,2,2,37,185,4,193,160,236,190,220,179,198,58,132,162,136,137
],[
5,2,3,3,3,26,152,193,202,209,72,104,237,102,213,40,188,11,239,251
],[
27,164,64,250,142,53,6,116,253,155,1,61,180,123,143,72,174,121,22,120
],[
19,170,162,180,255,75,207,58,133,179,234,53,244,134,83,145,88,44,37,14
],[
68,129,25,147,207,206,168,198,221,249,112,217,160,248,217,166,94,139,248,255
],[
116,43,180,63,155,61,39,37,106,140,71,227,28,246,197,113,148,102,53,39
],[
158,2,112,139,120,165,54,104,145,143,24,32,144,91,149,66,152,50,132,95
],[
202,63,178,26,12,98,203,127,9,41,126,150,121,252,220,55,163,151,1,31
],[
32,190,247,68,225,43,215,102,116,204,49,231,130,43,174,220,157,46,244,100
],[
56,0,202,57,247,79,125,132,42,184,130,246,148,127,92,20,112,132,193,210
],[
182,114,248,100,154,58,133,81,85,192,8,201,41,211,99,56,159,99,27,27
],[
20,238,1,19,115,60,17,55,68,76,154,175,230,142,159,127,24,83,125,160
],[
191,129,207,85,227,139,143,188,250,160,126,163,105,35,197,158,72,92,220,86
]
]