aLevelData = [
[
2,2,2,2,2,2,2,2,2,2,2,2,2,2,2,235,197,43,74,103
],[
2,2,2,2,2,2,2,2,2,2,2,2,2,2,2,79,204,231,79,156
],[
2,2,2,2,2,2,2,2,2,2,2,2,2,2,2,23,181,30,202,255
],[
2,2,2,13,2,2,2,2,2,2,2,2,2,2,2,230,10,197,15,239
],[
2,2,2,2,2,2,2,2,2,2,2,2,2,2,2,136,190,8,151,18
],[
2,2,2,2,2,2,2,2,2,2,2,2,2,2,2,217,204,78,40,38
],[
2,2,2,2,2,2,2,2,2,2,2,2,2,2,2,122,193,149,211,219
],[
2,2,2,2,2,2,2,2,2,1,2,2,2,2,2,171,243,160,253,238
],[
2,2,11,2,2,2,2,2,2,2,2,2,2,2,2,113,146,29,226,212
],[
2,2,2,2,2,2,2,2,2,2,2,2,2,2,2,236,202,237,188,91
],[
2,2,2,2,2,2,2,2,2,2,2,2,2,2,2,72,84,41,113,51
],[
2,2,2,2,2,2,2,2,2,2,2,2,2,2,2,80,61,84,100,101
],[
2,2,2,2,2,2,2,2,2,2,2,2,2,2,2,68,184,25,239,241
],[
10,79,254,234,238,115,99,136,236,58,11,215,102,206,140,229,206,42,254,57
],[
22,199,12,161,103,120,74,49,21,146,202,136,211,81,234,85,35,119,111,26
],[
17,54,216,48,33,80,236,12,134,125,150,192,148,13,242,196,120,206,168,247
],[
39,48,121,225,148,167,23,59,38,81,58,177,105,217,240,230,4,155,52,185
],[
235,9,195,199,213,77,43,48,241,48,37,159,212,58,36,132,182,26,46,164
],[
223,73,235,212,92,235,252,1,246,246,141,116,101,149,46,84,192,207,222,109
],[
56,100,105,47,6,247,245,250,162,114,215,153,54,167,171,12,82,51,163,138
]
]