aLevelData = [
[
4,2,2,2,2,2,2,2,2,2,2,2,2,2,2,2,2,2,2,190
],[
5,2,5,3,2,2,2,2,2,2,2,2,2,2,2,2,2,2,2,135
],[
2,5,5,3,3,3,3,3,3,3,3,3,3,3,3,3,3,3,2,166
],[
3,3,5,5,5,5,5,5,5,5,3,2,2,2,2,2,2,2,2,73
],[
2,3,5,5,5,5,5,5,5,5,3,6,2,2,2,2,2,2,2,13
],[
3,3,5,5,5,5,3,3,3,3,3,3,3,3,3,2,3,3,3,168
],[
3,5,5,5,5,5,3,2,2,2,2,2,2,2,2,2,2,2,2,78
],[
3,5,5,3,3,3,3,8,2,2,2,5,5,5,5,5,5,5,5,103
],[
3,5,5,3,2,2,3,3,3,3,2,5,3,3,3,5,3,3,3,172
],[
3,5,5,3,2,2,2,2,2,3,2,5,3,5,5,5,5,5,5,31
],[
3,5,5,3,2,2,3,2,2,3,2,5,3,5,5,5,5,5,5,52
],[
5,5,5,3,2,2,3,2,2,3,2,5,3,5,5,5,5,5,5,23
],[
5,5,5,3,2,2,3,2,2,3,2,5,3,3,3,5,5,5,5,189
],[
205,195,228,41,76,58,224,78,213,2,164,241,96,63,146,122,12,165,93,96
],[
194,140,204,226,21,71,186,248,109,178,98,137,101,11,217,222,113,3,220,87
],[
196,20,204,92,113,20,247,151,208,11,25,96,35,66,35,121,121,156,58,252
],[
211,41,3,145,134,249,30,228,224,46,240,87,14,85,166,244,61,247,118,165
],[
0,106,40,167,242,237,214,60,156,245,240,160,153,193,130,63,247,52,186,37
],[
225,228,165,182,123,111,57,159,14,14,152,12,101,108,147,28,119,184,109,145
],[
70,248,226,205,6,161,104,250,130,101,181,136,188,77,129,220,211,7,141,70
]
]