aLevelData = [
[
2,2,2,2,2,11,2,2,227,139,104,6,123,102,53,198,9,135,170,32
],[
2,2,2,2,2,2,2,2,13,136,199,169,21,197,73,183,111,110,113,24
],[
5,2,5,2,5,5,5,2,0,218,7,4,116,30,159,79,152,223,27,227
],[
5,2,5,2,5,2,5,2,3,100,113,110,252,239,174,88,152,78,59,248
],[
5,5,5,2,5,5,5,2,35,173,95,7,193,174,6,85,85,188,193,186
],[
5,2,5,2,5,2,5,2,162,156,13,80,177,68,216,223,114,241,65,153
],[
5,2,5,2,5,2,5,2,165,116,160,8,251,204,198,68,121,250,134,105
],[
2,2,2,12,2,2,2,2,30,17,116,72,197,141,236,93,77,229,86,2
],[
2,2,7,2,2,2,2,2,246,100,169,225,14,52,46,175,206,188,135,24
],[
2,2,7,2,5,5,5,2,127,44,239,245,224,85,195,197,204,191,66,91
],[
2,2,7,2,5,2,2,2,24,245,145,212,187,36,1,204,49,228,149,210
],[
33,86,191,24,61,111,107,111,105,147,62,115,32,102,32,3,20,223,248,245
],[
21,158,182,7,52,127,151,24,40,111,164,152,241,126,125,61,187,54,84,247
],[
4,43,60,39,1,212,164,12,62,153,30,125,134,45,102,222,2,30,159,77
],[
164,171,223,28,199,213,238,132,15,185,75,151,151,28,112,119,75,72,87,198
],[
146,23,61,93,49,77,166,65,108,42,161,210,109,64,77,70,234,131,156,86
],[
3,159,87,55,105,142,99,204,197,105,66,26,88,126,220,252,222,164,128,24
],[
185,203,38,17,75,215,247,255,164,175,15,28,93,144,129,191,195,168,155,143
],[
57,224,108,240,215,249,132,194,87,218,251,75,50,40,181,113,6,24,227,45
],[
59,129,205,60,230,54,208,24,237,146,162,38,109,84,222,49,88,173,188,23
]
]