aLevelData = [
[
2,2,2,2,2,2,2,2,2,2,111,248,142,113,74,228,145,76,71,128
],[
2,2,2,2,2,2,2,2,2,2,72,200,42,13,59,95,88,241,139,190
],[
2,2,2,2,2,2,2,2,2,2,150,104,212,26,19,118,87,199,169,32
],[
2,2,2,13,2,2,2,2,2,2,89,7,96,219,198,32,52,69,26,177
],[
2,2,2,2,2,2,2,2,2,2,24,19,129,69,58,74,61,41,137,179
],[
2,2,2,2,2,2,2,2,2,2,73,123,117,136,60,132,245,116,111,72
],[
2,2,2,2,2,2,2,2,2,2,207,187,98,90,20,180,92,245,233,128
],[
2,2,2,2,2,2,2,2,2,1,82,73,141,246,10,19,152,221,129,112
],[
2,2,11,2,2,2,2,2,2,2,129,94,137,243,99,184,182,245,1,54
],[
123,44,7,95,145,128,147,108,152,25,243,255,1,189,177,17,43,89,204,44
],[
204,221,73,219,147,77,234,96,12,21,62,164,195,158,218,116,172,30,229,233
],[
194,180,218,40,239,180,137,76,44,64,95,161,233,24,232,19,175,178,146,230
],[
4,142,180,167,143,196,206,98,124,223,19,21,34,237,36,101,227,215,31,144
],[
84,239,216,163,158,200,102,237,37,74,226,179,103,5,107,37,38,198,109,145
],[
201,104,35,215,0,237,91,29,167,206,122,195,237,142,191,153,181,149,204,80
],[
60,60,98,47,252,37,108,7,209,205,63,105,91,100,32,22,163,220,6,183
],[
1,64,162,207,61,71,157,237,244,41,33,38,61,177,154,194,141,147,190,54
],[
216,1,203,83,249,121,15,188,84,225,174,157,186,213,160,154,141,64,249,6
],[
36,41,109,86,112,208,19,213,224,250,105,153,131,137,153,181,109,79,250,176
],[
91,36,218,54,154,54,123,14,36,161,91,76,13,64,184,200,29,194,84,206
]
]