aLevelData = [
[
2,2,2,5,2,2,0,205,54,185,104,101,63,113,16,67,103,246,199,137
],[
2,2,2,2,2,5,151,161,87,104,140,72,10,147,126,88,108,244,255,36
],[
2,2,3,3,3,3,83,159,39,125,29,4,238,131,57,104,217,186,233,150
],[
2,3,2,2,2,2,217,97,69,209,112,255,132,14,21,62,119,96,218,252
],[
86,180,76,160,191,190,154,170,252,51,250,143,133,57,73,195,197,28,241,23
],[
33,66,16,69,55,97,215,201,99,239,48,243,136,218,163,59,13,122,122,212
],[
37,196,35,132,84,192,215,178,47,61,121,193,99,195,193,156,248,201,153,146
],[
215,40,199,101,138,208,205,157,68,185,13,34,33,29,49,10,174,229,202,176
],[
172,97,55,6,17,59,201,44,80,174,37,65,218,243,233,121,229,252,146,111
],[
108,101,157,189,119,168,236,203,156,144,108,228,198,240,245,143,53,148,113,28
],[
198,120,65,125,117,56,220,87,32,200,185,89,142,101,112,205,175,203,28,108
],[
37,169,3,119,4,82,121,3,214,181,1,149,227,143,182,238,175,223,233,40
],[
195,155,12,2,176,161,206,121,82,240,136,152,82,24,216,144,238,239,139,11
],[
253,134,193,190,45,91,75,61,144,208,88,20,87,220,81,19,221,1,1,233
],[
231,126,249,245,42,197,51,88,13,47,245,79,177,239,248,192,46,69,202,18
],[
32,244,113,66,99,245,81,51,26,109,80,70,246,221,55,43,181,152,91,247
],[
232,123,126,118,250,216,240,194,110,179,249,20,104,49,124,219,111,77,212,11
],[
113,205,2,184,7,116,10,227,251,122,154,148,8,57,237,41,224,41,239,237
],[
116,14,162,236,111,112,192,6,3,76,162,67,233,9,96,102,163,173,58,197
],[
5,81,54,87,243,211,11,15,108,202,62,104,200,191,139,66,61,154,134,236
]
]