aLevelData = [
[
4,2,5,5,2,2,2,2,2,2,2,2,2,245,52,192,50,198,189,117
],[
2,2,2,2,2,2,5,2,2,2,5,2,2,108,89,135,200,153,155,159
],[
2,2,2,2,2,2,3,3,3,3,3,3,3,41,188,157,161,80,0,231
],[
3,3,3,3,3,3,3,2,2,2,2,2,3,194,45,227,14,20,30,154
],[
2,2,3,2,2,2,2,2,2,2,2,2,3,137,6,101,177,192,42,217
],[
13,2,3,2,2,2,2,2,2,3,2,2,3,243,102,60,219,137,9,95
],[
2,5,3,2,2,2,2,2,2,3,2,2,3,140,102,231,169,62,226,4
],[
2,12,3,2,2,2,2,2,2,3,2,2,3,226,40,164,121,137,93,198
],[
5,2,3,3,3,3,3,3,3,3,2,2,3,15,24,255,52,12,138,175
],[
11,2,3,2,2,2,2,2,2,2,2,2,2,85,77,25,73,238,149,76
],[
2,5,3,2,2,2,2,2,2,2,2,2,2,206,67,37,49,162,127,141
],[
2,10,3,2,2,2,2,2,2,2,2,2,2,231,248,85,193,96,138,232
],[
5,2,2,2,2,2,2,2,2,2,2,2,2,111,101,141,232,144,219,228
],[
2,2,2,2,2,2,2,2,2,2,2,2,2,254,62,68,148,107,197,137
],[
9,5,3,2,2,2,2,2,2,2,2,2,2,120,236,252,246,54,224,214
],[
2,2,3,2,2,2,2,2,3,3,3,3,3,134,113,172,52,97,64,95
],[
5,8,3,2,2,2,2,2,3,2,2,2,2,253,163,223,146,113,95,165
],[
2,2,3,2,2,2,2,2,5,2,1,2,2,147,186,228,54,194,196,62
],[
6,5,3,3,3,3,3,3,3,2,2,2,2,250,58,79,0,206,180,67
],[
2,2,2,2,2,2,2,2,2,2,2,2,2,65,249,169,67,229,97,183
]
]