aLevelData = [
[
2,2,2,2,2,180,240,236,153,164,132,77,102,178,57,212,36,189,130,244
],[
2,2,2,2,2,12,109,122,51,28,24,49,46,11,226,67,222,130,41,176
],[
5,2,5,2,5,27,137,32,231,94,64,185,36,203,207,201,252,111,159,103
],[
5,2,5,2,5,55,198,203,148,221,128,209,34,147,132,142,206,40,54,105
],[
5,5,5,2,5,176,108,245,206,213,65,232,222,42,244,251,100,155,205,36
],[
5,2,5,2,5,11,125,228,235,207,41,55,41,178,234,250,16,176,26,46
],[
5,2,5,2,5,107,244,135,117,39,76,28,37,19,219,189,155,228,14,114
],[
2,2,2,12,2,210,124,209,200,52,108,2,116,175,183,37,58,12,217,90
],[
2,2,7,2,2,13,124,7,141,120,116,185,237,60,187,102,159,59,194,142
],[
2,2,7,2,5,179,148,51,254,87,16,204,80,74,189,110,177,148,216,113
],[
231,117,240,59,146,155,73,17,177,151,127,44,105,146,107,16,2,60,74,25
],[
51,6,28,87,159,145,75,156,159,102,141,210,66,231,11,146,146,134,195,243
],[
25,52,43,160,164,28,23,46,71,146,220,172,161,70,182,123,97,190,103,96
],[
9,3,33,215,243,154,166,170,145,181,174,195,248,171,137,62,160,166,5,195
],[
101,155,146,19,210,128,164,224,159,185,89,226,120,211,92,39,1,116,9,171
],[
22,146,210,40,87,228,225,47,228,150,254,120,101,65,180,119,78,26,175,47
],[
97,106,105,75,116,62,6,107,116,95,124,188,170,132,246,203,61,199,123,155
],[
248,86,202,245,78,107,137,255,155,126,159,16,173,185,223,195,131,172,230,74
],[
84,66,70,5,212,243,228,83,178,60,158,169,101,76,49,225,40,1,90,212
],[
67,18,60,42,141,142,2,113,47,133,197,109,170,4,176,175,28,71,98,105
]
]