aLevelData = [
[
4,2,2,2,2,2,2,2,2,2,2,2,2,2,2,2,2,2,2,142
],[
5,2,5,3,2,2,2,2,2,2,2,2,2,2,2,2,2,2,2,198
],[
2,5,5,3,3,3,3,3,3,3,3,3,3,3,3,3,3,3,2,105
],[
3,3,5,5,5,5,5,5,5,5,3,2,2,2,2,2,2,2,2,207
],[
2,3,5,5,5,5,5,5,5,5,3,6,2,2,2,2,2,2,2,30
],[
3,3,5,5,5,5,3,3,3,3,3,3,3,3,3,2,3,3,3,93
],[
3,5,5,5,5,5,3,2,2,2,2,2,2,2,2,2,2,2,2,11
],[
3,5,5,3,3,3,3,8,2,2,2,5,5,5,5,5,5,5,5,240
],[
226,224,92,180,181,71,193,248,210,121,214,249,78,191,15,106,230,120,159,196
],[
251,15,152,222,219,43,84,189,66,37,21,173,33,191,232,144,157,19,207,119
],[
91,201,30,111,251,141,38,158,226,192,17,142,61,110,13,200,66,129,173,165
],[
185,52,139,97,188,202,51,113,187,127,60,22,195,191,184,51,255,150,207,92
],[
127,104,166,47,56,226,134,231,76,48,58,46,140,112,184,51,59,103,4,253
],[
21,115,82,255,144,193,107,236,98,192,81,204,67,214,38,80,244,81,74,98
],[
128,160,196,1,194,195,227,76,39,0,36,220,182,216,87,87,77,57,254,66
],[
45,245,246,23,184,115,89,152,122,165,162,98,103,57,18,197,99,20,83,211
],[
8,252,92,183,163,148,148,73,127,142,58,223,103,28,4,101,102,167,6,176
],[
209,196,214,15,135,100,238,35,120,74,81,241,100,195,114,54,229,145,81,250
],[
176,40,231,104,24,29,196,221,212,219,247,63,1,152,46,144,107,135,30,195
],[
8,79,37,206,197,189,46,0,133,181,214,149,103,111,205,136,72,224,126,168
]
]