aLevelData = [
[
6,2,8,2,9,2,10,2,11,3,2,215,19,6,105,252,187,5,196,33
],[
2,2,2,2,2,2,2,2,12,3,5,234,224,56,246,29,114,69,200,254
],[
2,2,3,3,3,3,3,3,3,3,2,10,12,3,218,17,100,245,85,237
],[
2,2,3,2,2,2,2,2,2,2,5,43,212,93,36,218,3,92,197,92
],[
2,2,3,2,2,2,2,2,2,2,2,145,178,4,33,3,98,36,110,83
],[
2,2,3,2,3,3,3,3,3,3,2,11,154,247,56,27,111,175,168,63
],[
2,2,3,2,2,2,2,5,5,3,2,230,223,155,30,95,117,19,70,123
],[
159,89,102,129,153,137,191,0,196,80,213,182,247,245,106,177,25,150,172,180
],[
240,181,174,220,52,243,21,131,232,26,20,101,234,97,154,1,200,236,201,67
],[
213,147,171,95,124,228,32,0,213,107,27,162,118,49,14,60,140,130,163,35
],[
42,243,173,43,224,164,94,15,144,195,186,19,125,81,75,231,165,41,23,207
],[
81,62,207,1,234,36,73,78,14,210,48,5,227,166,251,21,171,169,27,113
],[
153,21,121,185,227,20,31,22,25,203,53,102,181,151,48,153,243,150,70,90
],[
227,106,37,242,188,57,228,106,115,248,58,240,140,234,238,125,49,99,142,180
],[
129,210,100,12,42,254,166,49,58,144,237,168,50,210,232,178,92,182,82,116
],[
95,26,33,84,17,74,1,166,140,199,0,136,132,71,139,10,216,252,153,147
],[
102,25,38,128,36,147,227,13,109,36,44,121,152,150,58,101,207,62,154,126
],[
30,199,221,91,203,49,146,168,230,24,113,133,32,58,217,41,225,52,125,203
],[
148,140,90,194,70,244,236,235,111,205,161,75,15,235,142,245,253,152,96,46
],[
124,219,150,208,16,250,238,236,144,61,29,179,123,245,195,151,143,189,158,173
]
]