aLevelData = [
[
4,2,130,77,71,253,222,98,206,85,78,230,0,194,66,159,92,82,219,51
],[
2,2,196,247,152,58,57,56,49,150,231,39,195,7,97,147,46,250,45,126
],[
2,2,187,162,131,209,3,74,82,79,12,234,132,200,180,248,131,143,83,128
],[
252,46,156,119,227,87,196,77,183,30,231,193,7,102,167,249,53,153,22,210
],[
122,157,214,117,42,3,126,43,57,129,64,114,255,162,201,80,56,188,105,231
],[
79,35,116,74,220,156,232,143,107,20,79,37,127,146,231,104,214,107,1,115
],[
239,181,167,53,202,253,129,200,239,61,250,253,177,8,158,60,180,8,198,139
],[
173,170,120,236,105,24,137,236,17,104,4,121,172,18,208,244,229,168,140,135
],[
14,193,190,185,102,55,45,63,151,146,139,21,131,195,87,206,64,22,2,41
],[
97,98,81,228,120,130,2,213,217,9,178,54,160,50,254,65,245,22,233,253
],[
142,34,125,87,118,199,182,116,13,115,155,70,81,193,174,93,91,237,134,0
],[
44,138,187,125,170,119,2,189,230,15,153,27,160,160,230,118,13,30,91,133
],[
216,25,156,107,102,237,228,140,94,57,165,158,105,146,110,3,54,120,18,86
],[
194,136,7,68,214,244,12,157,209,49,14,170,167,239,77,194,42,78,187,24
],[
136,79,164,215,21,136,148,113,75,29,118,51,15,235,249,30,54,6,56,242
],[
72,102,153,139,132,221,245,112,36,76,250,170,226,23,206,210,186,214,245,110
],[
242,78,117,126,88,159,56,81,203,190,177,157,252,38,195,207,118,203,222,160
],[
220,80,107,233,114,121,106,184,223,227,89,163,50,243,88,92,34,12,140,134
],[
154,5,193,199,117,218,83,31,134,161,78,120,219,192,212,126,66,94,191,176
],[
13,23,136,183,19,244,104,247,247,154,188,101,173,193,174,152,57,232,18,34
]
]