aLevelData = [
[
6,2,2,2,2,2,2,2,2,2,2,235,244,40,78,137,1,142,184,187
],[
2,2,2,2,2,2,2,2,2,2,2,96,217,232,58,242,48,247,14,179
],[
2,2,2,2,2,2,2,2,2,2,2,115,215,175,75,125,138,107,224,166
],[
3,3,3,3,3,3,3,3,3,3,3,145,7,47,140,168,169,219,20,176
],[
2,2,2,2,2,2,2,2,2,2,2,246,4,171,237,119,28,210,113,65
],[
2,2,2,2,2,2,2,2,2,2,2,246,217,216,213,32,234,54,69,115
],[
2,2,2,2,2,3,2,2,3,2,2,74,78,152,232,220,5,112,174,231
],[
2,2,3,3,3,3,3,3,3,3,3,22,234,121,24,6,198,28,203,91
],[
2,2,2,2,2,2,2,2,2,2,2,200,90,134,9,93,249,198,45,130
],[
2,2,2,2,2,2,2,2,2,4,2,25,255,253,226,196,222,255,62,198
],[
3,3,3,3,3,3,3,3,3,3,3,209,122,18,191,201,43,118,118,63
],[
2,2,2,2,2,2,2,2,2,2,2,56,66,112,117,106,117,194,254,150
],[
2,2,2,2,2,2,2,2,2,2,2,216,35,128,92,222,69,185,20,207
],[
2,2,3,3,3,3,3,3,3,3,2,102,192,6,37,34,141,217,55,139
],[
2,2,3,2,2,2,2,2,2,2,2,188,79,20,123,142,47,178,41,49
],[
2,2,3,2,2,2,2,2,2,2,2,130,72,251,65,1,248,155,142,207
],[
2,2,3,3,3,3,3,2,2,2,2,177,77,32,100,84,128,120,201,21
],[
2,2,2,2,2,2,3,2,2,2,2,162,25,11,37,57,71,234,142,48
],[
15,209,94,110,135,11,7,174,87,51,6,138,120,236,195,216,60,211,184,58
],[
143,178,214,241,124,247,36,242,243,100,170,60,201,7,141,104,0,109,123,130
]
]