aLevelData = [
[
4,2,2,2,2,2,2,2,2,120,87,167,159,235,156,64,223,78,76,223
],[
5,2,5,3,2,2,2,2,2,50,7,72,181,148,117,131,183,182,212,88
],[
2,5,5,3,3,3,3,3,3,162,244,97,33,60,135,190,5,221,252,151
],[
3,3,5,5,5,5,5,5,5,17,47,228,134,138,50,206,52,130,131,114
],[
2,3,5,5,5,5,5,5,5,194,170,221,47,103,103,224,184,90,40,17
],[
3,3,5,5,5,5,3,3,3,10,242,246,35,161,11,77,117,235,173,42
],[
3,5,5,5,5,5,3,2,2,219,253,232,101,161,133,2,65,205,255,213
],[
3,5,5,3,3,3,3,8,2,66,165,44,114,62,113,192,10,183,130,91
],[
3,5,5,3,2,2,3,3,3,15,104,115,187,150,30,175,48,0,201,51
],[
3,5,5,3,2,2,2,2,2,80,217,211,150,235,0,176,70,66,8,183
],[
3,5,5,3,2,2,3,2,2,20,115,223,48,243,56,173,174,252,209,255
],[
5,5,5,3,2,2,3,2,2,159,182,63,37,33,149,179,216,23,192,70
],[
5,5,5,3,2,2,3,2,2,33,124,23,234,118,248,117,161,37,177,50
],[
5,3,3,3,2,2,3,2,2,237,246,100,237,135,11,180,136,83,12,194
],[
5,3,2,2,2,2,3,2,2,115,148,129,253,46,93,127,60,9,72,135
],[
5,3,3,2,2,2,3,2,5,10,47,105,171,64,226,133,242,218,8,128
],[
5,5,3,3,2,2,3,2,5,254,3,231,21,236,114,45,202,124,249,51
],[
5,5,5,5,3,3,3,2,5,34,114,91,130,20,60,95,151,188,212,34
],[
227,81,232,177,22,87,57,215,157,21,65,52,105,74,24,143,243,28,152,110
],[
125,81,192,227,154,193,86,168,240,11,208,110,61,136,117,115,152,125,192,83
]
]