aLevelData = [
[
4,116,210,87,219,75,120,39,103,240,236,225,54,202,203,61,112,110,35,166
],[
40,184,52,234,59,27,115,53,123,53,213,64,13,166,73,198,16,35,134,56
],[
127,198,8,177,89,168,85,44,255,178,133,245,221,176,1,93,76,167,139,178
],[
183,105,127,110,253,102,88,175,23,197,117,231,251,180,30,213,192,252,194,180
],[
2,216,130,178,136,7,244,163,36,32,32,247,219,38,207,233,70,92,6,250
],[
56,90,205,158,162,97,52,53,179,236,152,60,67,135,35,197,113,228,146,36
],[
139,44,59,236,47,147,78,26,176,47,91,143,187,10,20,196,59,118,85,185
],[
121,160,97,46,136,104,111,22,224,112,101,73,73,115,227,121,251,217,131,103
],[
3,136,95,86,232,252,212,192,143,154,134,73,92,65,164,241,154,35,110,141
],[
29,211,244,120,37,158,32,134,134,31,246,57,6,14,27,56,7,89,148,252
],[
102,118,209,205,162,247,234,237,65,95,40,19,111,52,199,26,233,85,250,251
],[
25,142,48,249,130,106,150,27,95,72,221,223,135,177,61,45,148,233,186,138
],[
68,196,166,142,32,187,103,152,91,63,122,192,252,78,184,13,64,67,216,233
],[
57,242,54,209,188,244,210,81,122,64,156,48,109,251,239,232,118,146,91,88
],[
68,5,167,189,119,134,22,223,5,66,234,136,221,127,39,58,203,231,153,33
],[
156,35,24,71,130,172,11,7,186,222,43,196,107,79,138,219,210,94,211,213
],[
156,15,211,226,147,22,56,131,125,49,153,134,65,187,183,55,76,127,3,213
],[
51,202,96,67,154,196,41,0,84,255,118,89,204,81,155,221,163,223,242,18
],[
154,123,219,102,179,48,0,104,147,26,222,56,43,123,129,60,151,12,142,21
],[
70,145,135,210,92,176,75,99,84,3,220,80,234,108,101,171,56,169,124,67
]
]