aLevelData = [
[
5,5,5,5,51,176,71,203,26,141,64,109,201,1,163,77,83,36,53,229
],[
5,2,2,2,218,227,64,47,255,165,158,104,158,47,19,20,185,196,224,66
],[
5,2,5,3,177,145,148,17,188,73,38,115,147,13,65,49,107,142,223,47
],[
2,2,5,2,39,117,25,242,204,3,61,95,53,244,34,197,8,170,184,30
],[
2,2,3,2,232,135,227,146,236,155,138,61,80,127,235,50,107,128,49,192
],[
2,2,3,2,225,0,72,244,26,26,240,94,243,133,16,24,179,187,77,5
],[
4,2,3,2,64,90,220,87,147,202,148,84,105,32,72,89,59,66,83,31
],[
2,2,3,2,113,76,116,61,211,51,221,238,64,169,134,21,162,64,199,126
],[
33,209,38,103,151,31,110,63,68,184,1,173,196,28,110,212,61,33,70,214
],[
221,150,44,150,132,39,44,195,189,128,78,18,243,182,106,202,226,226,61,134
],[
75,15,189,54,236,86,170,104,175,71,102,198,34,139,6,223,39,200,169,42
],[
237,197,8,71,30,207,79,137,90,91,44,178,229,236,37,253,156,55,46,98
],[
46,133,123,21,136,90,147,80,145,84,166,82,24,85,32,168,10,229,126,171
],[
233,209,96,74,121,24,224,9,189,8,35,74,33,165,45,203,249,74,250,113
],[
42,147,202,68,39,121,188,186,32,191,158,56,118,142,4,214,113,92,151,99
],[
53,18,176,169,242,109,38,241,92,164,100,202,91,76,190,7,3,121,5,7
],[
198,39,88,57,232,216,62,222,52,126,242,17,238,154,254,5,8,166,11,143
],[
152,177,248,228,138,73,41,163,146,157,34,22,101,227,84,181,41,248,54,235
],[
42,70,152,29,206,235,53,233,203,24,135,171,151,182,223,70,33,80,180,33
],[
190,45,59,111,102,188,57,180,32,54,22,132,187,126,50,142,191,76,124,218
]
]