aLevelData = [
[
2,2,2,2,2,2,2,2,2,2,2,2,2,2,2,2,2,2,203,211
],[
2,2,2,2,2,2,2,2,2,2,2,2,2,2,2,2,2,2,34,114
],[
2,2,2,2,2,2,2,2,2,2,2,2,2,2,2,2,2,4,117,132
],[
2,2,2,13,2,2,2,2,2,2,2,2,2,2,2,2,2,2,62,206
],[
2,2,2,2,2,2,2,2,2,2,2,2,2,2,2,2,2,2,151,193
],[
2,2,2,2,2,2,2,2,2,2,2,2,2,2,2,2,2,2,229,0
],[
2,2,2,2,2,2,2,2,2,2,2,2,2,2,2,2,2,2,202,9
],[
2,2,2,2,2,2,2,2,2,1,2,2,2,2,2,2,2,2,167,43
],[
2,2,11,2,2,2,2,2,2,2,2,2,2,2,2,2,2,2,56,51
],[
2,2,2,2,2,2,2,2,2,2,2,2,2,2,2,2,2,2,19,113
],[
2,2,2,2,2,2,2,2,2,2,2,2,2,2,2,2,2,2,11,11
],[
2,2,2,2,2,2,2,2,2,2,2,2,2,2,2,2,2,2,204,182
],[
2,2,2,2,2,2,2,2,2,2,2,2,2,2,2,2,2,10,38,64
],[
2,2,2,2,2,2,2,2,2,2,2,2,2,2,2,2,2,2,224,166
],[
2,9,2,2,2,2,2,2,2,2,2,2,2,2,2,2,2,2,19,126
],[
2,2,2,2,2,2,2,2,2,2,2,2,2,2,2,12,2,2,86,249
],[
61,215,6,245,96,103,174,53,61,56,65,170,146,99,130,223,73,120,210,129
],[
240,32,70,30,105,1,253,45,227,226,177,79,9,16,139,212,120,0,60,129
],[
119,53,73,144,226,100,166,249,104,215,135,240,247,15,115,175,115,173,154,117
],[
174,147,104,207,149,70,90,22,167,150,17,57,172,130,165,188,163,86,59,1
]
]