aLevelData = [
[
2,2,2,2,5,5,2,2,2,2,2,13,164,215,9,7,125,58,89,231
],[
178,96,214,221,190,169,242,234,181,171,119,253,214,120,190,93,96,35,33,70
],[
168,128,178,215,103,44,46,44,88,205,44,199,3,155,154,52,211,32,106,236
],[
111,59,137,123,71,107,17,222,109,74,191,47,167,88,167,132,194,250,38,20
],[
41,195,25,155,182,241,76,0,199,59,54,53,149,202,227,96,193,133,49,56
],[
48,145,63,177,25,24,35,219,92,74,219,7,22,162,134,45,114,107,213,138
],[
194,130,188,141,206,93,109,244,107,76,134,51,80,255,137,21,38,73,142,165
],[
222,35,52,79,71,244,221,67,224,16,27,26,235,126,101,188,194,254,15,129
],[
110,74,121,150,118,157,134,163,245,114,79,170,239,142,25,51,229,64,133,166
],[
167,232,7,248,106,182,153,137,26,180,177,77,242,7,112,43,73,114,28,162
],[
175,27,208,178,56,146,114,250,24,15,230,30,112,251,129,107,104,178,193,190
],[
126,136,59,161,30,10,212,184,114,134,52,92,123,205,120,133,97,55,39,237
],[
7,232,104,114,227,82,114,188,13,251,67,33,149,128,149,197,26,219,14,6
],[
152,225,183,23,130,14,175,234,17,133,33,84,219,83,115,108,167,244,192,52
],[
128,24,137,123,8,167,167,1,15,2,132,221,100,140,139,28,235,105,221,171
],[
240,133,70,119,187,216,111,210,101,233,85,25,234,145,249,147,126,2,90,157
],[
37,7,160,4,126,142,154,179,223,99,106,142,167,62,127,157,208,0,196,109
],[
196,58,23,179,114,239,253,51,160,155,148,224,131,115,201,69,141,239,202,35
],[
134,134,191,92,222,184,181,15,66,82,218,5,109,238,240,76,65,185,252,33
],[
22,121,62,20,82,206,102,102,57,183,5,182,7,89,66,220,60,252,206,22
]
]