aLevelData = [
[
5,5,3,5,5,5,5,5,5,5,3,5,5,5,71,205,196,53,17,99
],[
4,2,3,5,5,5,5,5,5,5,3,5,5,5,111,49,106,178,180,15
],[
2,2,3,2,3,3,3,3,3,2,3,3,3,3,9,104,25,143,192,222
],[
33,117,82,157,195,47,134,34,27,183,121,222,96,187,56,129,22,252,142,120
],[
132,244,27,180,105,187,166,174,235,43,181,168,208,67,90,53,240,201,79,251
],[
234,51,69,184,23,200,122,131,188,3,138,85,132,56,135,199,45,121,75,29
],[
129,187,13,132,136,53,51,152,252,9,103,41,253,38,237,63,6,109,52,91
],[
32,19,171,0,85,70,213,114,104,19,160,190,195,135,243,250,177,20,134,206
],[
205,55,246,52,187,88,25,123,21,242,143,146,168,243,153,131,225,102,46,62
],[
130,79,76,152,153,214,141,147,179,168,250,224,77,155,35,162,139,145,112,117
],[
45,158,178,175,190,109,253,230,14,223,186,178,227,246,248,179,236,242,3,214
],[
246,185,56,213,98,124,23,253,215,152,154,52,52,186,197,58,201,71,127,47
],[
198,251,160,86,243,208,75,24,162,33,126,76,227,15,231,181,246,36,250,204
],[
6,54,64,192,20,142,242,188,49,74,198,104,240,0,9,178,27,164,238,206
],[
165,172,38,123,224,113,176,137,240,217,243,152,128,51,10,34,179,98,95,188
],[
93,62,123,152,116,55,28,79,193,60,136,221,219,219,34,237,86,169,59,88
],[
56,228,42,232,172,87,159,97,251,126,52,194,183,235,69,200,58,232,2,180
],[
79,94,194,78,46,245,155,42,174,125,47,42,182,141,200,68,244,105,168,133
],[
210,41,154,86,166,24,205,255,41,91,226,105,43,211,68,40,133,68,184,184
],[
78,182,53,7,82,27,245,52,191,51,204,151,34,173,185,1,146,143,187,69
]
]