aLevelData = [
[
10,2,2,8,233,223,174,24,132,184,105,91,159,248,50,167,15,244,156,143
],[
2,2,2,2,35,139,152,144,124,173,236,173,31,26,225,86,201,108,60,142
],[
2,2,2,2,131,88,112,77,117,49,18,35,255,173,141,31,6,236,23,239
],[
9,2,2,2,140,182,228,72,132,5,153,137,228,195,3,155,251,212,9,27
],[
3,3,3,3,5,87,223,187,253,41,125,229,178,171,80,162,29,198,47,187
],[
2,2,2,2,242,44,144,30,117,224,252,130,143,248,192,78,33,162,230,183
],[
2,2,2,2,152,101,99,41,194,169,146,233,224,122,225,248,252,137,203,58
],[
2,2,2,2,124,115,6,215,248,70,253,226,73,66,128,57,226,220,186,172
],[
2,2,2,2,100,9,100,97,108,184,57,118,175,160,170,233,74,61,210,181
],[
2,2,2,2,83,21,172,62,180,64,132,239,57,39,171,34,231,140,111,64
],[
2,2,2,2,144,203,74,41,164,95,90,214,74,167,17,61,175,234,46,116
],[
2,2,2,2,158,154,236,26,82,213,121,243,136,49,169,210,216,185,236,188
],[
2,2,2,2,68,51,126,74,18,165,221,79,215,23,128,187,213,153,198,191
],[
2,2,2,2,134,136,45,50,121,14,196,52,93,232,227,17,92,108,25,104
],[
170,202,102,140,93,146,170,42,127,118,94,44,97,82,130,222,51,105,214,79
],[
210,241,77,251,225,211,191,166,27,172,222,139,231,23,107,182,45,46,170,175
],[
105,78,19,88,254,27,74,24,204,196,81,57,4,137,253,143,59,122,166,91
],[
190,129,35,110,38,162,245,146,44,130,195,37,190,38,7,7,82,254,6,183
],[
122,34,5,184,184,219,186,58,148,101,1,246,237,243,208,90,141,244,109,230
],[
0,149,222,214,165,135,162,1,5,2,158,1,100,10,90,148,150,241,109,66
]
]