aLevelData = [
[
5,5,3,5,5,5,5,5,5,5,3,5,5,5,5,5,5,5,5,100
],[
4,2,3,5,5,5,5,5,5,5,3,5,5,5,5,5,5,5,5,178
],[
2,2,3,2,3,3,3,3,3,2,3,3,3,3,3,5,5,3,5,43
],[
5,2,2,2,3,2,2,2,2,2,5,5,5,5,5,5,5,3,5,134
],[
2,2,2,3,2,2,2,2,2,2,5,5,5,5,5,5,5,3,5,80
],[
2,2,2,3,2,2,5,3,3,2,3,3,3,3,3,5,5,3,5,211
],[
2,2,2,2,2,2,5,5,3,2,2,2,2,2,2,2,2,3,5,91
],[
5,2,2,2,2,2,5,5,3,2,2,2,2,2,2,2,2,3,5,124
],[
2,2,5,5,3,2,5,5,3,2,3,3,3,5,5,3,5,3,5,26
],[
2,2,5,5,3,2,5,5,3,6,3,3,5,5,5,3,5,3,5,178
],[
2,2,3,3,3,2,5,5,3,5,5,3,5,5,5,3,5,3,5,70
],[
2,2,3,2,2,2,5,5,3,5,5,5,3,5,5,3,5,3,5,100
],[
2,2,3,2,2,2,5,5,3,5,5,5,3,3,5,3,5,3,5,171
],[
101,57,163,228,25,62,111,50,88,74,52,98,135,184,54,183,179,246,121,58
],[
141,127,222,82,178,9,142,148,48,255,155,220,70,49,229,157,108,203,59,117
],[
147,131,195,5,174,23,156,255,113,247,193,128,89,62,49,161,236,231,77,73
],[
66,62,129,69,196,148,38,154,52,55,167,25,238,162,227,53,109,240,211,18
],[
16,151,109,222,30,82,200,100,9,95,128,222,239,235,92,11,102,203,46,130
],[
121,108,251,70,238,13,92,154,203,43,36,23,24,61,67,251,229,162,235,196
],[
143,216,241,254,64,238,117,89,181,60,197,254,68,81,127,35,29,45,246,221
]
]