aLevelData = [
[
2,2,2,2,5,5,2,2,2,2,2,2,2,2,19,17,219,223,158,45
],[
142,239,48,113,18,179,54,165,223,78,152,36,180,26,153,51,147,155,255,145
],[
12,177,115,80,191,17,42,226,29,245,197,119,110,19,118,135,24,204,101,170
],[
30,167,82,176,231,253,123,238,65,246,192,214,165,180,5,203,189,205,216,51
],[
35,255,83,205,108,31,68,68,101,83,140,5,156,129,197,78,34,7,40,136
],[
144,173,173,215,72,215,115,239,253,0,99,41,118,99,17,214,142,251,226,211
],[
128,174,116,94,97,198,58,39,238,160,103,170,136,168,14,189,125,133,135,101
],[
137,144,20,238,157,139,196,59,222,144,152,90,241,71,229,91,118,92,249,99
],[
210,48,1,252,50,207,43,175,205,35,7,213,105,103,51,170,32,221,55,163
],[
100,196,174,2,65,133,167,167,226,45,74,41,87,31,191,37,149,11,75,214
],[
190,26,188,230,163,107,8,132,136,195,49,183,39,128,107,242,247,207,129,232
],[
173,31,117,161,3,214,103,206,185,66,183,90,218,210,110,65,65,134,218,165
],[
91,164,121,31,47,173,25,83,155,143,60,199,224,28,193,245,97,187,193,158
],[
167,93,184,98,169,179,229,142,74,159,243,53,36,232,216,130,132,49,254,76
],[
181,44,160,235,130,11,120,74,246,55,151,62,102,69,148,22,178,38,232,116
],[
199,157,153,91,104,246,22,136,47,246,98,6,206,14,117,253,155,211,224,203
],[
76,179,175,85,254,224,147,159,125,145,65,155,191,106,21,63,177,56,251,218
],[
55,226,143,168,109,157,131,164,52,94,65,157,234,149,210,140,120,24,255,37
],[
146,93,182,172,58,237,175,10,134,21,78,32,164,223,204,91,27,65,146,137
],[
83,147,229,235,88,70,200,139,219,212,30,207,122,243,16,79,65,14,174,228
]
]