aLevelData = [
[
10,2,2,55,177,30,180,11,173,5,184,28,99,105,59,199,13,172,232,150
],[
2,2,2,91,209,140,182,22,140,214,171,5,155,91,66,13,89,220,199,155
],[
145,204,121,71,144,13,59,177,126,251,140,175,238,171,185,171,179,116,81,70
],[
245,175,218,65,133,188,194,158,110,70,153,2,205,199,125,94,226,78,213,206
],[
102,128,66,194,31,220,210,91,179,68,119,24,186,185,184,177,22,103,167,67
],[
135,225,19,174,122,173,254,59,34,3,81,131,202,210,207,140,106,4,72,52
],[
120,3,15,211,0,124,174,28,247,99,215,68,205,55,158,103,65,135,230,39
],[
121,181,25,150,82,250,29,86,245,170,131,254,171,185,1,192,242,127,34,73
],[
208,184,60,233,103,207,163,244,202,92,28,104,15,235,148,207,165,255,18,103
],[
232,86,235,129,243,111,53,39,181,74,125,1,72,111,189,122,125,49,136,30
],[
188,52,136,70,11,45,42,248,108,233,152,9,108,145,232,132,249,44,146,80
],[
116,101,40,12,7,142,65,62,57,230,183,173,191,23,18,11,149,3,67,215
],[
78,192,150,130,169,225,226,209,100,248,2,130,85,89,137,50,182,32,178,126
],[
193,117,150,105,125,14,162,253,215,246,71,54,244,141,243,27,198,209,65,46
],[
221,219,109,6,128,172,10,59,253,42,247,130,61,102,143,25,155,32,32,102
],[
246,141,158,219,5,88,153,28,235,230,109,100,12,222,185,37,30,233,18,238
],[
131,182,248,146,214,66,8,135,196,86,116,140,29,81,177,142,42,39,111,205
],[
66,170,206,59,152,8,207,36,87,149,8,20,241,203,157,246,179,143,107,121
],[
158,182,134,184,114,200,230,25,11,4,93,117,240,164,204,122,42,98,151,78
],[
82,58,86,117,238,114,206,245,254,216,31,184,209,75,62,49,29,124,166,67
]
]