aLevelData = [
[
6,2,8,2,9,2,221,251,225,163,111,137,176,8,8,163,235,248,153,12
],[
2,2,2,2,2,2,157,92,53,25,18,104,22,173,244,40,225,103,180,92
],[
2,2,3,3,3,3,42,26,43,134,59,126,130,65,17,37,79,212,168,176
],[
0,7,121,66,125,54,64,53,9,163,2,12,105,16,79,169,73,142,197,193
],[
219,144,213,140,193,67,202,193,45,34,6,193,71,197,143,18,207,249,203,16
],[
3,22,136,223,195,141,63,164,243,193,154,245,33,24,51,142,103,81,159,69
],[
147,24,171,64,134,215,229,101,218,208,95,18,200,105,175,14,72,198,58,192
],[
121,157,179,159,68,70,222,234,60,18,154,153,201,222,30,147,134,232,131,33
],[
231,225,131,163,31,67,128,130,65,228,199,101,165,204,23,168,141,67,93,10
],[
8,47,194,165,23,157,231,36,15,158,111,48,62,84,191,43,209,76,1,33
],[
245,14,111,251,61,243,206,246,68,55,56,84,147,79,31,82,197,125,143,89
],[
233,161,179,120,39,82,155,18,167,45,60,212,174,109,185,234,10,189,225,115
],[
177,74,248,50,165,27,186,134,26,165,157,156,219,154,87,227,234,3,160,192
],[
102,142,57,132,178,41,45,155,212,207,87,5,27,162,36,11,5,59,154,42
],[
95,62,153,84,174,49,97,88,206,142,85,158,217,22,255,23,75,105,83,116
],[
99,212,56,150,204,106,68,70,124,86,199,39,221,111,12,232,42,13,219,190
],[
28,27,66,18,199,110,150,119,190,85,180,222,126,114,140,13,10,200,225,77
],[
210,20,74,99,217,97,125,194,23,215,204,255,29,212,240,133,247,62,6,138
],[
86,23,215,66,239,81,92,82,30,228,130,135,207,31,42,200,158,59,116,73
],[
61,54,61,2,22,223,230,96,50,45,87,58,90,212,68,6,124,26,175,77
]
]