aLevelData = [
[
2,139,90,150,214,106,36,66,245,233,88,214,237,39,103,140,94,88,135,86
],[
2,196,24,179,208,156,254,243,115,201,117,221,12,53,199,92,109,187,123,176
],[
2,99,69,225,182,232,49,235,106,153,250,62,170,106,20,137,61,152,23,22
],[
2,19,223,32,159,206,238,116,98,130,24,103,119,185,76,125,98,187,71,206
],[
2,229,12,8,175,24,53,132,142,187,199,156,30,202,158,76,181,82,99,37
],[
2,242,132,84,253,162,7,72,229,228,147,237,91,140,188,85,193,198,11,177
],[
2,14,252,83,92,196,249,66,27,34,78,55,163,154,244,83,91,133,52,211
],[
2,100,22,196,157,215,140,51,24,77,172,134,65,165,111,36,252,1,248,239
],[
2,167,18,200,180,245,150,53,197,250,30,24,228,130,21,199,99,167,254,67
],[
2,138,163,253,178,57,226,153,15,206,92,192,32,73,33,11,168,175,53,68
],[
223,172,159,38,31,123,189,99,224,11,218,236,230,90,2,108,185,37,21,21
],[
86,196,27,160,36,80,215,143,41,6,159,182,126,240,107,249,0,194,43,87
],[
73,2,94,40,223,107,224,162,170,148,3,162,172,205,226,170,236,73,242,37
],[
179,131,218,243,251,218,133,33,37,126,117,248,234,144,90,58,148,133,227,168
],[
110,204,212,199,121,176,89,228,96,127,153,86,174,236,143,3,63,178,21,38
],[
244,122,66,79,171,255,246,171,111,112,179,133,235,22,175,13,37,54,39,88
],[
105,57,245,169,130,10,101,239,49,192,69,142,215,125,59,98,117,149,92,1
],[
214,243,249,65,11,185,188,251,24,39,244,14,237,190,46,166,152,165,5,190
],[
184,75,59,227,53,78,8,59,46,156,177,199,51,216,93,229,181,255,37,25
],[
186,75,106,12,213,87,107,213,86,133,22,120,190,157,31,172,118,182,80,226
]
]