aLevelData = [
[
2,2,2,2,2,2,118,101,131,147,151,162,47,178,24,195,28,56,221,176
],[
2,2,13,5,5,2,231,97,3,157,66,40,104,130,151,92,109,203,239,246
],[
2,2,2,5,5,2,250,81,19,170,195,138,240,188,202,252,64,21,37,248
],[
2,2,2,2,2,2,103,150,2,132,155,172,232,153,72,37,64,143,179,66
],[
2,2,2,2,2,2,19,213,221,13,21,229,170,236,227,119,66,119,137,245
],[
2,2,2,2,2,2,184,135,71,48,234,143,149,81,168,48,100,18,24,7
],[
167,46,88,202,18,21,102,147,33,229,61,123,93,150,65,107,219,116,221,47
],[
5,211,107,204,156,254,84,20,254,112,120,119,165,71,208,28,241,245,81,49
],[
39,57,20,127,185,78,181,65,200,98,249,54,231,73,179,245,34,115,232,129
],[
63,27,49,29,67,194,97,97,56,220,104,142,46,201,119,31,128,6,101,160
],[
88,165,82,195,117,250,138,177,44,152,171,158,173,124,11,160,136,135,84,193
],[
112,50,113,83,62,125,174,131,57,40,26,49,148,38,48,255,56,79,183,168
],[
196,85,231,148,210,249,205,169,125,126,241,99,32,94,53,39,95,61,0,212
],[
108,27,156,156,131,205,221,18,183,174,4,131,241,146,226,138,54,251,65,223
],[
40,144,127,112,208,202,124,179,154,241,183,58,161,71,179,136,45,131,160,35
],[
122,128,55,234,188,55,230,169,95,235,45,235,147,163,72,15,8,221,14,158
],[
246,129,25,220,97,20,39,157,155,46,192,90,10,46,25,132,43,44,57,24
],[
215,47,90,116,198,160,146,105,81,255,178,145,124,213,111,227,51,234,191,132
],[
212,183,134,224,238,30,114,250,73,89,35,0,38,49,144,35,199,112,166,166
],[
50,152,50,52,51,213,0,118,160,49,68,229,224,7,58,221,174,186,10,243
]
]