aLevelData = [
[
2,2,2,2,2,2,2,2,2,2,2,2,2,2,2,2,2,2,2,235
],[
2,2,13,5,5,2,2,12,5,5,2,3,2,5,5,2,2,2,2,116
],[
2,2,2,5,5,2,2,2,5,5,2,3,2,5,5,2,2,2,2,15
],[
2,2,2,2,2,2,2,2,2,2,2,3,2,2,2,2,2,2,2,201
],[
2,2,2,2,2,2,2,2,2,2,2,3,3,3,3,3,3,3,3,105
],[
2,2,2,2,2,2,2,2,2,2,2,2,2,2,6,2,2,2,2,209
],[
2,2,2,2,2,2,2,2,2,2,2,2,2,3,3,3,2,3,3,177
],[
2,2,2,2,2,2,2,2,2,2,2,2,2,2,2,2,2,2,2,252
],[
2,2,2,2,2,2,2,2,2,2,3,2,2,2,2,2,2,2,2,198
],[
2,2,2,2,2,2,2,2,2,3,3,2,3,2,2,2,2,2,3,23
],[
6,194,98,180,25,13,59,67,104,110,106,255,142,42,241,126,31,143,179,156
],[
212,136,196,181,232,112,227,23,193,36,69,182,211,92,149,34,194,59,56,183
],[
198,36,213,19,84,208,21,206,251,157,167,101,140,41,136,118,125,32,129,51
],[
143,82,241,17,175,9,204,192,26,153,228,96,197,56,103,242,252,16,169,12
],[
73,147,36,209,151,15,190,33,151,130,74,13,99,175,80,142,98,113,17,118
],[
107,80,198,166,45,82,41,130,206,19,54,162,210,24,51,202,63,97,238,29
],[
254,61,70,141,133,99,236,150,179,61,107,44,251,135,102,242,197,25,33,172
],[
17,1,68,247,94,213,219,56,202,72,160,210,122,250,125,156,60,149,77,146
],[
107,21,227,202,20,103,77,170,86,54,89,89,15,2,89,115,181,114,36,1
],[
129,235,93,168,211,97,248,32,210,109,249,232,82,160,127,56,252,24,2,56
]
]