aLevelData = [
[
2,2,2,2,2,2,2,215,142,248,251,90,122,23,55,34,239,145,129,92
],[
2,2,13,5,5,2,2,54,24,18,110,240,91,53,136,91,50,169,123,209
],[
2,2,2,5,5,2,2,28,71,207,145,236,228,15,194,191,121,104,181,49
],[
2,2,2,2,2,2,2,130,115,107,209,163,78,87,210,145,241,100,3,48
],[
2,2,2,2,2,2,2,191,58,1,249,92,189,170,159,191,215,214,242,136
],[
120,66,3,147,219,205,137,205,10,231,131,70,164,70,31,136,222,218,219,40
],[
200,4,234,154,210,3,217,73,142,175,114,231,183,105,225,2,115,82,21,217
],[
213,187,105,109,166,221,132,219,101,202,125,232,140,164,67,222,21,13,61,151
],[
61,222,45,215,136,28,90,223,5,40,238,62,211,53,157,235,228,255,135,145
],[
1,187,96,42,14,73,206,207,144,177,18,206,108,205,235,254,241,67,183,79
],[
25,183,220,165,12,62,102,231,230,21,242,82,186,147,202,20,215,92,81,22
],[
74,216,162,25,164,227,116,4,253,198,65,124,56,102,167,182,137,188,14,137
],[
53,133,139,200,153,59,4,206,110,67,149,90,75,104,51,158,107,136,143,146
],[
177,141,61,142,233,159,22,24,81,153,219,251,88,185,27,153,165,155,86,129
],[
91,104,98,68,156,75,14,133,76,36,6,80,23,129,246,173,181,202,242,116
],[
108,187,22,98,215,23,105,109,231,155,7,85,39,49,128,124,68,103,123,247
],[
204,31,159,229,54,136,179,255,35,77,3,113,227,12,6,233,59,9,63,237
],[
101,36,97,113,89,8,182,169,75,166,193,28,117,226,35,250,22,139,187,175
],[
187,145,17,184,189,114,245,181,11,246,99,192,41,28,170,254,121,84,205,115
],[
186,238,42,27,206,211,89,54,192,115,87,227,5,254,228,240,2,215,41,241
]
]