aLevelData = [
[
2,2,2,2,5,5,2,2,81,150,120,177,149,170,219,235,0,98,7,172
],[
2,2,2,4,2,2,2,2,50,175,184,12,242,10,23,229,198,181,233,54
],[
5,3,3,3,5,5,3,3,192,67,7,197,154,90,14,9,6,184,87,70
],[
2,3,2,2,2,2,2,2,63,116,42,250,228,134,46,120,6,138,36,211
],[
2,3,2,2,2,2,2,2,128,193,213,253,134,89,73,48,129,238,58,141
],[
2,3,2,2,3,2,2,2,26,80,200,4,149,135,111,115,97,20,53,18
],[
237,122,40,14,189,253,7,116,188,170,64,81,212,151,26,24,188,108,52,67
],[
17,34,46,61,169,11,166,128,36,19,102,250,195,69,219,182,126,145,202,184
],[
80,204,62,41,214,248,197,180,24,198,219,47,167,89,167,126,232,77,229,180
],[
175,248,36,124,15,239,49,184,113,204,211,103,228,47,184,204,180,3,176,205
],[
62,3,25,153,2,124,154,141,250,84,21,89,43,75,214,94,121,129,17,91
],[
191,57,139,73,31,220,151,131,151,65,68,42,213,43,213,200,77,19,113,51
],[
136,40,28,181,191,149,230,105,168,2,98,232,144,93,90,37,170,218,193,150
],[
167,56,233,149,134,71,247,5,174,167,147,56,58,210,228,16,148,92,187,101
],[
69,122,14,167,11,194,169,197,44,49,32,77,11,114,8,212,249,93,102,152
],[
77,191,104,100,183,89,83,180,209,43,189,26,247,242,252,224,89,239,222,239
],[
78,234,155,239,236,119,7,176,213,120,12,201,83,227,88,127,168,197,83,232
],[
159,135,84,80,103,112,20,219,161,108,99,108,184,12,25,198,113,205,80,241
],[
195,157,208,224,232,155,203,80,180,31,203,243,38,250,232,206,61,255,62,223
],[
12,194,158,4,17,159,132,24,195,254,73,95,106,214,154,36,51,112,41,160
]
]