aLevelData = [
[
2,2,2,2,2,220,233,136,203,81,196,135,86,85,3,44,137,154,224,209
],[
2,2,2,2,2,37,102,214,23,21,141,193,125,174,157,65,50,53,88,95
],[
2,2,2,2,2,40,161,103,115,106,163,76,69,175,228,153,114,47,142,95
],[
2,2,2,13,2,17,181,13,234,151,246,23,171,248,33,233,118,15,183,212
],[
2,2,2,2,2,238,64,157,249,61,92,112,81,8,196,24,240,161,210,160
],[
2,2,2,2,2,138,127,116,68,54,236,26,204,114,254,211,25,103,200,178
],[
2,2,2,2,2,254,111,209,119,81,213,198,107,65,220,107,140,233,2,215
],[
2,2,2,2,2,234,38,133,225,81,166,39,214,40,66,46,109,153,142,176
],[
252,243,174,13,235,76,107,189,105,106,134,76,95,228,75,162,162,132,106,136
],[
109,240,3,104,14,137,0,84,223,148,167,74,120,152,111,183,35,6,19,57
],[
145,31,230,169,203,19,102,89,106,102,19,154,11,152,130,130,254,5,173,236
],[
62,10,141,191,166,105,235,116,97,239,115,210,163,84,10,252,150,98,97,174
],[
152,89,202,196,163,147,75,252,12,100,241,252,113,68,103,151,237,48,199,76
],[
141,77,176,15,8,207,153,77,170,25,101,42,146,37,55,13,29,39,135,94
],[
162,109,118,142,96,138,94,88,180,179,174,71,144,105,245,121,40,89,60,162
],[
238,128,153,83,193,146,1,125,97,157,94,49,39,233,225,169,243,36,154,140
],[
101,187,70,110,80,139,104,150,107,185,155,5,74,222,38,180,141,104,209,28
],[
88,61,247,251,3,161,221,86,18,89,66,186,103,16,55,200,182,251,49,241
],[
58,185,93,125,166,125,51,210,95,110,78,243,232,78,123,71,157,90,16,156
],[
165,114,127,107,34,122,42,93,170,0,121,15,251,31,42,18,234,163,233,55
]
]