aLevelData = [
[
2,2,2,2,2,2,2,2,2,6,5,2,2,4,103,117,215,128,205,252
],[
2,3,5,3,5,5,5,3,5,3,5,2,5,91,234,236,198,194,163,51
],[
2,3,2,3,2,2,2,3,5,3,5,2,5,222,254,168,58,194,159,21
],[
2,2,2,2,2,2,2,2,2,2,2,2,5,64,13,236,232,215,83,51
],[
2,3,5,3,5,5,5,3,2,3,5,5,5,8,222,77,93,134,176,54
],[
2,3,5,3,5,5,5,3,2,3,5,5,5,197,34,155,116,75,17,148
],[
2,5,5,5,5,5,5,5,5,5,5,5,5,123,164,253,40,239,244,78
],[
2,3,5,3,5,5,5,3,5,3,5,5,5,182,8,158,168,220,59,90
],[
2,3,5,3,5,5,5,3,5,3,5,5,5,180,47,23,137,36,47,109
],[
2,5,5,5,5,5,5,5,5,5,5,5,5,198,241,122,179,190,231,63
],[
2,3,5,3,2,2,2,3,2,3,2,2,2,170,65,100,246,63,153,93
],[
5,3,5,3,2,2,2,3,2,3,2,2,2,78,175,26,161,103,239,250
],[
5,5,5,5,5,5,5,5,5,5,5,5,5,98,66,75,99,241,118,77
],[
5,3,5,3,5,5,5,3,5,3,5,5,2,199,201,36,224,116,207,44
],[
5,3,5,3,5,5,5,3,5,3,5,5,2,181,104,216,161,230,102,108
],[
1,5,5,5,5,5,5,5,5,5,5,5,5,123,218,73,202,140,104,153
],[
5,3,2,3,2,2,2,3,2,3,2,2,2,43,182,63,92,75,90,133
],[
2,3,2,3,2,2,2,3,2,3,2,2,2,46,38,19,190,148,255,165
],[
240,142,167,48,4,107,252,170,112,225,176,139,19,93,76,202,96,152,116,9
],[
191,107,108,13,48,228,219,112,50,153,207,154,227,60,2,237,104,112,92,64
]
]