aLevelData = [
[
6,2,8,2,9,2,10,2,11,3,2,2,5,2,2,2,5,2,2,4
],[
2,2,2,2,2,2,2,2,12,3,5,2,2,2,5,2,2,2,5,2
],[
2,2,3,3,3,3,3,3,3,3,2,2,3,3,3,3,3,3,2,2
],[
2,2,3,2,2,2,2,2,2,2,5,2,3,2,2,2,2,3,2,2
],[
2,2,3,2,2,2,2,2,2,2,2,2,3,2,2,2,2,3,2,2
],[
2,2,3,2,3,3,3,3,3,3,2,5,3,2,2,2,2,2,2,2
],[
2,2,3,2,2,2,2,5,5,3,2,2,3,2,2,2,2,2,2,2
],[
2,2,3,5,5,5,2,3,3,3,5,2,3,3,3,2,2,3,3,3
],[
2,2,2,2,2,2,2,2,2,2,2,2,5,2,2,2,2,5,2,2
],[
2,3,2,2,3,1,3,2,2,2,2,2,5,2,2,2,2,5,2,2
],[
2,3,2,2,3,2,3,2,2,2,2,5,5,2,2,2,2,5,2,2
],[
2,3,2,3,2,2,2,3,2,2,2,2,5,2,2,2,2,5,2,2
],[
2,3,2,3,2,2,2,3,3,3,2,2,3,3,3,2,2,3,3,3
],[
2,3,2,3,2,2,2,3,2,2,5,2,5,2,2,2,2,5,2,2
],[
2,3,2,3,2,2,3,3,2,2,2,2,5,2,2,2,2,5,2,2
],[
206,114,172,121,210,244,185,222,72,237,7,142,167,191,252,170,159,50,211,209
],[
101,116,147,65,75,95,61,63,147,251,74,186,133,68,84,43,191,45,20,191
],[
205,228,140,184,249,88,133,16,100,249,60,96,86,190,89,1,211,109,32,113
],[
111,23,235,248,99,225,216,139,223,11,191,240,162,42,103,35,201,184,249,249
],[
228,207,180,3,79,50,227,181,192,141,12,199,28,254,107,220,143,211,158,98
]
]