aLevelData = [
[
2,2,3,3,51,123,75,80,145,207,66,209,30,57,21,103,113,64,63,113
],[
2,2,2,2,254,219,231,73,69,217,180,201,73,128,228,14,68,117,152,123
],[
3,2,3,3,153,220,114,1,10,191,98,158,43,180,189,36,22,186,144,60
],[
2,2,2,2,97,101,51,170,77,59,33,211,64,93,6,124,118,106,26,212
],[
3,2,3,3,243,160,174,181,188,68,4,39,70,68,100,38,47,28,108,165
],[
2,2,3,2,44,246,168,210,67,21,99,156,58,115,188,114,79,169,252,78
],[
3,2,3,2,41,16,38,243,15,38,208,115,88,51,50,243,34,44,125,178
],[
2,2,3,2,71,215,110,72,141,48,34,44,29,12,44,121,55,252,229,242
],[
2,3,3,2,35,116,3,67,107,44,109,138,71,199,78,21,89,179,104,109
],[
2,2,2,2,154,80,172,148,149,84,7,140,211,110,126,24,150,41,125,199
],[
3,3,3,3,202,20,108,45,56,32,132,116,253,73,225,20,58,120,216,222
],[
8,2,6,3,14,168,138,63,193,72,185,195,66,225,219,216,212,249,109,213
],[
2,2,2,3,4,55,138,58,222,200,188,57,96,0,18,118,47,69,115,12
],[
2,2,2,2,137,41,49,208,123,214,225,217,84,175,107,64,89,52,93,36
],[
186,38,133,241,197,236,190,226,90,54,10,197,159,224,225,255,244,25,201,207
],[
42,196,39,215,239,30,85,216,141,162,244,189,213,42,132,219,85,86,50,119
],[
210,49,240,136,242,18,203,191,56,193,121,197,53,219,50,196,253,120,194,40
],[
217,10,219,167,59,137,175,126,247,205,190,254,175,59,237,72,143,163,217,85
],[
59,105,106,57,6,227,171,168,101,3,217,185,163,54,186,234,214,139,47,100
],[
17,24,13,129,219,154,41,140,224,91,178,200,231,89,196,179,4,164,57,139
]
]