aLevelData = [
[
5,5,5,5,5,2,2,15,134,27,161,176,78,2,111,251,140,38,163,189
],[
5,2,2,2,2,2,2,110,82,237,183,57,2,231,233,131,200,237,16,162
],[
5,2,5,3,3,3,3,238,47,109,100,93,4,200,1,189,130,181,77,222
],[
2,2,5,2,3,2,2,75,22,50,87,169,225,94,109,222,35,57,54,181
],[
2,2,3,2,3,2,2,69,26,254,93,142,186,233,119,234,233,218,110,234
],[
2,2,3,2,3,3,3,127,148,7,11,150,31,57,59,246,110,62,153,209
],[
4,2,3,2,2,2,2,62,234,125,177,65,60,184,174,124,51,29,228,237
],[
2,2,3,2,2,3,3,226,64,36,114,199,125,234,230,89,60,143,141,224
],[
2,2,2,2,2,3,2,116,192,178,137,110,47,142,186,204,136,108,163,201
],[
2,3,2,2,2,3,2,167,11,22,194,8,68,152,246,127,236,184,138,41
],[
2,3,2,2,2,3,2,252,159,208,162,239,233,200,120,108,179,231,224,37
],[
2,3,2,3,3,2,2,245,24,168,255,19,1,109,115,174,135,14,52,192
],[
2,3,2,3,6,2,2,148,96,18,232,23,36,30,2,77,54,15,251,64
],[
2,3,2,3,8,2,2,7,228,227,141,76,203,68,105,248,66,179,230,104
],[
2,3,2,3,9,2,3,124,164,115,222,6,131,162,49,170,0,47,195,148
],[
170,61,178,179,191,226,83,98,66,230,220,72,79,200,96,124,172,2,1,237
],[
160,142,97,2,8,169,89,125,167,215,238,165,190,39,128,164,220,184,69,46
],[
248,124,246,99,189,60,200,247,37,221,158,144,73,225,125,111,120,49,64,83
],[
134,25,141,154,102,148,7,170,251,202,197,143,44,215,4,229,55,206,24,249
],[
71,253,169,43,72,115,27,151,250,192,78,244,68,252,136,187,204,11,175,140
]
]