aLevelData = [
[
2,2,2,2,67,106,210,179,182,232,14,28,100,100,72,158,134,64,46,197
],[
2,2,13,5,205,124,138,189,0,207,11,10,230,247,72,121,102,77,2,87
],[
2,2,2,5,237,156,169,224,16,51,34,250,115,57,200,36,233,65,177,169
],[
2,2,2,2,220,30,50,25,240,249,165,249,227,161,105,186,184,33,43,232
],[
2,2,2,2,20,152,100,164,232,69,35,84,80,226,13,153,187,51,162,130
],[
2,2,2,2,77,222,194,255,129,125,111,152,19,242,212,94,29,250,134,34
],[
2,2,2,2,128,6,11,230,133,70,153,145,196,6,31,231,69,61,138,183
],[
2,2,2,2,230,99,65,86,252,132,241,77,61,147,144,79,222,0,156,110
],[
2,2,2,2,248,140,164,142,48,93,10,25,151,77,7,244,207,136,239,178
],[
2,2,2,2,112,86,183,8,169,53,180,129,43,43,165,115,66,90,244,50
],[
69,213,57,131,49,178,0,84,145,97,204,170,161,60,92,218,178,94,44,252
],[
208,185,63,157,163,99,28,180,147,49,23,215,47,135,209,175,208,110,2,170
],[
121,231,118,239,2,128,86,151,118,36,169,26,185,55,26,7,110,227,252,249
],[
23,172,139,198,126,75,117,249,85,185,153,131,25,138,14,173,60,124,103,81
],[
130,80,53,74,172,216,206,41,84,82,77,41,24,244,218,102,250,200,44,73
],[
7,186,75,71,55,240,155,203,149,89,22,112,159,137,217,116,240,196,226,106
],[
28,88,24,46,220,48,139,30,107,167,254,135,47,154,163,94,156,193,37,49
],[
86,63,235,92,149,119,156,128,206,34,222,49,144,158,100,239,172,137,39,88
],[
152,143,243,155,21,128,38,48,16,166,181,199,198,85,111,126,44,195,134,86
],[
142,26,75,232,118,204,57,84,207,39,53,123,74,41,20,110,1,149,94,37
]
]