aLevelData = [
[
2,2,2,2,2,2,2,2,2,231,110,216,200,219,170,22,123,195,50,0
],[
2,2,2,2,2,2,2,2,2,115,243,149,58,217,197,89,133,123,153,236
],[
2,2,2,2,2,2,2,2,2,224,103,25,221,243,185,194,76,174,177,160
],[
160,46,9,88,120,224,133,108,227,232,203,187,211,196,117,71,207,44,101,59
],[
233,61,88,45,240,215,190,160,230,68,202,205,180,26,197,163,29,98,167,12
],[
241,249,232,114,131,55,148,130,92,207,158,47,49,246,118,250,19,200,221,113
],[
230,231,249,246,20,101,164,194,131,228,10,42,196,251,115,32,141,220,93,252
],[
105,52,206,125,174,83,232,10,175,141,190,62,52,224,102,164,39,215,80,191
],[
144,173,213,78,196,182,19,205,216,251,249,63,92,36,158,43,70,156,215,229
],[
45,239,8,14,184,119,58,94,85,55,110,161,46,7,49,0,89,242,113,130
],[
78,220,143,211,159,103,181,67,227,24,106,17,243,182,100,234,90,243,157,173
],[
6,79,169,113,68,56,70,201,235,118,53,71,214,198,72,62,152,197,189,204
],[
108,16,202,24,107,170,121,217,2,158,182,24,162,229,166,54,185,137,59,48
],[
226,11,6,34,88,3,76,10,177,6,91,207,201,204,30,130,252,146,240,227
],[
152,190,174,39,145,194,16,248,119,66,57,190,166,121,140,29,189,217,194,190
],[
81,241,57,83,226,148,143,213,13,56,112,16,4,156,172,98,60,174,141,192
],[
101,171,103,249,159,136,112,63,235,145,210,227,223,80,255,96,159,176,69,155
],[
8,98,162,105,46,128,217,82,9,112,197,149,107,12,238,107,53,255,90,144
],[
203,114,166,0,197,233,85,254,232,103,103,91,84,217,45,245,254,177,93,126
],[
97,210,98,127,113,172,245,156,209,168,241,25,69,198,99,157,106,132,225,54
]
]