aLevelData = [
[
5,5,3,5,5,5,178,246,103,12,36,241,187,127,188,153,176,21,217,226
],[
4,2,3,5,5,5,60,123,201,235,210,233,52,211,227,153,183,206,165,125
],[
2,2,3,2,3,3,207,120,19,49,249,105,53,47,23,9,161,66,22,165
],[
5,2,2,2,3,2,66,61,206,195,88,236,41,179,192,75,136,103,118,246
],[
2,2,2,3,2,2,98,133,88,225,46,185,44,73,132,80,229,234,127,3
],[
2,2,2,3,2,2,34,115,101,16,248,55,138,144,241,37,113,4,84,250
],[
2,2,2,2,2,2,53,49,167,181,39,46,115,75,185,187,71,157,155,212
],[
5,2,2,2,2,2,255,167,35,134,70,250,242,2,90,108,213,240,16,14
],[
2,2,5,5,3,2,233,5,23,94,3,216,128,190,78,241,126,37,54,35
],[
2,2,5,5,3,2,107,21,133,29,12,205,204,59,22,191,5,162,241,68
],[
2,2,3,3,3,2,118,139,187,143,217,223,144,223,185,5,9,249,31,247
],[
2,2,3,2,2,2,2,214,110,156,161,153,140,82,148,196,66,201,153,170
],[
2,2,3,2,2,2,230,24,68,40,55,10,253,144,136,185,72,230,33,95
],[
2,2,3,2,5,2,73,79,226,104,135,198,41,204,240,17,246,155,29,243
],[
77,218,216,164,220,141,219,126,222,21,219,249,63,188,197,217,1,143,72,166
],[
222,108,147,93,47,91,96,101,12,33,49,196,181,19,217,147,48,41,63,175
],[
52,83,95,178,70,16,145,34,34,60,14,232,92,41,176,3,71,242,249,125
],[
22,12,87,158,65,30,166,97,43,19,247,36,1,109,144,163,229,220,52,39
],[
76,15,164,251,164,202,101,32,59,57,196,65,92,132,24,233,187,163,71,244
],[
18,116,139,68,13,10,118,181,100,72,52,82,70,175,17,201,254,117,58,28
]
]