aLevelData = [
[
2,2,2,2,2,2,2,2,2,6,5,2,2,2,2,2,2,2,2,255
],[
2,3,5,3,5,5,5,3,5,3,5,2,5,3,5,3,5,5,2,183
],[
2,3,2,3,2,2,2,3,5,3,5,2,5,3,5,3,5,5,3,20
],[
2,2,2,2,2,2,2,2,2,2,2,2,5,5,5,5,5,5,3,98
],[
2,3,5,3,5,5,5,3,2,3,5,5,5,3,2,3,5,5,3,119
],[
170,107,9,189,108,171,249,35,215,213,119,235,243,98,114,93,188,236,99,23
],[
37,44,119,165,92,36,240,81,80,157,200,60,113,212,152,174,182,113,185,171
],[
229,184,169,199,15,3,176,59,89,112,195,55,3,215,168,122,162,255,91,33
],[
176,17,177,188,71,76,59,167,42,251,109,152,5,164,255,116,246,131,148,103
],[
75,54,154,51,142,186,113,200,191,150,207,22,224,86,99,31,183,59,184,80
],[
207,49,93,17,192,1,67,155,176,200,102,9,26,168,175,178,206,189,25,183
],[
57,83,20,216,231,86,39,140,70,9,216,80,173,251,208,63,156,56,59,227
],[
70,188,110,75,76,45,204,93,204,201,234,110,154,157,241,16,205,247,68,43
],[
126,31,99,80,204,66,16,73,35,175,176,245,191,70,243,83,107,44,183,220
],[
143,196,42,22,105,219,47,102,155,35,4,37,230,227,33,247,53,236,99,88
],[
221,207,105,120,35,77,63,73,255,15,57,214,31,152,34,214,47,119,150,129
],[
88,193,173,162,6,190,218,238,239,227,18,148,81,0,48,21,122,187,152,86
],[
142,61,26,244,133,43,26,215,115,216,238,10,12,185,136,201,103,25,85,220
],[
2,13,100,36,7,171,203,116,205,119,71,162,162,30,34,221,200,103,90,64
],[
189,102,255,168,191,243,221,195,144,90,91,106,119,84,163,49,135,54,3,60
]
]