aLevelData = [
[
6,2,8,46,218,155,249,48,8,187,222,242,172,76,239,173,238,105,47,106
],[
2,2,2,133,126,169,21,122,253,86,212,46,82,64,151,158,24,232,239,230
],[
2,2,3,141,229,35,4,67,207,129,223,25,91,242,136,106,199,209,191,132
],[
2,2,3,121,253,185,92,227,45,32,128,169,132,92,76,6,102,17,97,108
],[
2,2,3,137,232,83,106,79,147,162,211,83,11,236,29,65,28,96,7,236
],[
2,2,3,36,118,126,154,24,221,194,162,199,181,197,58,99,255,212,138,61
],[
2,2,3,82,120,5,208,207,159,248,1,87,247,99,165,251,155,9,68,179
],[
2,2,3,241,195,28,83,210,25,105,188,236,19,228,79,101,77,138,168,193
],[
2,2,2,74,158,136,6,10,241,18,30,223,97,59,124,124,160,124,3,79
],[
2,3,2,55,201,35,17,202,199,69,155,157,58,105,251,87,188,13,199,6
],[
181,81,177,100,135,90,92,89,9,244,110,192,55,123,231,110,40,251,177,112
],[
64,150,119,149,166,38,187,45,248,36,35,15,62,201,20,225,29,114,130,147
],[
78,73,7,45,78,34,50,203,86,163,33,229,141,168,82,212,125,229,182,146
],[
195,206,7,194,11,179,92,240,60,48,251,25,240,196,110,110,39,192,217,85
],[
60,99,138,177,24,67,210,99,165,238,19,17,133,210,27,37,5,90,176,25
],[
76,90,108,243,217,173,204,11,44,29,131,20,194,130,20,90,71,46,159,73
],[
8,137,251,47,167,249,6,67,18,5,57,229,181,185,128,39,239,76,72,141
],[
195,0,217,17,209,74,230,106,132,51,98,142,140,254,150,118,143,11,113,33
],[
27,251,31,219,224,21,221,191,28,232,11,123,86,50,130,83,79,1,41,105
],[
54,24,195,59,27,148,11,109,166,208,3,201,9,133,137,132,51,54,43,194
]
]