aLevelData = [
[
2,2,2,2,2,2,2,2,2,2,2,2,2,2,2,2,2,2,66,15
],[
2,2,13,5,5,2,2,12,5,5,2,3,2,5,5,2,2,2,110,236
],[
2,2,2,5,5,2,2,2,5,5,2,3,2,5,5,2,2,2,207,130
],[
2,2,2,2,2,2,2,2,2,2,2,3,2,2,2,2,2,2,10,125
],[
2,2,2,2,2,2,2,2,2,2,2,3,3,3,3,3,3,3,49,94
],[
2,2,2,2,2,2,2,2,2,2,2,2,2,2,6,2,2,2,174,38
],[
2,2,2,2,2,2,2,2,2,2,2,2,2,3,3,3,2,3,184,132
],[
2,2,2,2,2,2,2,2,2,2,2,2,2,2,2,2,2,2,74,104
],[
2,2,2,2,2,2,2,2,2,2,3,2,2,2,2,2,2,2,240,31
],[
2,2,2,2,2,2,2,2,2,3,3,2,3,2,2,2,2,2,235,106
],[
2,2,2,2,2,2,2,2,3,3,2,9,3,3,2,2,2,2,118,42
],[
2,2,2,2,2,2,2,2,3,2,2,2,3,3,2,2,2,2,51,155
],[
4,2,2,2,2,2,2,3,2,2,2,2,3,2,2,2,2,2,11,51
],[
2,2,2,2,2,3,3,2,2,2,2,3,3,2,2,2,2,2,7,153
],[
2,2,2,3,2,2,11,2,2,2,3,3,2,2,3,3,3,3,231,94
],[
135,82,79,172,67,105,106,125,171,219,81,84,200,226,101,219,42,25,229,39
],[
34,225,192,60,49,4,167,212,191,153,103,92,16,40,118,64,117,14,203,104
],[
191,34,243,3,249,152,98,131,87,38,7,232,105,102,35,66,148,124,90,113
],[
195,248,11,48,90,254,221,82,108,164,154,74,45,155,65,241,170,18,86,132
],[
183,215,125,236,41,191,71,67,70,73,76,147,122,126,122,225,76,27,172,106
]
]