aLevelData = [
[
2,138,91,218,123,103,164,156,153,39,94,194,105,42,57,203,198,247,109,156
],[
2,71,210,254,189,171,146,62,197,122,173,147,19,233,149,122,191,254,71,204
],[
5,208,246,32,65,176,228,243,50,221,154,90,163,224,204,73,128,131,115,233
],[
2,39,63,112,163,39,244,114,122,71,221,25,159,203,194,92,63,242,111,40
],[
2,160,195,102,73,108,9,209,142,77,157,186,40,185,227,126,84,16,151,127
],[
2,58,228,202,26,20,151,39,217,146,44,123,233,125,87,117,206,156,214,170
],[
2,85,212,4,219,202,146,172,123,108,110,27,108,30,8,121,10,95,54,89
],[
2,106,124,98,142,227,4,45,64,206,125,88,64,139,85,229,153,197,28,121
],[
2,104,246,240,5,237,45,56,165,225,15,149,201,10,27,21,146,14,51,170
],[
2,127,133,88,219,72,81,182,186,10,50,224,22,165,149,92,241,98,173,98
],[
2,52,218,197,225,162,19,213,195,11,235,83,114,194,186,75,155,81,51,178
],[
2,50,106,139,248,182,33,222,220,182,89,206,132,148,124,109,205,137,112,93
],[
2,224,233,198,53,6,168,52,39,189,30,69,224,11,7,79,176,18,206,166
],[
2,235,229,11,15,143,154,74,119,38,160,14,229,238,83,21,174,56,206,222
],[
2,232,14,0,105,32,24,3,62,80,193,168,176,11,149,87,99,251,237,22
],[
6,12,141,207,231,120,235,16,87,208,43,187,84,27,197,183,63,4,75,163
],[
8,66,221,84,5,228,229,186,164,218,198,5,50,32,98,38,46,73,207,105
],[
9,9,20,160,165,136,63,103,181,105,160,120,44,73,113,239,69,197,236,244
],[
10,25,224,24,61,21,164,226,213,170,13,111,28,70,34,177,16,132,101,56
],[
202,160,109,75,75,45,210,56,121,10,73,232,101,146,16,182,207,19,141,129
]
]