aLevelData = [
[
4,2,5,5,2,2,2,2,2,2,2,2,2,2,2,2,204,14,121,17
],[
2,2,2,2,2,2,5,2,2,2,5,2,2,2,5,3,114,195,167,228
],[
2,2,2,2,2,2,3,3,3,3,3,3,3,2,2,2,33,126,94,68
],[
3,3,3,3,3,3,3,2,2,2,2,2,3,2,2,2,175,12,72,5
],[
2,2,3,2,2,2,2,2,2,2,2,2,3,2,2,2,45,141,26,217
],[
13,2,3,2,2,2,2,2,2,3,2,2,3,2,2,2,25,210,105,206
],[
213,10,190,24,88,158,236,17,36,89,161,126,119,204,60,20,198,241,222,59
],[
103,14,196,17,142,220,212,178,122,233,117,183,240,59,164,252,233,54,69,167
],[
136,192,182,101,78,162,170,247,145,49,53,238,42,47,35,178,111,236,142,201
],[
97,176,176,86,38,93,245,224,185,81,84,85,224,138,224,79,94,13,154,149
],[
106,136,138,229,97,54,14,241,184,3,113,167,52,241,191,181,93,186,216,77
],[
48,183,196,37,20,0,70,195,15,213,180,247,58,60,5,169,114,236,44,212
],[
81,106,165,211,92,114,77,220,126,152,118,202,182,47,59,31,12,106,17,73
],[
201,193,159,36,231,150,208,193,199,25,38,102,34,105,81,213,66,252,0,209
],[
114,64,247,223,179,130,97,74,176,16,104,105,244,154,4,36,91,222,16,181
],[
198,133,163,172,19,71,157,54,77,86,128,158,31,250,130,20,143,120,224,174
],[
233,57,116,172,248,40,138,0,124,92,240,14,217,247,76,176,13,78,178,125
],[
228,74,118,75,111,14,63,242,178,217,93,83,157,46,93,153,62,51,218,191
],[
52,88,150,83,103,56,201,121,246,196,184,50,113,158,138,222,73,195,87,0
],[
132,109,131,66,181,56,74,185,44,131,155,105,106,25,42,12,216,17,193,15
]
]