aLevelData = [
[
10,2,2,8,2,2,2,2,2,2,2,2,2,2,2,43,20,15,45,23
],[
2,2,2,2,2,2,2,2,2,2,2,2,2,2,2,60,18,241,166,65
],[
2,2,2,2,2,2,3,3,3,3,2,2,2,2,2,49,76,166,71,76
],[
9,2,2,2,2,2,2,2,2,3,2,2,2,2,2,178,144,115,71,133
],[
3,3,3,3,3,3,3,2,2,3,2,2,2,2,2,13,91,176,43,186
],[
2,2,2,2,2,2,2,2,2,3,2,2,2,2,2,186,161,99,40,105
],[
2,2,2,2,2,2,2,2,2,3,3,2,2,2,2,232,217,40,138,102
],[
2,2,2,2,2,2,2,2,2,2,3,2,2,2,2,248,69,6,181,255
],[
2,2,2,2,2,2,2,2,2,2,3,2,2,2,2,145,59,14,87,165
],[
2,2,2,2,3,3,3,3,2,2,3,2,2,2,2,238,105,36,227,135
],[
2,2,2,2,3,2,2,3,2,2,3,2,2,2,2,229,26,254,125,107
],[
2,2,2,2,3,2,2,3,2,2,3,3,3,5,2,145,189,15,142,220
],[
2,2,2,2,3,2,2,3,2,2,2,2,3,2,2,251,53,182,215,243
],[
2,2,2,2,3,2,2,3,2,2,2,2,3,2,2,214,126,192,186,59
],[
2,2,2,2,3,2,2,3,2,2,2,2,3,2,2,90,72,13,196,125
],[
233,77,217,250,121,200,36,41,0,58,253,76,199,148,38,114,177,251,185,156
],[
206,20,94,31,46,127,193,73,243,161,68,71,170,167,241,70,220,199,178,217
],[
223,201,196,155,242,199,105,21,138,49,221,226,230,19,140,16,233,155,130,202
],[
41,214,35,52,68,186,28,151,115,105,153,190,97,180,185,160,61,222,62,63
],[
13,163,138,207,70,121,199,27,154,22,101,37,18,50,201,12,92,142,67,51
]
]