aLevelData = [
[
2,2,2,5,2,2,2,5,2,2,2,5,2,2,2,181,251,75,38,161
],[
2,2,2,2,2,5,2,2,2,5,2,2,2,5,2,189,179,36,66,70
],[
2,2,3,3,3,3,3,3,3,3,3,3,3,3,3,21,66,95,205,31
],[
2,3,2,2,2,2,2,2,2,2,2,2,2,5,2,132,182,175,12,75
],[
2,3,2,2,2,2,2,2,2,2,8,2,2,2,2,248,97,200,225,22
],[
2,2,2,2,2,5,5,5,5,2,2,2,2,5,2,168,85,83,187,12
],[
2,2,3,3,3,3,2,3,2,3,2,2,2,3,2,109,127,25,138,105
],[
2,2,3,2,2,3,2,3,2,3,3,2,2,3,2,109,233,137,97,227
],[
2,2,3,2,2,3,2,3,2,3,2,3,2,3,2,173,15,149,51,57
],[
4,2,3,2,2,3,2,3,2,3,2,3,2,3,2,53,11,88,113,216
],[
2,2,3,3,3,2,2,3,2,3,2,3,2,3,2,122,65,84,146,103
],[
2,2,3,2,3,2,2,3,2,3,2,2,3,3,2,109,58,232,142,184
],[
2,2,3,2,3,2,2,3,2,3,2,2,3,3,2,89,197,131,117,142
],[
2,2,3,2,2,3,2,3,2,3,2,2,2,3,2,40,153,188,91,25
],[
2,2,3,2,2,3,2,3,2,3,2,2,2,3,2,3,5,44,225,57
],[
2,2,2,2,2,5,5,5,5,2,2,2,2,5,2,246,222,122,158,122
],[
129,69,95,19,93,251,158,113,52,230,208,67,199,81,99,77,155,61,164,187
],[
253,85,225,181,68,36,202,51,86,134,29,19,110,92,131,105,28,132,181,22
],[
141,9,226,156,12,150,85,48,201,49,83,17,217,37,66,25,127,64,17,145
],[
170,63,211,74,190,135,173,233,151,22,243,131,204,184,142,106,48,126,161,70
]
]