aLevelData = [
[
2,2,2,5,2,2,2,5,2,2,2,5,2,2,2,5,2,2,2,2
],[
2,2,2,2,2,5,2,2,2,5,2,2,2,5,2,2,2,2,2,2
],[
2,2,3,3,3,3,3,3,3,3,3,3,3,3,3,3,2,2,2,2
],[
2,3,2,2,2,2,2,2,2,2,2,2,2,5,2,5,2,2,2,2
],[
2,3,2,2,2,2,2,2,2,2,8,2,2,2,2,2,2,2,2,2
],[
2,2,2,2,2,5,5,5,5,2,2,2,2,5,2,3,3,3,2,2
],[
2,2,3,3,3,3,2,3,2,3,2,2,2,3,2,3,2,2,3,2
],[
2,2,3,2,2,3,2,3,2,3,3,2,2,3,2,3,2,2,3,2
],[
2,2,3,2,2,3,2,3,2,3,2,3,2,3,2,3,2,2,2,2
],[
4,2,3,2,2,3,2,3,2,3,2,3,2,3,2,3,2,2,2,2
],[
193,225,149,236,125,58,37,176,32,202,72,12,250,179,105,84,95,8,32,79
],[
77,223,249,234,78,168,119,42,160,189,88,100,148,58,27,176,52,14,192,155
],[
40,82,207,28,219,218,155,202,217,10,200,75,124,235,11,16,199,126,49,63
],[
146,81,99,241,231,79,168,158,173,220,171,213,131,34,191,49,239,165,32,136
],[
184,30,123,101,144,134,177,185,246,113,217,205,91,157,132,123,132,203,68,158
],[
47,205,111,199,249,225,32,50,127,61,127,248,196,235,66,133,211,215,116,77
],[
165,39,117,187,68,202,67,106,49,84,247,152,3,9,147,216,82,55,250,6
],[
211,202,64,128,196,26,36,147,139,7,219,52,154,72,16,241,149,0,40,39
],[
183,146,202,116,114,183,159,111,85,206,86,151,51,115,236,138,130,82,42,120
],[
1,61,111,214,158,125,175,87,150,102,188,24,222,47,196,26,194,0,27,246
]
]