aLevelData = [
[
12,2,2,2,2,89,238,163,17,83,94,121,98,46,163,100,179,70,124,185
],[
2,2,2,2,2,85,182,102,144,84,109,97,118,88,133,247,98,201,208,123
],[
2,2,3,3,3,235,54,179,143,183,248,55,232,55,18,93,86,145,92,178
],[
11,2,3,2,2,254,222,225,36,234,150,133,20,197,72,235,172,223,143,149
],[
2,2,3,2,2,115,120,65,77,30,58,233,196,170,7,120,122,167,245,55
],[
2,2,3,2,2,221,215,151,0,181,247,127,174,191,221,0,210,152,195,57
],[
10,2,3,2,2,168,221,227,78,73,145,68,249,33,191,211,66,164,96,181
],[
2,2,3,2,2,138,61,126,220,206,135,154,216,42,192,76,240,156,123,41
],[
2,2,3,2,2,114,11,148,233,71,136,105,202,202,211,71,47,219,33,35
],[
9,2,3,2,2,141,46,28,139,135,233,44,220,88,111,245,180,114,118,33
],[
2,2,3,2,2,170,100,96,95,61,1,200,171,11,191,91,209,68,93,233
],[
2,2,3,2,2,44,93,201,187,180,9,64,40,56,101,183,99,231,114,122
],[
8,2,3,2,2,151,21,201,19,54,60,138,109,142,65,150,57,157,249,254
],[
2,2,3,2,3,145,38,236,187,219,4,89,159,241,191,122,139,127,93,8
],[
2,2,3,2,3,227,172,122,2,63,252,155,171,99,116,192,210,114,0,56
],[
6,2,3,2,3,85,94,19,185,232,163,141,176,19,53,225,214,122,182,119
],[
2,2,3,3,3,4,97,237,79,72,111,116,232,56,178,176,96,134,228,6
],[
220,213,237,76,42,203,168,126,165,104,234,179,89,150,193,79,104,1,249,121
],[
173,40,229,208,158,181,92,89,119,9,1,188,149,28,199,177,31,132,181,181
],[
236,211,231,1,161,38,214,188,26,251,217,112,12,67,235,187,232,185,174,71
]
]