aLevelData = [
[
6,2,8,2,9,2,10,2,11,3,143,43,15,40,197,166,135,69,20,0
],[
2,2,2,2,2,2,2,2,12,3,230,34,212,255,108,75,107,67,199,5
],[
2,2,3,3,3,3,3,3,3,3,29,204,137,235,38,188,216,217,6,94
],[
2,2,3,2,2,2,2,2,2,2,103,9,29,104,166,124,119,125,54,156
],[
2,2,3,2,2,2,2,2,2,2,233,246,160,31,93,226,70,46,106,75
],[
2,2,3,2,3,3,3,3,3,3,154,199,40,188,141,96,66,255,75,205
],[
2,2,3,2,2,2,2,5,5,3,76,43,37,99,87,223,206,94,195,200
],[
2,2,3,5,5,5,2,3,3,3,203,128,85,105,37,251,137,27,97,145
],[
2,2,2,2,2,2,2,2,2,2,42,82,177,250,31,35,108,134,136,3
],[
2,3,2,2,3,1,3,2,2,2,188,3,10,210,151,225,102,24,240,148
],[
81,142,46,58,128,224,221,126,2,177,163,188,210,223,118,102,173,9,13,166
],[
33,79,148,68,231,89,164,203,114,155,114,231,200,215,71,18,145,227,48,111
],[
109,172,246,246,139,123,80,210,120,119,88,7,52,108,60,88,139,202,54,104
],[
162,241,190,31,209,171,254,79,176,250,134,152,117,21,65,137,125,173,167,7
],[
40,116,53,243,234,224,26,7,159,44,52,1,31,161,58,4,19,19,59,59
],[
7,174,71,191,192,243,108,187,207,253,228,206,102,9,140,176,107,53,152,25
],[
203,136,133,222,17,51,80,93,55,22,230,28,187,134,219,173,246,78,94,213
],[
170,243,109,237,218,61,69,135,222,242,29,85,182,229,19,71,159,47,103,244
],[
228,189,231,59,247,11,170,42,192,46,1,30,53,24,171,44,43,24,72,192
],[
107,160,16,132,9,75,197,132,241,30,230,143,195,15,38,224,225,195,29,254
]
]