aLevelData = [
[
2,2,2,2,151,89,221,37,67,184,222,11,21,247,63,207,84,214,16,81
],[
2,2,2,2,51,72,202,51,155,37,53,49,43,31,136,176,126,247,210,153
],[
5,2,5,2,172,241,154,103,19,133,194,127,87,87,178,192,167,105,178,92
],[
5,2,5,2,66,143,150,230,58,36,161,172,120,252,164,70,1,153,102,111
],[
5,5,5,2,120,162,72,20,227,144,41,171,178,171,136,198,253,53,232,232
],[
5,2,5,2,13,229,121,151,30,151,244,178,99,65,199,5,75,41,114,27
],[
5,2,5,2,3,85,49,83,60,67,219,54,46,219,10,8,220,162,124,157
],[
2,2,2,12,154,48,185,111,205,228,246,237,243,214,58,21,227,13,191,68
],[
2,2,7,2,85,243,155,77,164,5,159,201,211,207,128,175,207,24,52,37
],[
2,2,7,2,243,90,159,149,209,117,111,2,48,163,69,157,81,175,21,147
],[
2,2,7,2,119,98,207,42,165,63,63,12,170,112,50,226,91,255,218,37
],[
32,73,115,49,178,176,39,156,34,145,47,197,30,118,60,176,112,140,21,17
],[
199,87,129,166,186,164,103,202,10,191,52,72,39,231,125,109,246,255,230,97
],[
210,134,66,183,209,201,251,66,72,87,180,42,145,182,46,64,11,84,104,143
],[
99,192,11,51,18,26,4,111,39,201,115,249,71,107,196,152,242,18,27,241
],[
7,173,246,158,139,196,14,129,166,105,126,88,238,107,38,145,233,204,82,95
],[
204,117,151,13,137,41,254,147,9,184,101,103,182,117,33,149,61,233,232,18
],[
146,201,239,77,52,38,79,8,178,228,173,102,110,109,26,69,161,166,56,205
],[
159,35,158,73,93,151,126,54,48,142,133,154,215,94,3,152,188,90,76,64
],[
119,74,94,172,148,24,196,72,150,204,186,113,59,186,145,66,2,250,85,170
]
]