aLevelData = [
[
5,5,3,5,5,5,5,5,5,5,3,5,5,5,111,29,129,0,172,155
],[
4,2,3,5,5,5,5,5,5,5,3,5,5,5,166,243,246,158,67,107
],[
2,2,3,2,3,3,3,3,3,2,3,3,3,3,218,71,128,69,213,246
],[
5,2,2,2,3,2,2,2,2,2,5,5,5,5,210,116,34,201,111,160
],[
2,2,2,3,2,2,2,2,2,2,5,5,5,5,209,95,5,19,25,226
],[
2,2,2,3,2,2,5,3,3,2,3,3,3,3,171,214,239,68,24,23
],[
2,2,2,2,2,2,5,5,3,2,2,2,2,2,215,200,18,206,251,197
],[
5,2,2,2,2,2,5,5,3,2,2,2,2,2,42,161,122,167,167,4
],[
2,2,5,5,3,2,5,5,3,2,3,3,3,5,2,54,192,164,161,27
],[
2,2,5,5,3,2,5,5,3,6,3,3,5,5,14,6,216,159,64,107
],[
2,2,3,3,3,2,5,5,3,5,5,3,5,5,242,183,17,248,147,62
],[
2,2,3,2,2,2,5,5,3,5,5,5,3,5,119,19,148,129,29,16
],[
2,2,3,2,2,2,5,5,3,5,5,5,3,3,14,0,20,13,181,115
],[
2,2,3,2,5,2,3,3,3,5,5,5,3,3,198,26,104,12,43,158
],[
2,2,2,2,5,2,3,5,5,5,5,5,5,3,6,252,63,246,130,56
],[
179,94,58,125,226,21,132,145,8,188,138,205,174,255,89,216,105,120,52,181
],[
196,208,46,0,123,40,248,116,234,183,247,177,196,180,153,60,8,118,234,200
],[
49,218,98,180,174,229,1,212,145,170,159,116,139,110,125,154,24,11,31,140
],[
247,146,94,146,221,52,185,253,106,99,236,104,92,52,196,62,3,8,49,125
],[
245,107,157,185,2,60,124,99,106,15,36,75,78,207,223,100,101,168,63,199
]
]