aLevelData = [
[
2,2,2,221,61,71,26,125,173,68,122,153,235,20,171,101,169,178,139,217
],[
2,2,2,82,237,123,98,236,190,99,215,67,217,247,174,68,130,57,112,167
],[
5,2,5,162,63,106,209,26,55,166,248,87,168,25,136,38,251,30,197,202
],[
57,35,178,77,22,162,50,19,47,84,110,181,144,161,118,12,121,90,43,139
],[
98,170,92,210,60,74,47,129,250,245,195,74,80,28,19,75,186,218,30,154
],[
193,42,69,33,122,88,244,172,79,181,132,64,1,143,96,175,238,96,103,105
],[
144,70,146,149,71,179,215,96,88,102,77,149,53,154,144,111,255,125,103,171
],[
73,227,164,224,31,60,76,19,70,195,248,134,198,249,123,210,166,82,197,53
],[
247,46,8,45,20,10,25,70,39,248,24,48,239,76,83,20,193,153,104,40
],[
205,220,170,130,163,246,198,42,246,96,167,114,159,26,150,138,228,228,166,79
],[
251,177,79,100,202,89,89,132,241,142,251,22,10,17,69,2,47,37,187,196
],[
189,69,67,191,88,18,65,211,48,143,0,49,130,144,84,110,97,112,125,215
],[
182,3,79,5,134,203,144,177,115,111,162,201,134,104,97,194,43,254,79,49
],[
125,115,239,149,196,126,110,119,60,251,136,182,25,224,170,28,199,115,84,52
],[
118,186,194,96,214,51,203,38,31,198,9,203,85,248,58,35,202,97,230,167
],[
228,96,67,200,32,13,85,131,87,111,89,54,65,240,100,178,55,13,72,145
],[
61,82,183,202,63,134,171,130,155,35,4,37,224,9,115,182,213,114,152,99
],[
190,41,103,93,218,247,208,230,48,94,159,172,140,138,161,85,196,133,8,91
],[
63,170,16,26,184,92,227,39,64,248,186,228,130,7,70,81,75,185,78,37
],[
74,143,153,30,20,87,14,149,106,93,26,85,191,224,82,173,245,195,90,196
]
]