aLevelData = [
[
2,2,2,2,2,2,2,2,2,2,2,22,239,150,125,223,99,14,218,186
],[
2,2,2,2,2,2,2,2,3,3,3,65,98,76,88,202,229,172,194,46
],[
2,2,3,2,3,2,2,2,2,3,2,21,76,145,241,114,125,98,147,145
],[
2,2,3,2,3,2,2,2,2,2,3,85,133,112,108,175,245,229,252,114
],[
2,2,3,2,3,2,2,2,2,2,2,141,180,10,23,120,170,66,101,234
],[
2,2,3,2,2,2,2,2,2,2,2,127,137,127,13,253,144,33,63,100
],[
2,2,3,2,3,3,3,3,3,3,3,169,39,122,14,218,79,19,79,48
],[
2,2,3,2,2,2,2,2,2,2,2,63,168,159,86,202,84,251,102,111
],[
2,2,3,2,3,3,3,3,3,3,3,36,136,255,34,207,122,152,80,161
],[
2,2,3,2,2,2,2,2,2,2,2,52,20,29,185,176,150,240,116,34
],[
2,2,3,3,3,3,3,3,3,3,3,150,49,41,216,53,81,23,101,205
],[
1,2,3,2,2,2,2,2,2,2,2,11,155,254,205,234,167,36,196,12
],[
2,2,3,5,5,2,2,2,5,5,5,111,132,187,37,101,27,200,198,104
],[
2,2,3,2,2,5,5,5,5,5,2,157,224,224,56,24,237,132,46,212
],[
6,5,3,3,3,2,5,2,2,2,2,32,236,42,127,137,191,204,134,229
],[
145,231,198,183,169,50,100,154,8,65,249,213,167,180,243,48,255,175,56,6
],[
206,138,12,156,25,201,52,177,109,78,91,86,107,205,182,0,132,129,228,220
],[
0,29,24,98,69,6,121,45,86,191,201,10,154,164,69,79,223,220,205,110
],[
158,137,69,201,128,65,59,200,34,194,202,41,21,225,190,152,42,196,248,128
],[
236,81,21,32,109,230,74,225,70,75,146,231,217,229,12,230,217,44,158,55
]
]