aLevelData = [
[
2,2,2,5,2,2,2,5,2,203,156,253,147,18,127,108,54,156,204,1
],[
2,2,2,2,2,5,2,2,2,66,81,93,123,142,128,216,56,13,33,225
],[
2,2,3,3,3,3,3,3,3,158,160,93,141,185,46,80,25,37,247,13
],[
2,3,2,2,2,2,2,2,2,220,47,37,226,122,55,164,222,91,89,52
],[
2,3,2,2,2,2,2,2,2,145,91,76,189,19,195,137,226,72,121,176
],[
2,2,2,2,2,5,5,5,5,216,97,115,40,121,166,113,6,148,115,236
],[
2,2,3,3,3,3,2,3,2,49,136,129,73,195,17,103,83,178,97,97
],[
2,2,3,2,2,3,2,3,2,232,175,115,79,242,78,156,1,154,104,99
],[
2,2,3,2,2,3,2,3,2,177,184,190,146,209,141,222,141,8,180,75
],[
4,2,3,2,2,3,2,3,2,227,119,86,216,35,64,158,85,241,73,108
],[
2,2,3,3,3,2,2,3,2,109,88,61,78,207,98,212,172,140,230,85
],[
2,2,3,2,3,2,2,3,2,66,192,162,89,211,117,137,209,28,196,94
],[
2,2,3,2,3,2,2,3,2,74,8,61,130,112,34,138,11,209,79,78
],[
2,2,3,2,2,3,2,3,2,21,228,189,83,93,74,23,229,12,83,251
],[
2,2,3,2,2,3,2,3,2,121,208,196,173,147,49,216,13,230,35,132
],[
2,2,2,2,2,5,5,5,5,198,188,215,255,201,152,215,130,250,26,82
],[
2,3,2,2,2,2,2,2,2,77,40,36,180,234,67,59,122,181,201,48
],[
2,3,3,3,3,2,2,2,2,69,156,130,255,45,36,109,247,87,172,250
],[
2,2,2,2,2,3,3,3,3,27,202,246,121,201,126,227,211,153,182,126
],[
2,2,2,2,2,2,2,2,2,120,136,144,60,152,86,219,131,150,44,40
]
]