aLevelData = [
[
4,2,2,2,2,2,2,2,161,219,0,68,206,225,127,79,87,140,242,218
],[
5,2,5,3,2,2,2,2,71,69,110,186,243,159,134,62,58,139,183,7
],[
2,5,5,3,3,3,3,3,12,207,4,26,41,180,221,52,43,255,69,94
],[
3,3,5,5,5,5,5,5,199,35,52,192,80,181,58,186,124,32,102,49
],[
2,3,5,5,5,5,5,5,107,154,102,39,229,87,239,143,228,252,96,95
],[
3,3,5,5,5,5,3,3,82,86,162,230,19,76,82,96,70,18,34,200
],[
3,5,5,5,5,5,3,2,200,160,124,237,250,99,105,200,197,50,178,13
],[
3,5,5,3,3,3,3,8,219,131,69,0,63,223,217,138,7,147,213,140
],[
3,5,5,3,2,2,3,3,97,169,110,115,212,22,16,13,200,53,0,155
],[
3,5,5,3,2,2,2,2,73,116,63,39,8,78,177,23,162,121,126,3
],[
3,5,5,3,2,2,3,2,37,96,185,196,209,211,64,205,27,253,227,191
],[
5,5,5,3,2,2,3,2,248,151,200,55,87,92,13,234,239,189,176,245
],[
60,213,172,110,196,159,101,63,159,103,70,52,54,126,169,82,75,50,247,107
],[
58,253,16,239,126,253,237,5,118,164,132,218,105,177,235,57,201,95,193,93
],[
180,220,202,3,192,252,217,195,248,47,243,159,34,177,177,221,68,0,230,18
],[
102,147,130,128,152,201,182,161,55,32,89,4,109,167,139,88,247,182,152,199
],[
43,220,31,133,57,25,115,168,177,77,65,58,69,241,115,140,209,5,85,206
],[
152,73,246,221,208,176,210,92,98,18,173,6,235,33,194,66,6,158,29,248
],[
205,205,70,164,157,38,31,169,26,77,15,231,115,68,96,143,232,224,230,54
],[
137,121,226,41,64,230,37,1,17,168,121,119,161,102,60,121,245,154,78,125
]
]