aLevelData = [
[
4,2,2,2,2,2,2,2,2,69,220,92,126,229,60,194,1,124,88,15
],[
2,2,3,2,9,2,2,2,2,122,53,252,240,172,89,164,3,150,122,226
],[
2,3,2,2,2,2,3,2,2,161,245,242,0,251,10,140,230,104,157,128
],[
2,3,2,2,2,3,2,2,3,63,253,66,165,216,95,219,226,72,213,94
],[
2,3,2,2,3,2,2,3,2,229,214,161,217,24,151,145,179,209,215,209
],[
2,3,2,3,2,2,3,2,2,52,202,186,3,71,208,35,145,127,191,213
],[
2,2,3,2,2,3,2,2,3,66,89,173,217,12,193,102,31,42,215,25
],[
104,110,242,80,98,215,229,37,21,102,130,179,127,46,93,204,123,171,211,234
],[
232,84,74,103,6,115,185,240,35,53,108,55,120,253,1,232,78,254,183,223
],[
101,9,232,152,149,163,211,230,182,91,159,232,190,91,157,57,41,60,206,104
],[
158,31,165,168,207,249,13,200,161,46,174,101,141,98,108,94,69,139,49,136
],[
155,75,237,163,159,126,219,141,8,15,5,182,214,15,10,212,53,8,31,216
],[
163,142,84,32,85,24,25,238,215,14,0,25,244,35,196,2,213,229,139,202
],[
109,146,104,194,20,46,36,35,113,210,62,0,158,71,48,120,135,212,244,48
],[
147,83,199,1,135,138,45,237,167,185,53,88,30,112,254,116,159,163,122,254
],[
77,0,114,40,216,128,202,214,233,61,7,12,193,131,14,167,29,41,46,76
],[
92,34,97,159,227,79,207,181,193,151,148,203,143,58,195,56,154,98,171,160
],[
69,252,89,107,168,197,94,117,125,168,210,7,61,71,152,7,134,216,228,107
],[
192,50,251,243,0,39,58,24,44,21,90,64,97,184,242,51,145,66,61,210
],[
113,174,30,7,146,81,97,248,205,178,68,128,229,155,54,223,104,112,222,176
]
]