aLevelData = [
[
2,2,2,2,2,2,2,2,2,2,2,2,82,73,81,36,213,114,1,209
],[
2,2,2,2,2,2,2,2,2,2,2,2,213,161,41,126,164,238,77,40
],[
2,2,2,2,2,2,2,2,2,2,2,2,159,87,74,209,14,16,78,117
],[
2,2,2,3,3,3,3,3,3,3,3,3,75,26,40,63,39,23,194,253
],[
2,2,2,2,2,2,2,2,2,2,2,2,137,93,235,210,88,73,90,42
],[
2,2,2,2,2,2,2,2,2,2,2,2,155,213,240,243,223,109,62,11
],[
2,2,2,2,2,3,2,2,3,2,2,3,217,255,71,244,77,82,135,207
],[
2,2,2,3,3,3,3,3,3,3,3,3,47,152,52,136,7,70,195,78
],[
2,2,2,2,2,2,2,2,2,2,2,2,154,35,174,70,198,159,117,128
],[
2,2,2,2,2,2,2,2,2,2,2,2,174,103,227,42,23,54,146,3
],[
2,2,3,3,3,3,3,3,3,3,3,3,18,238,177,19,220,231,5,154
],[
2,2,2,2,2,2,2,2,2,2,2,2,2,135,46,70,200,19,44,168
],[
2,2,2,2,2,2,2,2,2,2,2,2,204,196,33,233,231,30,88,185
],[
2,2,3,3,3,3,3,3,3,2,2,3,84,125,135,137,20,241,81,250
],[
2,2,3,2,2,2,2,2,2,2,2,2,144,75,15,149,129,120,208,188
],[
2,2,3,2,2,2,2,2,2,2,2,2,13,14,158,224,50,37,4,245
],[
2,2,3,3,3,3,2,2,2,2,2,2,104,104,205,35,130,108,13,191
],[
2,2,2,2,2,3,2,2,2,2,2,2,214,64,102,121,157,69,132,215
],[
3,3,3,3,2,3,2,2,2,2,2,2,157,63,234,226,5,173,241,31
],[
2,2,2,2,2,3,2,2,2,2,2,2,152,86,13,192,13,37,83,28
]
]