aLevelData = [
[
10,2,2,8,2,2,2,2,2,2,2,2,2,2,138,171,202,153,150,145
],[
2,2,2,2,2,2,2,2,2,2,2,2,2,2,62,9,31,170,19,109
],[
2,2,2,2,2,2,3,3,3,3,2,2,2,2,141,211,128,172,123,73
],[
158,15,93,191,39,246,102,174,125,202,169,237,238,50,126,129,54,138,39,182
],[
69,145,179,111,67,97,35,186,210,165,204,167,147,6,252,91,235,230,224,96
],[
7,81,165,63,29,48,222,81,245,192,38,210,169,67,6,55,169,246,25,193
],[
1,66,109,83,223,54,45,129,79,53,125,233,74,236,166,198,239,135,115,194
],[
16,37,219,12,240,137,223,171,75,18,182,18,151,237,40,244,138,137,56,89
],[
220,75,5,242,78,132,242,169,235,160,5,125,142,160,141,141,164,202,8,114
],[
51,158,67,210,28,13,195,50,157,230,100,12,25,145,64,34,28,255,210,17
],[
154,225,92,41,119,24,133,124,76,109,71,53,105,131,8,44,22,9,7,183
],[
31,52,250,194,143,109,246,34,187,71,142,38,130,179,63,111,212,119,12,2
],[
113,220,101,156,243,167,77,70,15,75,188,40,24,93,66,162,196,72,238,153
],[
51,66,110,15,45,127,119,247,172,164,104,71,154,126,42,78,219,244,90,72
],[
142,58,170,48,144,72,132,213,66,139,241,48,141,218,186,245,35,171,205,104
],[
7,135,225,114,79,187,93,244,41,81,118,91,28,62,152,117,144,221,8,131
],[
145,156,199,143,208,246,185,255,234,161,6,107,237,8,193,172,25,251,200,53
],[
227,165,235,167,64,191,80,159,31,4,21,210,55,229,56,93,4,125,180,86
],[
12,199,237,167,103,15,78,28,126,166,49,186,19,218,255,83,130,37,152,87
],[
70,165,245,237,190,204,12,66,49,89,243,33,17,135,73,197,124,132,210,235
]
]