aLevelData = [
[
2,2,2,2,2,2,2,2,2,2,2,2,239,41,154,93,128,192,52,176
],[
2,2,2,2,2,2,2,2,2,2,2,2,98,198,94,189,220,182,185,110
],[
2,2,2,2,2,2,2,2,2,2,2,2,191,105,196,24,156,130,174,0
],[
2,2,2,13,2,2,2,2,2,2,2,2,52,9,105,30,48,86,0,33
],[
2,2,2,2,2,2,2,2,2,2,2,2,19,49,42,179,108,55,31,253
],[
2,2,2,2,2,2,2,2,2,2,2,2,80,128,170,110,7,126,128,184
],[
2,2,2,2,2,2,2,2,2,2,2,2,6,40,208,28,29,88,27,232
],[
2,2,2,2,2,2,2,2,2,1,2,2,242,114,70,62,174,71,238,22
],[
2,2,11,2,2,2,2,2,2,2,2,2,246,57,251,134,29,159,120,66
],[
2,2,2,2,2,2,2,2,2,2,2,2,152,107,162,95,178,10,62,92
],[
2,2,2,2,2,2,2,2,2,2,2,2,129,139,48,98,24,4,74,203
],[
254,49,98,226,223,95,167,233,130,136,53,97,251,192,230,133,34,207,107,24
],[
67,32,156,96,23,218,13,115,243,76,226,177,64,142,228,146,43,101,212,162
],[
157,104,255,201,110,97,18,208,214,246,48,33,36,137,66,206,178,92,142,213
],[
24,249,140,163,160,209,244,214,250,35,28,71,49,31,129,72,222,76,163,42
],[
156,39,23,3,187,13,215,173,57,90,220,18,237,211,239,167,6,65,188,55
],[
180,95,40,226,37,246,228,101,179,71,66,156,92,169,72,69,114,115,4,6
],[
147,28,30,178,220,161,180,200,90,39,97,60,193,226,159,122,97,53,80,169
],[
85,27,151,44,254,197,236,111,176,133,112,224,170,234,125,59,76,45,130,11
],[
132,203,14,110,138,116,42,24,205,36,236,154,45,144,73,228,106,195,43,9
]
]