aLevelData = [
[
5,5,5,5,145,232,213,37,27,246,221,173,225,204,40,176,114,138,220,5
],[
5,2,2,2,93,82,39,120,70,10,233,184,56,93,173,113,61,3,222,181
],[
5,2,5,3,44,67,56,160,195,182,124,60,245,77,104,162,133,149,230,98
],[
2,2,5,2,212,58,132,37,248,203,36,145,13,188,244,109,208,177,161,6
],[
2,2,3,2,106,250,200,209,137,89,174,81,181,12,48,59,226,7,253,217
],[
2,2,3,2,65,130,2,172,92,179,38,85,98,221,56,182,191,137,37,84
],[
4,2,3,2,240,19,111,255,150,105,218,182,201,16,105,197,174,104,136,48
],[
2,2,3,2,76,48,139,84,155,76,87,204,222,198,95,146,51,20,211,102
],[
2,2,2,2,105,153,19,116,17,110,106,49,216,97,249,134,20,62,241,48
],[
2,3,2,2,156,78,6,103,221,30,32,189,42,129,83,74,84,216,17,6
],[
123,145,158,118,35,238,197,139,138,8,202,199,58,19,159,161,218,227,90,43
],[
73,175,231,242,238,22,250,37,73,95,72,250,206,5,247,78,244,115,83,140
],[
137,12,194,207,72,110,250,75,173,248,113,233,8,138,21,49,209,139,62,109
],[
59,49,225,11,11,252,6,68,171,132,124,251,122,117,203,232,103,216,106,245
],[
190,148,50,232,65,52,19,67,123,234,6,104,81,212,66,1,218,127,179,159
],[
113,170,168,161,8,76,204,88,191,216,87,105,181,191,133,114,29,54,72,240
],[
149,59,57,96,180,210,213,164,226,149,230,169,109,107,63,71,217,152,172,104
],[
119,246,41,109,57,129,82,205,196,25,27,255,199,132,193,155,139,179,1,188
],[
204,70,135,168,200,82,169,179,149,97,85,96,183,186,72,202,242,227,129,66
],[
93,101,246,58,184,207,133,98,255,253,45,16,63,154,126,229,169,228,78,174
]
]