aLevelData = [
[
2,2,2,2,2,2,2,2,2,6,5,2,2,2,2,2,2,146,154,38
],[
71,134,17,14,236,191,51,122,107,56,35,216,9,117,101,106,145,103,53,73
],[
70,144,29,169,29,104,198,94,41,254,15,160,87,226,92,11,91,67,48,233
],[
234,85,255,180,42,245,61,215,103,144,187,181,7,65,51,236,192,57,34,219
],[
8,100,213,98,205,74,199,232,103,51,42,163,203,142,196,19,1,147,252,208
],[
216,40,53,134,216,1,90,62,120,12,186,223,145,12,23,244,19,131,249,175
],[
247,214,72,46,116,172,26,254,118,151,202,222,76,246,74,197,160,26,186,38
],[
173,167,57,114,172,61,251,223,143,88,155,104,242,117,179,20,79,119,171,124
],[
113,72,206,135,43,195,163,121,73,210,122,44,199,211,69,156,65,65,169,170
],[
171,144,85,25,66,88,147,221,194,182,28,149,218,240,49,86,221,87,231,170
],[
186,114,195,216,46,88,134,102,56,94,74,221,206,242,206,204,206,199,15,15
],[
55,51,24,81,153,213,26,208,202,122,191,96,219,65,188,179,74,254,166,215
],[
121,221,6,0,95,72,175,136,126,10,79,52,21,180,69,185,150,63,178,127
],[
90,244,211,164,148,137,142,68,132,141,74,248,237,6,4,156,200,88,159,86
],[
58,104,124,211,196,2,75,212,186,120,33,234,246,140,202,125,205,144,96,19
],[
66,204,28,207,122,32,109,56,112,235,71,61,234,43,190,117,172,229,211,171
],[
235,199,142,153,4,12,77,244,110,160,91,169,237,132,196,103,9,117,104,93
],[
191,200,79,69,118,153,60,161,53,36,133,68,18,115,33,21,238,58,3,16
],[
95,255,166,141,238,125,234,197,131,75,30,146,29,185,94,118,198,251,31,223
],[
199,137,8,169,24,197,4,229,26,222,149,217,136,245,107,71,171,127,53,243
]
]