aLevelData = [
[
5,5,3,5,5,5,5,5,5,5,3,5,5,236,34,109,246,145,202,243
],[
4,2,3,5,5,5,5,5,5,5,3,5,5,40,231,66,92,195,220,83
],[
151,1,143,47,101,182,88,95,117,225,8,254,204,129,114,37,107,170,42,166
],[
44,215,140,253,238,130,0,131,241,242,125,229,131,85,76,213,221,14,15,255
],[
72,80,1,63,132,236,127,17,105,103,200,73,207,80,1,4,172,208,124,222
],[
124,131,57,101,230,134,173,206,156,210,195,231,131,200,33,77,20,12,172,223
],[
2,151,78,114,28,8,247,199,118,59,225,186,195,29,25,187,6,191,59,130
],[
106,169,124,255,109,112,238,144,68,139,0,119,123,98,68,139,221,168,118,45
],[
147,235,185,126,144,105,35,208,44,38,124,90,14,59,67,47,80,113,242,113
],[
222,14,132,193,31,239,51,251,216,215,134,32,77,7,139,148,169,15,97,138
],[
159,227,250,188,82,49,31,95,114,242,181,86,168,64,62,166,53,103,163,42
],[
214,62,48,136,234,184,224,99,214,182,219,210,169,31,61,17,252,51,25,119
],[
29,28,190,168,108,198,56,12,4,241,26,128,158,133,123,75,179,37,63,83
],[
225,6,152,145,144,2,203,194,213,232,56,95,151,23,149,208,240,75,122,221
],[
213,182,34,101,250,83,112,82,240,119,48,204,144,169,160,173,157,179,46,53
],[
165,249,132,0,40,10,194,52,253,117,10,255,240,222,66,65,176,80,21,133
],[
233,213,59,54,173,68,251,16,24,91,238,212,52,13,5,64,26,29,205,62
],[
90,236,242,92,157,144,3,124,137,37,116,204,229,104,233,249,254,130,178,160
],[
73,33,145,6,73,205,196,8,179,122,63,85,209,89,58,218,36,244,235,126
],[
77,122,149,16,46,87,193,125,76,8,203,71,119,46,161,50,174,225,200,65
]
]