aLevelData = [
[
4,2,5,5,2,2,2,2,2,2,2,2,2,208,206,88,153,232,186,53
],[
2,2,2,2,2,2,5,2,2,2,5,2,2,95,196,218,243,8,91,157
],[
2,2,2,2,2,2,3,3,3,3,3,3,3,88,24,180,57,203,35,158
],[
3,3,3,3,3,3,3,2,2,2,2,2,3,148,175,216,161,101,239,63
],[
2,2,3,2,2,2,2,2,2,2,2,2,3,52,150,218,63,48,238,50
],[
13,2,3,2,2,2,2,2,2,3,2,2,3,99,133,236,127,222,44,246
],[
2,5,3,2,2,2,2,2,2,3,2,2,3,169,204,93,179,198,186,1
],[
2,12,3,2,2,2,2,2,2,3,2,2,3,181,49,105,106,91,220,207
],[
5,2,3,3,3,3,3,3,3,3,2,2,3,66,245,231,95,193,42,113
],[
11,2,3,2,2,2,2,2,2,2,2,2,2,138,35,151,174,134,90,185
],[
57,78,0,13,172,234,143,117,111,240,212,222,205,75,161,32,77,59,195,37
],[
63,157,51,78,149,109,145,18,244,137,205,233,11,183,40,104,36,234,91,173
],[
248,193,21,253,200,81,171,172,169,36,11,61,32,129,243,203,238,238,96,168
],[
45,244,72,67,156,34,139,79,56,85,40,33,12,54,172,90,73,3,241,199
],[
153,147,4,133,177,148,103,105,37,24,121,158,129,80,50,144,149,150,19,9
],[
16,177,93,154,81,85,130,61,121,234,217,56,197,142,149,69,27,93,248,239
],[
226,240,196,63,23,35,243,152,157,28,167,224,213,137,100,224,111,40,125,238
],[
128,141,204,201,212,32,166,196,133,101,14,39,204,128,41,210,24,248,243,35
],[
93,187,47,26,175,98,164,187,15,183,134,180,133,116,51,64,111,78,32,75
],[
24,50,18,215,140,207,145,158,171,84,153,249,125,123,148,0,197,198,133,243
]
]