aLevelData = [
[
6,2,8,2,9,2,10,2,11,3,2,2,5,2,2,2,5,40,109,164
],[
2,2,2,2,2,2,2,2,12,3,5,2,2,2,5,2,2,221,201,173
],[
2,2,3,3,3,3,3,3,3,3,2,2,3,3,3,3,3,185,90,89
],[
2,2,3,2,2,2,2,2,2,2,5,2,3,2,2,2,2,40,4,137
],[
2,2,3,2,2,2,2,2,2,2,2,2,3,2,2,2,2,224,154,221
],[
2,2,3,2,3,3,3,3,3,3,2,5,3,2,2,2,2,172,167,244
],[
2,2,3,2,2,2,2,5,5,3,2,2,3,2,2,2,2,6,210,145
],[
2,2,3,5,5,5,2,3,3,3,5,2,3,3,3,2,2,91,153,252
],[
2,2,2,2,2,2,2,2,2,2,2,2,5,2,2,2,2,174,116,62
],[
2,3,2,2,3,1,3,2,2,2,2,2,5,2,2,2,2,127,14,223
],[
2,3,2,2,3,2,3,2,2,2,2,5,5,2,2,2,2,161,169,211
],[
2,3,2,3,2,2,2,3,2,2,2,2,5,2,2,2,2,1,36,167
],[
138,7,209,166,188,39,146,57,191,41,164,251,210,39,73,117,106,145,189,66
],[
198,115,108,112,201,251,98,42,9,54,3,148,36,26,252,247,83,201,121,30
],[
65,20,153,0,29,62,30,159,237,3,106,47,38,217,167,123,122,118,69,133
],[
242,146,169,108,60,238,35,147,70,149,33,0,12,98,163,2,174,194,239,23
],[
197,187,134,12,247,46,86,102,201,89,49,1,181,159,126,247,125,140,47,195
],[
190,20,243,167,200,27,172,75,173,59,35,166,152,193,250,33,96,248,227,250
],[
93,171,16,231,123,229,235,253,140,251,6,207,227,204,85,218,30,72,155,33
],[
67,47,34,20,15,27,175,182,138,193,181,255,223,116,201,127,107,235,86,69
]
]