aLevelData = [
[
12,2,2,2,2,2,2,2,2,2,2,2,2,2,2,2,54,162,231,103
],[
2,2,2,2,2,2,2,2,2,2,2,2,13,2,2,2,44,125,88,77
],[
2,2,3,3,3,3,3,3,3,3,2,3,3,3,2,3,12,103,65,222
],[
11,2,3,2,2,2,2,2,2,3,2,3,2,3,2,3,185,128,210,214
],[
2,2,3,2,2,2,2,2,2,3,2,3,2,3,2,3,14,11,212,47
],[
2,2,3,2,2,2,2,2,2,3,2,3,2,3,2,3,45,113,151,68
],[
10,2,3,2,2,2,2,2,2,2,2,2,2,2,2,2,20,137,43,54
],[
2,2,3,2,2,2,2,2,3,3,3,3,3,2,2,2,114,22,210,143
],[
2,2,3,2,2,2,2,3,2,2,2,2,1,3,2,2,184,146,182,37
],[
9,2,3,2,2,2,2,3,2,2,2,2,2,2,3,2,114,42,216,66
],[
2,2,3,2,2,2,3,2,2,2,2,2,2,2,2,3,216,9,73,1
],[
160,217,156,251,23,135,155,35,112,71,57,239,92,217,200,185,219,10,108,100
],[
81,125,208,66,220,171,23,53,229,41,22,21,245,42,192,82,202,68,225,219
],[
171,119,16,62,248,107,222,16,5,249,84,143,40,237,157,134,17,10,255,113
],[
90,79,16,226,95,121,38,35,80,201,15,29,133,7,2,120,17,199,214,4
],[
153,235,114,88,103,105,133,185,186,79,119,61,96,4,159,47,135,208,182,182
],[
209,158,139,178,166,1,249,231,206,118,22,93,63,233,174,6,51,122,240,162
],[
126,128,102,224,31,206,43,198,21,54,88,82,116,76,191,98,183,108,220,209
],[
88,255,8,227,158,249,240,227,183,166,70,10,6,167,182,163,190,56,28,109
],[
176,180,244,65,97,90,17,244,96,81,147,127,214,234,19,93,95,38,32,53
]
]