aLevelData = [
[
6,2,8,2,9,143,43,48,3,145,197,196,104,73,45,23,4,238,17,54
],[
2,2,2,2,2,135,4,50,236,94,210,10,217,122,23,177,196,84,249,1
],[
2,2,3,3,3,51,46,62,249,56,155,190,95,141,65,24,169,227,222,165
],[
2,2,3,2,2,30,120,137,170,57,232,59,210,78,69,141,219,111,105,195
],[
2,2,3,2,2,143,145,139,10,246,235,17,254,202,159,165,111,43,156,139
],[
2,2,3,2,3,101,148,195,50,97,14,73,9,230,163,92,147,56,22,9
],[
2,2,3,2,2,190,100,209,93,113,128,31,202,100,52,155,205,52,122,233
],[
2,2,3,5,5,206,183,161,163,72,141,152,150,41,247,105,47,124,236,4
],[
2,2,2,2,2,48,69,106,62,167,172,11,25,33,94,216,70,27,49,97
],[
2,3,2,2,3,232,185,7,14,155,187,244,176,181,172,163,91,204,92,245
],[
2,3,2,2,3,120,120,145,236,22,89,250,200,129,92,100,111,22,59,48
],[
2,3,2,3,2,18,85,67,5,14,56,90,194,16,195,64,183,125,221,21
],[
2,3,2,3,2,20,17,94,28,161,198,105,190,176,247,252,210,81,197,197
],[
2,3,2,3,2,27,196,186,56,18,52,172,222,230,162,228,240,194,31,128
],[
2,3,2,3,2,36,78,62,22,199,120,201,154,12,116,179,130,164,1,78
],[
2,3,2,3,2,39,142,239,190,111,49,222,174,169,168,72,65,184,93,194
],[
2,3,2,3,2,75,116,217,126,194,77,218,21,111,50,166,131,233,177,160
],[
115,196,95,25,190,6,122,104,46,218,205,61,135,137,212,50,200,165,33,163
],[
174,136,254,192,122,253,84,224,244,60,203,25,176,28,51,13,144,132,35,6
],[
138,34,223,70,171,96,127,152,92,148,78,43,229,119,113,160,47,217,201,98
]
]