aLevelData = [
[
4,2,2,2,2,2,2,2,2,2,8,2,2,2,48,122,54,104,18,0
],[
2,2,3,2,9,2,2,2,2,2,2,2,2,3,101,223,228,41,71,89
],[
2,3,2,2,2,2,3,2,2,3,2,3,2,2,82,132,135,231,0,183
],[
2,3,2,2,2,3,2,2,3,2,2,2,3,2,129,132,202,182,166,234
],[
2,3,2,2,3,2,2,3,2,2,2,2,2,3,80,57,34,171,178,108
],[
2,3,2,3,2,2,3,2,2,3,2,3,2,2,189,124,152,232,255,212
],[
2,2,3,2,2,3,2,2,3,2,2,2,3,2,118,226,152,182,14,162
],[
2,2,2,2,3,2,2,3,2,2,2,2,2,3,255,202,54,55,88,179
],[
2,2,2,3,2,2,3,2,2,3,2,3,2,2,219,106,155,157,70,240
],[
2,2,3,2,2,3,2,2,3,2,2,2,3,2,243,21,158,228,100,30
],[
2,2,5,2,3,2,2,3,2,2,2,2,2,3,174,116,177,129,233,218
],[
125,100,171,142,176,30,194,185,28,74,45,237,97,26,35,20,13,239,88,167
],[
8,38,123,33,48,52,3,178,64,245,43,55,246,65,59,106,117,193,10,86
],[
232,0,193,15,104,197,225,159,32,161,136,67,174,196,240,216,205,20,56,144
],[
49,129,103,233,179,146,174,224,174,68,237,97,169,21,121,3,54,92,29,242
],[
25,219,94,44,173,151,3,241,132,232,213,116,78,204,164,215,252,128,138,86
],[
37,82,116,195,168,177,221,50,147,134,221,245,67,199,99,203,205,72,190,84
],[
157,213,99,200,93,127,234,233,25,51,89,54,160,145,165,98,45,250,118,4
],[
70,235,43,144,229,138,30,134,214,127,41,233,96,5,105,243,39,65,65,7
],[
81,210,162,231,232,169,138,39,127,27,203,226,25,52,14,171,70,79,23,198
]
]