aLevelData = [
[
10,2,2,8,2,2,2,2,2,2,2,2,172,177,65,38,106,186,163,199
],[
2,2,2,2,2,2,2,2,2,2,2,2,113,37,29,107,148,208,37,124
],[
2,2,2,2,2,2,3,3,3,3,2,2,37,16,199,166,174,155,248,223
],[
9,2,2,2,2,2,2,2,2,3,2,2,225,166,40,165,210,74,22,135
],[
3,3,3,3,3,3,3,2,2,3,2,2,100,44,232,231,1,93,123,254
],[
2,2,2,2,2,2,2,2,2,3,2,2,143,127,248,33,159,42,168,66
],[
2,2,2,2,2,2,2,2,2,3,3,2,231,142,9,185,242,89,33,69
],[
2,2,2,2,2,2,2,2,2,2,3,2,22,219,18,77,167,103,239,108
],[
2,2,2,2,2,2,2,2,2,2,3,2,106,253,206,45,76,39,30,19
],[
2,2,2,2,3,3,3,3,2,2,3,2,84,33,59,221,215,60,64,7
],[
2,2,2,2,3,2,2,3,2,2,3,2,235,132,29,148,29,161,233,11
],[
2,2,2,2,3,2,2,3,2,2,3,3,103,251,121,192,92,34,49,84
],[
2,2,2,2,3,2,2,3,2,2,2,2,166,108,26,127,178,224,53,13
],[
2,2,2,2,3,2,2,3,2,2,2,2,170,82,15,39,164,208,150,212
],[
2,2,2,2,3,2,2,3,2,2,2,2,25,61,43,192,152,60,248,59
],[
2,2,2,2,3,2,2,3,2,2,2,2,187,80,132,132,91,65,132,72
],[
2,2,2,2,3,2,2,3,2,2,2,2,0,193,245,102,155,79,103,245
],[
2,2,2,2,3,2,2,3,2,2,2,2,120,92,156,136,110,172,81,176
],[
3,3,3,3,3,2,2,3,3,2,2,2,89,0,92,195,202,242,247,220
],[
2,2,1,2,2,2,2,2,2,2,2,2,252,32,92,35,10,140,146,79
]
]