aLevelData = [
[
6,2,2,2,2,2,74,141,240,48,101,87,126,7,165,140,63,227,241,72
],[
2,2,2,2,2,2,112,96,135,158,104,203,146,221,203,132,254,17,1,166
],[
2,2,2,2,2,2,139,205,230,234,32,40,195,201,99,6,126,225,134,153
],[
3,3,3,3,3,3,13,154,99,39,48,9,204,13,96,21,28,4,2,216
],[
2,2,2,2,2,2,18,163,225,72,224,37,219,22,126,109,219,214,68,71
],[
2,2,2,2,2,2,7,97,184,241,58,119,165,218,180,169,109,169,16,118
],[
2,2,2,2,2,3,159,129,119,181,204,131,20,51,151,149,199,156,12,98
],[
2,2,3,3,3,3,30,159,51,162,129,77,228,156,172,194,220,233,99,8
],[
2,2,2,2,2,2,17,122,96,56,67,221,145,226,212,187,128,175,217,166
],[
19,69,113,17,117,107,86,160,84,110,177,163,77,195,51,221,164,237,97,137
],[
57,162,47,159,183,41,209,83,15,6,206,222,37,217,86,130,200,132,213,200
],[
232,140,200,13,3,194,208,60,225,34,4,221,129,251,140,79,83,80,108,81
],[
168,126,157,200,102,32,98,188,0,48,217,163,165,111,208,226,184,6,219,145
],[
129,109,163,126,34,140,129,117,204,32,76,191,50,97,111,233,62,226,62,199
],[
3,184,138,183,244,222,114,42,83,216,125,97,236,151,230,117,2,157,55,154
],[
138,97,25,164,151,245,107,203,22,230,145,171,187,100,15,143,59,162,86,238
],[
188,128,221,54,137,104,116,201,11,117,214,69,245,219,125,9,190,131,186,245
],[
84,245,4,112,15,123,145,176,227,131,35,54,219,70,37,151,194,167,246,130
],[
35,94,133,255,117,85,30,245,143,82,131,239,98,215,63,31,230,71,55,164
],[
85,73,130,8,152,113,122,13,254,30,19,169,52,158,108,79,114,153,164,112
]
]