aLevelData = [
[
5,5,3,5,113,145,162,82,15,28,22,248,80,4,162,199,206,6,97,119
],[
51,188,216,144,180,17,144,128,219,248,3,234,138,94,189,66,61,92,187,151
],[
143,178,23,175,0,113,231,89,245,247,98,255,0,32,68,123,98,187,116,43
],[
206,59,228,72,112,175,185,115,46,245,173,145,46,42,177,217,152,100,214,43
],[
157,164,109,164,184,6,109,111,51,59,22,222,238,57,212,185,92,49,102,214
],[
206,194,63,233,244,108,45,158,160,71,56,229,206,245,205,141,226,213,28,21
],[
48,121,190,191,193,91,155,229,84,203,11,144,164,44,59,71,233,96,211,37
],[
161,129,213,47,144,210,200,228,6,245,23,21,96,94,180,246,209,7,0,118
],[
99,101,239,204,56,156,103,82,22,239,234,151,35,122,117,175,236,35,168,206
],[
172,206,38,22,204,208,63,172,166,166,205,17,142,232,91,176,19,120,141,179
],[
130,255,188,27,172,154,224,16,233,208,179,117,93,200,19,192,122,184,168,9
],[
198,161,200,96,223,58,151,100,188,41,115,18,53,121,143,218,198,73,221,248
],[
144,193,50,1,160,75,165,188,116,255,56,52,187,94,186,11,93,68,235,17
],[
187,24,226,21,56,70,172,252,248,239,54,16,232,223,108,154,254,191,163,178
],[
194,139,52,86,13,71,106,186,16,238,159,223,153,172,161,103,146,76,91,168
],[
202,244,177,255,249,16,171,102,254,140,214,73,106,70,231,150,66,195,162,20
],[
1,33,250,245,221,76,122,174,75,117,227,6,197,192,23,109,203,61,53,144
],[
40,26,6,42,118,23,152,29,228,57,40,193,55,195,69,124,15,98,51,147
],[
108,168,142,63,112,187,47,4,103,79,84,62,4,209,250,253,237,229,142,18
],[
123,19,197,106,186,189,201,155,184,85,149,189,252,205,162,123,84,78,195,105
]
]