aLevelData = [
[
4,2,2,2,2,2,2,2,2,2,2,2,191,31,244,71,198,18,67,30
],[
5,2,5,3,2,2,2,2,2,2,2,2,55,36,33,143,6,136,192,144
],[
2,5,5,3,3,3,3,3,3,3,3,3,169,239,224,115,121,89,80,90
],[
3,3,5,5,5,5,5,5,5,5,3,2,92,42,178,240,161,128,128,91
],[
2,3,5,5,5,5,5,5,5,5,3,6,43,196,76,108,210,127,76,25
],[
3,3,5,5,5,5,3,3,3,3,3,3,6,111,21,46,181,219,167,63
],[
3,5,5,5,5,5,3,2,2,2,2,2,111,35,170,225,201,155,247,26
],[
3,5,5,3,3,3,3,8,2,2,2,5,255,153,90,21,221,205,150,26
],[
3,5,5,3,2,2,3,3,3,3,2,5,223,209,170,190,151,1,83,87
],[
3,5,5,3,2,2,2,2,2,3,2,5,79,141,210,179,240,205,239,10
],[
3,5,5,3,2,2,3,2,2,3,2,5,34,212,62,48,181,71,161,15
],[
5,5,5,3,2,2,3,2,2,3,2,5,64,112,14,85,7,142,147,106
],[
5,5,5,3,2,2,3,2,2,3,2,5,34,111,151,165,220,65,98,191
],[
5,3,3,3,2,2,3,2,2,3,2,5,90,166,224,136,125,6,161,216
],[
5,3,2,2,2,2,3,2,2,3,2,5,8,41,37,201,6,5,87,35
],[
5,3,3,2,2,2,3,2,5,5,5,5,102,212,87,24,233,106,124,50
],[
5,5,3,3,2,2,3,2,5,3,5,5,62,198,154,137,107,231,128,57
],[
110,225,197,19,36,47,197,147,107,75,230,18,131,124,32,61,187,239,188,198
],[
73,10,91,90,121,253,59,210,10,154,182,173,212,102,11,190,175,240,97,34
],[
145,97,9,117,246,85,4,69,133,233,197,199,240,21,55,201,28,61,2,232
]
]