aLevelData = [
[
6,2,8,2,9,2,10,2,115,33,40,79,217,40,163,110,7,58,219,193
],[
2,2,2,2,2,2,2,2,96,124,109,61,145,54,148,5,199,54,250,232
],[
2,2,3,3,3,3,3,3,30,111,206,42,92,230,23,135,223,207,72,117
],[
2,2,3,2,2,2,2,2,212,242,20,170,170,84,131,222,198,20,70,210
],[
2,2,3,2,2,2,2,2,121,147,72,145,47,215,133,245,233,50,31,110
],[
2,2,3,2,3,3,3,3,237,30,174,255,187,108,216,137,68,158,35,76
],[
2,2,3,2,2,2,2,5,87,145,6,171,92,95,70,47,68,131,128,207
],[
192,62,1,111,177,58,222,166,224,110,66,196,240,65,2,20,145,242,119,94
],[
246,55,140,176,136,36,22,94,220,79,100,72,226,50,23,91,96,208,52,91
],[
159,156,120,223,101,150,236,157,34,183,185,231,110,143,60,118,179,45,93,103
],[
39,63,29,131,254,122,111,195,221,60,73,19,145,112,250,87,1,179,190,172
],[
97,180,144,240,169,225,63,132,70,64,196,80,15,154,211,8,122,223,176,174
],[
16,198,68,89,30,180,112,52,174,223,161,201,181,179,165,128,142,117,189,98
],[
167,38,243,35,123,170,173,96,192,41,131,37,225,182,78,178,174,46,129,127
],[
83,99,189,125,134,122,159,159,5,146,221,153,64,167,145,232,82,181,212,18
],[
54,32,143,47,56,83,142,168,169,167,214,63,215,135,57,79,61,211,39,85
],[
246,129,199,176,120,138,70,165,126,4,112,166,70,139,125,212,253,230,45,194
],[
120,232,23,124,36,147,61,200,64,132,229,171,73,139,164,47,182,153,188,100
],[
230,223,168,165,87,52,244,28,24,183,82,137,129,182,235,62,33,207,243,110
],[
248,85,128,168,230,246,156,159,100,154,152,44,114,141,164,150,208,225,157,16
]
]