aLevelData = [
[
2,2,2,5,2,2,2,5,2,16,15,156,135,132,7,0,190,245,171,110
],[
2,2,2,2,2,5,2,2,2,163,247,209,183,212,128,36,42,117,240,26
],[
2,2,3,3,3,3,3,3,3,181,201,80,39,78,3,215,49,145,89,179
],[
2,3,2,2,2,2,2,2,2,67,171,91,6,133,118,131,46,108,229,13
],[
2,3,2,2,2,2,2,2,2,73,46,163,8,248,121,247,174,100,100,235
],[
2,2,2,2,2,5,5,5,5,241,127,166,173,86,141,5,53,6,226,18
],[
2,2,3,3,3,3,2,3,2,40,35,237,20,253,88,117,66,94,180,35
],[
2,2,3,2,2,3,2,3,2,53,209,184,65,156,151,174,193,50,212,61
],[
2,2,3,2,2,3,2,3,2,129,237,241,59,205,120,63,194,38,228,221
],[
4,2,3,2,2,3,2,3,2,134,65,155,219,101,83,149,159,64,140,206
],[
2,2,3,3,3,2,2,3,2,136,10,225,247,210,30,15,107,186,214,221
],[
2,2,3,2,3,2,2,3,2,102,226,89,161,113,246,180,5,33,144,45
],[
2,2,3,2,3,2,2,3,2,11,1,89,211,79,205,114,90,141,225,18
],[
2,2,3,2,2,3,2,3,2,38,98,240,112,166,87,249,227,227,27,119
],[
2,2,3,2,2,3,2,3,2,71,89,16,217,164,5,9,49,10,191,83
],[
2,2,2,2,2,5,5,5,5,48,191,202,242,82,157,170,44,86,181,53
],[
76,241,56,237,160,195,152,141,196,138,234,226,34,150,143,220,186,125,19,229
],[
31,15,85,113,194,140,232,215,115,21,186,95,37,97,243,156,242,177,32,252
],[
95,6,145,157,224,145,255,98,159,107,115,71,121,134,98,241,73,228,29,138
],[
106,6,105,203,119,168,105,90,85,171,197,87,116,83,5,49,81,178,62,191
]
]