aLevelData = [
[
6,2,8,2,9,2,10,2,11,3,2,2,5,2,2,2,5,2,101,45
],[
2,2,2,2,2,2,2,2,12,3,5,2,2,2,5,2,2,2,63,181
],[
2,2,3,3,3,3,3,3,3,3,2,2,3,3,3,3,3,3,129,9
],[
2,2,3,2,2,2,2,2,2,2,5,2,3,2,2,2,2,3,91,148
],[
2,2,3,2,2,2,2,2,2,2,2,2,3,2,2,2,2,3,138,54
],[
2,2,3,2,3,3,3,3,3,3,2,5,3,2,2,2,2,2,56,18
],[
2,2,3,2,2,2,2,5,5,3,2,2,3,2,2,2,2,2,20,202
],[
2,2,3,5,5,5,2,3,3,3,5,2,3,3,3,2,2,3,38,139
],[
2,2,2,2,2,2,2,2,2,2,2,2,5,2,2,2,2,5,28,159
],[
2,3,2,2,3,1,3,2,2,2,2,2,5,2,2,2,2,5,35,92
],[
2,3,2,2,3,2,3,2,2,2,2,5,5,2,2,2,2,5,152,159
],[
2,3,2,3,2,2,2,3,2,2,2,2,5,2,2,2,2,5,7,71
],[
2,3,2,3,2,2,2,3,3,3,2,2,3,3,3,2,2,3,81,63
],[
2,3,2,3,2,2,2,3,2,2,5,2,5,2,2,2,2,5,254,25
],[
2,3,2,3,2,2,3,3,2,2,2,2,5,2,2,2,2,5,245,74
],[
2,3,2,3,2,2,3,3,2,2,2,5,5,2,2,2,2,5,59,137
],[
104,224,235,100,92,190,104,231,33,192,176,108,190,163,21,74,64,16,54,246
],[
82,214,45,110,14,120,10,215,19,231,129,100,216,144,223,123,64,153,66,19
],[
110,104,10,97,218,102,139,179,164,2,4,156,41,248,213,81,213,211,236,83
],[
56,176,129,78,91,70,3,65,84,35,82,224,24,56,46,55,145,152,240,143
]
]