aLevelData = [
[
2,2,2,2,5,5,2,2,2,2,2,2,2,2,2,2,69,105,215,108
],[
193,117,109,185,233,17,162,67,15,146,130,183,189,174,0,9,166,154,140,184
],[
219,111,232,83,66,210,55,60,69,212,87,172,199,23,112,247,92,51,205,17
],[
185,87,235,81,105,52,208,118,194,22,158,232,24,84,104,64,48,235,68,9
],[
247,102,162,200,116,1,220,59,252,13,14,223,165,150,39,180,253,68,64,68
],[
251,127,45,226,53,214,82,48,84,162,184,228,197,230,97,203,178,122,216,14
],[
49,105,11,180,187,151,93,104,223,167,248,124,55,27,96,47,156,189,78,43
],[
150,62,187,82,22,30,59,186,104,203,140,246,99,13,111,152,227,161,182,243
],[
121,37,159,38,96,52,96,86,179,209,3,58,222,9,116,221,83,212,217,159
],[
126,61,33,125,250,194,224,147,5,254,90,223,49,133,221,72,93,16,85,223
],[
228,218,26,100,20,73,12,12,226,209,226,129,219,22,191,43,94,80,6,174
],[
9,244,112,180,113,145,92,236,22,247,102,83,150,159,58,178,32,71,171,103
],[
44,221,255,105,105,158,141,135,247,127,139,240,215,204,33,248,160,15,193,25
],[
115,51,187,56,48,233,12,42,234,75,119,119,153,191,216,94,15,31,180,25
],[
46,23,20,98,87,206,148,53,37,200,183,216,92,11,125,25,28,128,56,215
],[
91,157,155,195,146,65,20,104,181,223,92,105,105,223,76,10,114,65,242,242
],[
106,132,228,48,185,198,212,123,193,44,101,190,89,132,61,212,125,41,91,143
],[
67,39,171,0,17,160,216,242,14,111,98,184,214,10,240,41,114,173,231,232
],[
135,181,59,233,205,74,134,48,195,64,87,220,162,63,204,101,143,34,99,34
],[
20,158,13,14,209,36,132,203,111,8,223,231,214,226,100,95,160,53,157,97
]
]