aLevelData = [
[
12,2,2,2,2,2,2,2,2,2,2,111,134,111,154,17,179,232,108,42
],[
2,2,2,2,2,2,2,2,2,2,2,0,127,105,38,115,51,108,6,91
],[
2,2,3,3,3,3,3,3,3,3,2,35,226,16,54,232,209,196,209,40
],[
11,2,3,2,2,2,2,2,2,3,2,26,19,177,104,251,204,178,34,215
],[
87,238,24,58,165,224,231,24,103,202,223,85,126,83,18,138,179,117,171,7
],[
169,150,130,20,15,245,237,125,26,72,216,77,51,164,24,217,237,156,252,0
],[
57,173,37,178,221,218,152,175,34,147,18,145,205,219,156,13,81,170,94,118
],[
67,144,184,130,14,156,143,81,232,124,229,171,5,229,173,138,10,54,221,216
],[
196,88,196,121,26,232,158,140,64,152,102,238,46,210,235,0,81,159,38,171
],[
128,200,203,161,49,59,30,229,237,175,8,141,1,139,106,199,119,4,177,26
],[
68,134,171,238,195,86,153,79,98,117,133,238,156,199,213,104,39,116,33,203
],[
110,143,66,87,65,246,171,129,203,121,253,62,197,62,213,125,234,99,232,245
],[
171,230,83,34,35,194,44,138,77,91,93,69,117,28,178,188,236,95,48,177
],[
0,141,169,128,43,134,141,164,139,67,3,124,146,186,56,79,255,1,247,143
],[
13,183,123,90,234,160,129,70,106,143,161,94,253,137,221,104,223,39,123,106
],[
142,60,16,108,129,184,222,126,23,204,95,253,206,79,34,19,181,97,214,125
],[
36,78,165,145,170,181,195,127,71,233,70,215,219,151,56,75,223,169,234,183
],[
83,107,140,94,247,236,251,118,190,168,218,232,128,99,228,81,239,88,128,76
],[
204,147,150,243,91,156,162,163,20,85,7,0,155,37,165,57,242,86,173,142
],[
238,188,180,15,231,152,7,166,180,187,63,87,214,239,21,199,244,146,119,251
]
]