aLevelData = [
[
2,2,3,3,3,3,3,3,3,3,3,3,3,3,3,139,164,159,203,32
],[
2,2,2,2,2,2,2,2,2,2,2,2,2,2,2,3,102,5,1,246
],[
3,2,3,3,3,3,3,3,3,3,3,2,3,3,3,7,245,250,236,197
],[
2,2,2,2,2,2,2,2,2,2,2,2,2,2,3,30,150,18,167,187
],[
3,2,3,3,3,3,3,3,3,3,3,3,3,2,3,52,25,43,163,93
],[
2,2,3,2,2,2,2,2,2,2,2,2,3,2,3,57,57,112,85,118
],[
3,2,3,2,2,3,3,3,3,3,3,3,3,2,3,86,224,240,34,26
],[
2,2,3,2,2,3,2,2,2,2,2,3,3,2,3,124,167,163,228,119
],[
2,3,3,2,2,3,3,3,3,2,2,2,2,2,3,235,118,204,216,186
],[
2,2,2,2,2,2,2,2,2,3,2,3,2,2,3,116,217,220,111,84
],[
3,3,3,3,2,2,2,2,2,3,2,3,2,2,3,117,149,222,114,29
],[
8,2,6,3,2,3,3,3,3,3,2,3,2,2,3,216,160,206,93,86
],[
2,2,2,3,2,3,2,2,2,3,2,3,2,2,3,172,88,252,9,39
],[
2,2,2,2,2,3,2,2,2,3,2,3,3,3,3,107,116,210,126,151
],[
2,2,2,2,2,3,2,2,2,3,2,2,2,2,2,164,96,177,163,201
],[
9,2,12,3,2,2,2,2,3,2,3,3,3,3,3,83,242,210,171,161
],[
2,2,2,3,2,3,3,3,3,2,3,2,2,2,3,110,102,20,57,107
],[
2,2,2,3,2,2,2,2,3,13,3,1,2,2,3,99,134,231,147,149
],[
45,120,143,212,19,30,216,135,147,22,202,103,16,135,251,134,231,174,202,143
],[
161,56,59,79,110,239,2,116,207,153,221,149,146,29,39,115,3,232,171,127
]
]