aLevelData = [
[
2,2,2,2,2,11,2,2,2,2,2,2,2,2,9,2,2,41,242,5
],[
2,2,2,2,2,2,2,2,2,2,2,2,2,2,2,2,2,55,82,28
],[
5,2,5,2,5,5,5,2,5,5,5,2,5,5,5,2,5,223,224,241
],[
5,2,5,2,5,2,5,2,5,2,5,2,5,2,5,2,2,173,31,140
],[
5,5,5,2,5,5,5,2,5,5,5,2,5,5,5,2,2,233,17,76
],[
5,2,5,2,5,2,5,2,5,2,2,2,5,2,2,2,2,54,152,64
],[
5,2,5,2,5,2,5,2,5,2,2,2,5,2,2,2,5,84,164,252
],[
2,2,2,12,2,2,2,2,2,2,2,2,2,10,2,2,2,74,208,154
],[
2,2,7,2,2,2,2,2,8,2,2,2,2,2,2,2,7,26,51,138
],[
2,2,7,2,5,5,5,2,5,5,5,2,5,5,2,2,7,77,160,2
],[
60,26,201,21,155,120,129,183,148,44,202,245,214,188,94,173,144,37,149,231
],[
124,208,138,104,28,195,121,133,68,21,108,54,216,164,23,107,215,10,0,163
],[
152,204,227,186,84,213,84,2,229,35,166,150,205,193,12,235,122,245,254,168
],[
201,186,222,184,200,112,220,157,192,211,23,7,115,42,4,165,162,192,20,59
],[
210,152,145,245,80,93,201,251,115,152,111,69,33,38,62,177,148,232,223,82
],[
94,188,13,11,171,172,247,93,199,102,230,126,224,236,31,171,12,141,11,190
],[
142,20,149,3,85,63,212,72,197,115,234,51,186,173,44,217,202,188,131,139
],[
203,174,17,243,149,136,24,97,9,58,24,95,83,209,56,139,107,239,231,166
],[
226,120,195,232,219,143,186,150,88,193,111,215,183,127,223,196,124,210,68,190
],[
80,74,58,4,74,56,32,132,110,28,193,242,115,97,51,24,202,72,0,109
]
]