aLevelData = [
[
2,2,2,2,5,5,2,2,175,225,139,60,202,52,235,88,10,247,85,58
],[
2,2,2,4,2,2,2,2,61,19,36,170,154,48,106,60,248,30,204,210
],[
5,3,3,3,5,5,3,3,62,115,148,98,27,118,1,249,247,60,225,0
],[
2,3,2,2,2,2,2,2,41,17,98,191,106,26,38,31,137,56,149,180
],[
2,3,2,2,2,2,2,2,97,46,119,250,9,7,194,223,74,178,176,130
],[
2,3,2,2,3,2,2,2,86,240,21,59,182,112,240,219,133,55,64,53
],[
2,3,2,2,3,2,2,2,220,70,25,221,141,119,246,47,20,169,81,147
],[
2,3,2,2,3,5,5,3,202,28,113,0,92,30,132,191,124,232,237,114
],[
2,3,3,2,3,2,2,3,214,195,223,84,70,111,43,194,72,196,86,251
],[
2,2,3,2,3,2,2,3,176,154,239,36,155,231,31,143,165,39,130,60
],[
2,2,3,2,3,2,2,3,92,1,53,160,245,39,49,166,62,126,215,244
],[
2,2,3,2,3,2,2,3,212,127,203,111,150,221,6,1,89,103,39,154
],[
222,49,10,116,1,238,156,156,50,161,238,174,41,117,136,223,214,232,255,65
],[
151,47,202,67,174,214,81,119,242,168,71,153,196,206,58,204,69,59,104,38
],[
199,71,213,111,129,153,154,38,134,75,128,197,248,73,205,71,120,250,94,230
],[
226,35,246,41,55,8,214,30,219,212,142,228,1,58,18,109,99,93,16,130
],[
54,237,129,8,93,147,127,129,221,144,86,214,145,161,221,83,31,37,7,243
],[
42,129,181,222,201,196,206,48,56,135,146,252,206,24,43,145,47,215,133,251
],[
195,223,96,205,103,233,164,30,98,110,244,210,154,12,133,27,8,43,49,62
],[
105,224,199,155,54,18,166,232,215,219,138,189,20,48,165,85,204,197,242,147
]
]