aLevelData = [
[
2,2,2,2,2,2,2,2,2,2,2,2,2,2,2,2,2,2,2,4
],[
2,2,2,2,2,2,2,2,2,2,2,2,2,2,2,2,2,2,2,2
],[
2,2,2,2,2,2,2,2,2,2,2,2,2,2,2,2,2,2,2,2
],[
2,2,2,3,3,3,3,3,3,3,3,3,3,3,3,3,3,3,2,2
],[
2,2,2,2,2,2,2,2,2,2,2,2,2,2,2,2,2,2,2,2
],[
2,2,2,2,2,2,2,2,2,2,2,2,2,2,2,2,2,2,2,2
],[
2,2,2,2,2,3,2,2,3,2,2,3,2,2,2,3,2,2,3,2
],[
2,2,2,3,3,3,3,3,3,3,3,3,3,3,3,3,3,3,3,3
],[
2,2,2,2,2,2,2,2,2,2,2,2,2,2,2,2,2,2,2,2
],[
2,2,2,2,2,2,2,2,2,2,2,2,2,2,2,2,2,2,2,2
],[
2,2,3,3,3,3,3,3,3,3,3,3,3,3,3,3,3,3,2,2
],[
2,2,2,2,2,2,2,2,2,2,2,2,2,2,2,2,2,3,2,2
],[
2,2,2,2,2,2,2,2,2,2,2,2,2,2,2,2,2,3,2,2
],[
93,129,63,183,163,147,148,78,90,59,123,62,225,231,249,132,12,169,34,248
],[
39,50,57,221,56,254,24,183,133,204,210,92,86,81,152,78,252,45,217,72
],[
18,30,173,23,3,116,116,171,205,197,186,110,4,225,95,213,25,8,244,52
],[
220,91,103,214,64,145,227,77,94,235,242,7,189,106,229,34,209,63,117,129
],[
193,131,170,32,110,40,252,164,176,48,185,55,226,28,166,146,162,168,233,91
],[
210,181,38,178,226,135,233,7,82,48,68,46,114,76,185,181,109,239,89,117
],[
133,220,46,103,160,248,215,185,4,254,114,33,95,115,191,114,10,221,129,109
]
]