aLevelData = [
[
10,2,2,8,2,2,2,2,2,2,2,2,2,2,2,2,2,2,2,128
],[
2,2,2,2,2,2,2,2,2,2,2,2,2,2,2,2,2,2,2,119
],[
2,2,2,2,2,2,3,3,3,3,2,2,2,2,2,3,3,3,2,240
],[
9,2,2,2,2,2,2,2,2,3,2,2,2,2,2,3,2,2,2,216
],[
220,137,132,1,236,243,186,63,214,141,31,183,179,98,161,115,251,86,161,30
],[
61,12,73,8,20,6,32,113,86,14,219,3,142,213,119,160,173,219,132,94
],[
252,142,196,208,85,182,244,136,147,16,234,217,71,57,224,226,173,206,16,199
],[
222,210,129,66,70,80,32,91,89,65,18,115,130,175,73,135,92,27,85,179
],[
37,29,125,245,112,74,15,52,25,90,244,129,126,139,135,156,236,64,168,186
],[
88,238,11,133,80,56,214,101,49,89,108,254,153,195,131,250,31,5,125,8
],[
66,242,245,36,160,0,152,26,105,238,54,69,18,170,24,157,78,113,149,241
],[
58,56,224,112,215,75,36,110,190,52,211,101,15,222,59,58,171,250,90,194
],[
163,162,243,133,240,60,225,194,100,162,172,179,224,128,90,17,200,253,135,219
],[
180,157,184,84,104,101,237,75,7,65,117,158,131,164,6,1,88,110,13,252
],[
122,18,67,51,139,248,129,234,82,32,213,200,105,9,213,219,53,209,51,221
],[
27,157,146,182,241,59,152,65,179,6,69,83,120,10,131,250,164,105,254,2
],[
94,254,53,190,69,63,210,5,94,104,54,122,81,214,89,16,214,176,209,206
],[
106,205,48,208,70,210,147,143,145,155,120,98,213,221,208,68,176,9,86,215
],[
204,115,30,169,16,179,113,182,24,75,216,47,227,139,119,122,204,178,156,122
],[
188,86,152,16,157,6,206,226,18,45,9,91,101,57,19,243,193,253,131,176
]
]