aLevelData = [
[
2,2,2,2,2,2,2,2,2,2,2,2,2,2,2,128,149,9,198,184
],[
2,2,2,2,2,2,2,2,2,2,2,2,2,2,2,22,78,221,248,2
],[
2,2,2,2,2,2,2,2,2,2,2,2,2,2,2,196,19,214,41,71
],[
220,195,203,107,142,141,9,30,116,40,154,136,29,173,191,54,250,163,121,120
],[
41,126,249,7,139,101,88,235,28,56,136,156,132,210,139,104,233,139,226,20
],[
8,1,73,198,132,25,161,35,125,64,46,180,101,247,2,142,15,142,185,50
],[
9,47,103,178,44,31,207,21,113,65,214,253,7,220,55,135,162,157,119,115
],[
21,224,28,133,35,43,26,42,146,251,142,95,130,196,174,207,253,51,0,59
],[
207,182,203,31,152,62,204,147,31,68,41,111,233,10,171,178,11,35,39,37
],[
60,53,61,59,46,254,69,60,31,149,135,162,171,242,170,196,228,177,112,177
],[
164,19,160,95,34,70,67,5,196,230,18,197,52,195,48,142,182,229,21,65
],[
185,205,202,18,171,254,92,50,18,188,139,171,217,20,194,139,231,28,76,68
],[
247,124,196,83,163,45,205,32,193,129,4,37,243,100,51,83,122,225,200,177
],[
75,232,133,71,101,78,120,58,97,21,46,56,75,238,36,22,176,252,126,184
],[
248,219,251,50,246,225,41,44,190,163,213,139,183,187,198,78,241,201,171,181
],[
184,184,81,169,105,67,25,88,132,183,170,32,3,250,227,174,234,204,19,103
],[
32,77,109,6,125,191,182,135,36,142,65,69,19,141,29,95,248,131,141,95
],[
70,230,184,30,137,230,162,226,247,174,91,202,71,230,119,108,198,124,189,188
],[
167,164,36,48,154,29,251,33,161,182,103,117,31,18,18,123,50,168,34,22
],[
67,13,104,30,220,118,218,3,185,121,68,179,33,19,58,190,119,239,81,184
]
]