aLevelData = [
[
2,2,2,5,2,2,2,5,2,2,2,5,2,69,94,39,190,149,233,87
],[
2,2,2,2,2,5,2,2,2,5,2,2,2,2,144,233,198,165,20,79
],[
2,2,3,3,3,3,3,3,3,3,3,3,3,243,59,59,103,79,130,149
],[
2,3,2,2,2,2,2,2,2,2,2,2,2,8,159,59,180,14,161,56
],[
2,3,2,2,2,2,2,2,2,2,8,2,2,238,9,242,183,94,55,47
],[
2,2,2,2,2,5,5,5,5,2,2,2,2,238,44,176,90,231,14,225
],[
2,2,3,3,3,3,2,3,2,3,2,2,2,128,142,15,59,153,9,144
],[
44,176,71,140,79,68,220,32,224,237,12,74,114,67,37,241,228,251,19,37
],[
145,83,46,169,199,177,86,174,123,134,66,226,58,121,21,169,99,194,50,170
],[
148,211,82,142,98,62,212,4,77,211,84,9,242,8,126,102,131,159,36,122
],[
117,130,143,57,120,242,19,117,172,224,230,93,18,155,51,67,65,172,105,162
],[
90,254,217,95,61,67,128,79,253,146,33,250,146,85,152,158,206,98,106,119
],[
147,104,160,62,66,141,214,240,118,85,143,208,243,198,203,175,217,202,220,107
],[
30,212,117,182,58,198,4,24,36,19,65,55,126,32,7,87,12,241,100,29
],[
107,1,236,152,0,113,82,130,46,101,57,194,204,172,71,54,214,159,123,176
],[
98,75,193,62,214,210,196,175,89,14,4,82,135,120,40,1,105,72,149,94
],[
164,222,63,93,240,97,191,3,204,166,167,109,113,83,18,19,4,68,127,78
],[
15,45,223,24,50,129,236,19,22,147,189,206,163,252,151,67,115,60,7,164
],[
134,164,45,87,55,115,91,63,110,63,223,61,24,150,28,246,212,230,224,215
],[
239,154,241,87,147,134,233,124,59,133,68,161,106,96,184,118,157,242,197,72
]
]