aLevelData = [
[
2,2,2,2,2,11,2,2,2,2,2,2,2,2,9,2,2,2,2,22
],[
2,2,2,2,2,2,2,2,2,2,2,2,2,2,2,2,2,2,2,52
],[
5,2,5,2,5,5,5,2,5,5,5,2,5,5,5,2,5,2,5,200
],[
5,2,5,2,5,2,5,2,5,2,5,2,5,2,5,2,2,5,2,115
],[
176,239,68,63,205,81,40,174,107,251,231,122,41,150,212,186,150,10,135,180
],[
174,240,131,242,162,75,22,152,216,114,128,244,51,81,87,87,148,209,41,35
],[
161,149,100,38,197,231,115,38,119,242,42,189,192,49,100,104,247,39,234,218
],[
208,81,151,150,149,89,186,188,178,140,188,35,119,142,3,169,26,76,21,199
],[
251,51,1,105,44,160,251,252,49,151,70,200,4,183,87,128,93,109,55,23
],[
47,105,41,214,118,78,141,172,48,174,4,197,169,53,213,93,252,36,143,215
],[
215,1,240,9,126,141,6,219,19,247,148,16,20,79,183,99,37,61,201,214
],[
16,243,134,71,10,96,109,68,56,167,105,32,113,207,177,70,70,188,237,206
],[
63,94,154,78,104,40,175,243,12,196,129,208,193,5,228,117,164,29,147,196
],[
230,16,210,0,136,104,81,39,98,43,84,130,106,10,17,122,51,219,89,173
],[
180,73,123,65,75,202,102,120,2,210,13,133,16,71,16,159,163,52,152,83
],[
220,193,130,30,27,99,193,59,126,80,253,186,164,54,128,210,183,44,83,120
],[
169,233,164,48,189,51,107,36,74,155,78,115,188,104,193,203,219,209,113,58
],[
80,111,227,65,100,241,88,43,12,18,245,156,35,200,32,109,246,190,45,183
],[
5,5,58,46,8,7,87,177,49,188,235,31,177,32,83,107,125,228,203,243
],[
82,99,146,13,246,217,73,227,194,207,156,130,93,218,37,45,202,133,141,247
]
]