aLevelData = [
[
4,2,2,2,11,166,146,133,184,101,59,20,173,232,206,70,147,2,99,38
],[
2,2,3,2,91,172,153,32,212,77,210,100,125,57,160,139,152,119,122,125
],[
2,3,2,2,127,199,180,146,59,227,174,247,83,6,75,84,226,171,164,171
],[
2,3,2,2,236,151,254,132,242,25,250,71,196,145,12,233,151,47,46,202
],[
2,3,2,2,87,253,214,222,63,32,37,12,166,91,97,211,28,212,165,51
],[
2,3,2,3,181,27,215,203,165,104,219,63,13,36,6,220,21,171,214,127
],[
2,2,3,2,59,81,224,178,235,163,9,25,79,239,249,13,104,6,205,134
],[
2,2,2,2,94,64,12,62,20,193,221,19,0,251,119,173,58,116,216,98
],[
2,2,2,3,210,201,186,86,103,244,195,231,245,202,252,72,239,199,132,107
],[
2,2,3,2,142,14,134,37,104,172,104,141,68,29,69,165,45,17,158,60
],[
2,2,5,2,197,112,76,18,220,155,185,62,65,245,80,205,216,162,50,172
],[
2,2,2,3,237,142,43,200,200,177,228,115,130,146,90,10,23,10,142,212
],[
2,2,3,2,187,75,127,46,114,32,85,229,219,119,223,228,76,28,63,15
],[
2,3,2,2,36,199,228,110,93,89,185,142,97,99,156,36,31,232,18,244
],[
2,2,2,3,93,100,57,241,80,12,254,166,106,88,143,212,115,191,20,93
],[
2,2,3,2,219,193,154,96,79,43,79,166,138,151,245,61,110,50,145,98
],[
2,3,2,2,83,194,99,165,159,231,27,71,150,160,74,231,116,18,23,93
],[
2,2,2,3,185,133,51,231,197,176,15,131,164,54,76,155,43,112,115,231
],[
2,2,3,2,68,109,230,144,134,55,22,145,9,88,247,99,120,157,177,217
],[
103,26,153,73,231,110,95,236,88,73,136,135,127,43,31,75,217,110,168,250
]
]