aLevelData = [
[
2,2,3,3,3,3,3,3,3,3,3,3,3,3,3,3,2,3,239,60
],[
2,2,2,2,2,2,2,2,2,2,2,2,2,2,2,2,2,2,156,86
],[
3,2,3,3,3,3,3,3,3,3,3,2,3,3,3,2,2,2,138,246
],[
2,2,2,2,2,2,2,2,2,2,2,2,2,2,3,2,2,2,12,109
],[
3,2,3,3,3,3,3,3,3,3,3,3,3,2,3,2,2,3,77,214
],[
2,2,3,2,2,2,2,2,2,2,2,2,3,2,3,2,3,2,50,232
],[
3,2,3,2,2,3,3,3,3,3,3,3,3,2,3,2,3,2,84,149
],[
2,2,3,2,2,3,2,2,2,2,2,3,3,2,3,2,3,2,179,104
],[
2,3,3,2,2,3,3,3,3,2,2,2,2,2,3,2,3,3,14,249
],[
2,2,2,2,2,2,2,2,2,3,2,3,2,2,3,2,2,2,15,251
],[
3,3,3,3,2,2,2,2,2,3,2,3,2,2,3,2,3,2,159,168
],[
8,2,6,3,2,3,3,3,3,3,2,3,2,2,3,2,3,2,37,148
],[
2,2,2,3,2,3,2,2,2,3,2,3,2,2,3,2,3,2,130,58
],[
2,2,2,2,2,3,2,2,2,3,2,3,3,3,3,2,3,2,250,184
],[
2,2,2,2,2,3,2,2,2,3,2,2,2,2,2,2,3,2,115,145
],[
9,2,12,3,2,2,2,2,3,2,3,3,3,3,3,2,3,2,182,121
],[
2,2,2,3,2,3,3,3,3,2,3,2,2,2,3,2,3,2,140,109
],[
239,168,174,59,42,71,34,46,159,61,128,145,61,77,208,92,238,73,240,5
],[
28,131,54,152,116,133,85,10,234,2,133,203,253,12,222,154,60,134,5,157
],[
9,221,11,177,157,243,146,255,76,92,50,208,10,205,27,162,47,209,251,122
]
]