aLevelData = [
[
2,2,2,2,2,2,2,2,2,2,2,2,2,2,2,2,2,2,5,3
],[
2,2,2,2,2,2,2,2,3,3,3,3,3,3,3,3,3,2,5,3
],[
2,2,3,2,3,2,2,2,2,3,2,2,2,2,2,2,2,2,5,3
],[
2,2,3,2,3,2,2,2,2,2,3,2,2,2,2,2,2,2,5,3
],[
2,2,3,2,3,2,2,2,2,2,2,3,2,2,2,2,2,3,2,3
],[
2,2,3,2,2,2,2,2,2,2,2,2,3,2,2,3,3,2,2,3
],[
2,2,3,2,3,3,3,3,3,3,3,3,3,2,2,2,2,2,2,2
],[
2,2,3,2,2,2,2,2,2,2,2,2,2,2,2,2,2,2,2,2
],[
61,7,184,173,32,127,47,231,209,146,199,238,146,6,123,222,228,242,92,146
],[
2,42,54,185,175,254,112,44,49,36,52,127,158,242,208,213,86,208,92,249
],[
209,238,157,171,155,50,42,56,156,117,205,78,157,238,44,13,8,238,169,97
],[
239,206,134,144,80,38,77,15,152,64,111,154,101,205,43,131,144,214,177,75
],[
107,245,136,111,71,196,45,132,58,150,253,134,31,101,84,110,221,12,247,2
],[
237,182,175,241,22,151,55,31,123,218,88,62,216,218,83,158,9,148,127,70
],[
204,93,51,67,199,208,230,64,205,11,149,87,93,27,102,39,107,180,138,39
],[
99,37,103,57,108,140,247,131,234,70,107,122,70,170,21,63,241,247,132,47
],[
166,138,241,182,240,85,218,99,237,140,236,66,81,161,38,102,173,115,60,197
],[
242,195,57,73,49,231,105,35,164,194,118,99,242,243,209,197,175,77,83,206
],[
34,135,37,24,76,53,221,235,37,247,233,12,41,241,49,218,19,123,248,150
],[
233,25,3,3,56,173,254,47,161,235,27,144,148,14,252,82,92,201,211,240
]
]