aLevelData = [
[
2,2,2,5,2,2,2,5,2,2,2,5,2,2,2,5,2,2,2,2
],[
2,2,2,2,2,5,2,2,2,5,2,2,2,5,2,2,2,2,2,2
],[
2,2,3,3,3,3,3,3,3,3,3,3,3,3,3,3,2,2,2,2
],[
2,3,2,2,2,2,2,2,2,2,2,2,2,5,2,5,2,2,2,2
],[
2,3,2,2,2,2,2,2,2,2,8,2,2,2,2,2,2,2,2,2
],[
2,2,2,2,2,5,5,5,5,2,2,2,2,5,2,3,3,3,2,2
],[
2,2,3,3,3,3,2,3,2,3,2,2,2,3,2,3,2,2,3,2
],[
2,2,3,2,2,3,2,3,2,3,3,2,2,3,2,3,2,2,3,2
],[
2,2,3,2,2,3,2,3,2,3,2,3,2,3,2,3,2,2,2,2
],[
4,2,3,2,2,3,2,3,2,3,2,3,2,3,2,3,2,2,2,2
],[
2,2,3,3,3,2,2,3,2,3,2,3,2,3,2,3,2,3,3,5
],[
2,2,3,2,3,2,2,3,2,3,2,2,3,3,2,3,2,2,3,5
],[
2,2,3,2,3,2,2,3,2,3,2,2,3,3,2,3,2,2,3,5
],[
2,2,3,2,2,3,2,3,2,3,2,2,2,3,2,3,2,2,3,5
],[
2,2,3,2,2,3,2,3,2,3,2,2,2,3,2,3,1,2,3,5
],[
2,2,2,2,2,5,5,5,5,2,2,2,2,5,2,5,3,3,5,5
],[
75,115,51,120,141,83,225,196,230,211,0,203,230,209,69,123,147,210,116,157
],[
101,244,128,98,149,36,244,63,152,144,145,251,230,95,57,7,255,160,12,13
],[
176,129,208,203,146,194,150,34,213,105,154,106,59,182,108,9,103,89,77,68
],[
88,227,220,85,49,123,242,189,59,210,202,219,44,89,101,190,170,177,44,56
]
]