aLevelData = [
[
2,2,2,2,2,170,75,140,134,212,233,157,219,133,8,233,55,233,179,162
],[
2,3,5,3,5,28,75,152,16,191,219,185,121,95,175,101,67,214,7,103
],[
2,3,2,3,2,92,110,213,125,218,245,125,12,223,20,217,17,192,220,128
],[
2,2,2,2,2,91,102,162,72,248,244,13,9,237,169,109,164,42,9,78
],[
2,3,5,3,5,68,188,55,78,228,69,166,43,18,169,240,32,242,11,6
],[
2,3,5,3,5,114,133,248,138,70,43,225,121,181,103,207,13,34,227,82
],[
2,5,5,5,5,226,203,180,186,87,159,222,138,55,80,27,42,153,168,216
],[
2,3,5,3,5,220,4,32,129,241,215,175,254,61,232,224,126,200,108,39
],[
2,3,5,3,5,115,198,23,117,221,202,132,10,204,54,214,139,32,246,160
],[
2,5,5,5,5,84,148,110,2,15,251,176,21,133,201,243,137,181,212,65
],[
2,3,5,3,2,141,35,92,111,239,115,73,82,133,54,181,48,203,4,170
],[
5,3,5,3,2,117,205,203,45,167,72,102,123,156,12,114,146,235,164,93
],[
5,5,5,5,5,243,160,57,191,167,52,180,238,128,188,35,205,161,96,94
],[
5,3,5,3,5,228,64,15,234,182,171,113,29,78,137,29,131,28,99,13
],[
5,3,5,3,5,129,255,99,78,56,163,91,252,172,13,8,110,38,116,153
],[
1,5,5,5,5,174,215,83,107,44,189,188,23,179,203,239,174,155,68,43
],[
5,3,2,3,2,67,65,104,196,170,180,82,118,128,177,33,249,107,210,86
],[
213,163,2,125,120,178,52,16,134,120,85,152,112,113,126,21,72,59,111,160
],[
212,82,57,79,225,31,58,89,217,49,78,122,152,202,68,153,124,157,143,169
],[
187,214,62,205,250,91,47,191,27,81,127,114,86,227,68,246,139,62,127,157
]
]