aLevelData = [
[
2,2,2,5,2,2,2,5,2,2,2,5,2,2,2,103,199,204,69,113
],[
147,236,152,156,227,195,248,13,29,180,139,99,47,129,91,143,24,190,252,230
],[
170,133,110,116,142,108,68,148,136,180,6,190,252,195,213,159,178,212,77,111
],[
214,238,176,127,67,18,64,17,1,185,236,109,11,126,47,49,86,23,54,233
],[
16,137,65,223,37,156,75,53,8,141,237,48,176,4,128,215,225,69,130,189
],[
172,170,58,27,57,81,159,33,196,18,119,142,230,180,188,127,22,96,67,132
],[
111,85,160,249,180,222,68,148,145,129,232,58,35,122,47,23,187,104,134,237
],[
223,69,79,172,146,155,64,68,214,245,5,183,110,148,45,114,232,100,67,221
],[
219,47,59,49,110,15,17,138,25,41,172,61,176,152,8,107,157,168,148,214
],[
108,69,217,244,142,179,93,66,86,127,199,219,72,181,67,73,147,83,40,155
],[
220,254,217,183,61,244,233,242,142,66,130,222,227,55,7,99,85,24,248,18
],[
6,21,22,181,95,124,200,43,156,45,190,115,139,78,212,6,144,63,57,106
],[
237,208,208,4,64,178,214,46,77,44,198,137,254,15,121,148,168,236,146,126
],[
144,132,25,57,174,128,102,208,177,99,65,250,67,188,71,239,141,160,144,122
],[
254,87,142,80,72,86,56,160,172,109,104,235,120,66,130,22,206,254,87,190
],[
166,70,73,203,22,109,175,72,210,232,123,114,239,2,26,14,236,209,155,0
],[
242,104,20,26,91,78,65,50,114,47,111,119,121,210,152,5,241,75,208,182
],[
21,114,223,59,168,147,48,108,240,103,234,221,3,67,92,178,65,144,158,180
],[
34,123,117,164,50,237,120,207,89,190,113,226,96,38,6,0,177,116,153,18
],[
94,2,108,94,101,104,9,92,51,240,225,196,102,74,51,236,215,129,47,81
]
]