aLevelData = [
[
2,2,2,2,5,5,2,2,2,2,40,175,249,237,76,112,112,154,74,164
],[
2,2,2,4,2,2,2,2,2,2,138,106,197,176,40,133,212,163,49,7
],[
179,22,229,3,185,87,110,200,138,198,184,98,142,126,131,100,162,56,183,229
],[
13,109,247,201,181,187,120,66,147,138,20,149,100,239,154,34,161,209,105,159
],[
178,74,61,164,95,79,72,108,135,148,133,218,20,170,73,186,46,106,27,74
],[
175,151,197,248,215,191,171,110,66,98,92,204,22,87,103,52,129,106,112,140
],[
99,74,130,127,71,163,167,197,152,135,182,165,18,18,109,184,118,78,191,239
],[
130,84,111,215,32,180,222,28,222,23,34,77,158,35,87,222,142,159,58,115
],[
91,216,244,92,162,67,51,91,168,99,127,174,74,237,204,73,55,43,75,100
],[
92,158,134,53,160,231,172,255,210,232,41,75,223,38,122,117,73,113,64,107
],[
212,200,147,178,131,119,152,170,194,130,86,18,229,70,197,206,209,94,40,232
],[
249,196,157,214,141,56,243,251,237,230,187,112,100,67,162,3,19,56,254,128
],[
43,130,166,48,96,89,7,160,154,79,116,163,237,124,190,154,203,216,5,243
],[
120,232,205,240,191,157,84,170,228,121,36,85,217,243,228,197,180,29,115,49
],[
97,132,56,56,148,87,179,33,2,204,88,103,209,192,158,117,77,158,83,174
],[
220,129,50,176,52,157,183,218,203,219,50,12,143,195,27,173,216,159,165,243
],[
155,221,149,94,224,182,85,134,118,13,68,23,229,154,81,26,164,71,200,118
],[
140,218,107,182,141,213,197,12,160,154,187,150,252,211,100,225,141,17,27,172
],[
162,179,210,238,230,10,169,26,145,187,191,161,223,100,71,184,194,130,223,93
],[
211,146,30,148,143,118,108,247,192,27,23,109,57,89,163,58,198,26,97,56
]
]