aLevelData = [
[
2,2,2,2,2,2,2,2,2,6,5,137,166,225,107,72,176,45,139,37
],[
2,3,5,3,5,5,5,3,5,3,5,172,201,72,118,98,234,89,39,224
],[
2,3,2,3,2,2,2,3,5,3,5,249,210,13,122,136,73,119,16,139
],[
2,2,2,2,2,2,2,2,2,2,2,55,6,143,197,162,191,186,128,249
],[
2,3,5,3,5,5,5,3,2,3,5,95,43,129,64,238,148,59,108,151
],[
2,3,5,3,5,5,5,3,2,3,5,75,67,17,183,6,4,58,52,227
],[
2,5,5,5,5,5,5,5,5,5,5,180,152,16,171,135,224,62,87,34
],[
2,3,5,3,5,5,5,3,5,3,5,110,180,211,82,46,193,3,254,188
],[
2,3,5,3,5,5,5,3,5,3,5,161,4,90,202,79,180,94,195,154
],[
2,5,5,5,5,5,5,5,5,5,5,116,119,173,123,44,124,84,166,144
],[
2,3,5,3,2,2,2,3,2,3,2,227,165,95,162,53,88,143,120,191
],[
5,3,5,3,2,2,2,3,2,3,2,210,23,64,139,73,100,129,142,41
],[
5,5,5,5,5,5,5,5,5,5,5,67,164,35,182,247,178,184,243,138
],[
5,3,5,3,5,5,5,3,5,3,5,95,199,195,96,72,9,79,18,121
],[
5,3,5,3,5,5,5,3,5,3,5,230,167,121,50,47,172,8,235,15
],[
1,5,5,5,5,5,5,5,5,5,5,45,95,149,63,80,30,35,122,52
],[
5,3,2,3,2,2,2,3,2,3,2,247,73,49,212,8,131,127,47,103
],[
90,95,166,254,227,29,165,153,136,10,133,61,10,116,177,188,199,213,8,134
],[
57,75,131,194,192,72,24,157,161,139,222,226,78,79,113,204,232,194,152,24
],[
2,184,37,93,168,161,29,160,159,184,25,35,239,126,236,127,159,103,134,242
]
]