aLevelData = [
[
2,2,2,2,2,11,2,2,2,2,2,2,2,17,3,64,254,79,236,210
],[
2,2,2,2,2,2,2,2,2,2,2,2,2,155,193,250,193,198,157,149
],[
5,2,5,2,5,5,5,2,5,5,5,2,5,161,82,181,91,105,235,85
],[
5,2,5,2,5,2,5,2,5,2,5,2,5,115,119,7,111,29,212,26
],[
5,5,5,2,5,5,5,2,5,5,5,2,5,245,141,186,9,135,249,83
],[
5,2,5,2,5,2,5,2,5,2,2,2,5,226,78,241,196,202,40,239
],[
5,2,5,2,5,2,5,2,5,2,2,2,5,106,55,5,47,99,95,145
],[
2,2,2,12,2,2,2,2,2,2,2,2,2,192,81,240,19,220,90,1
],[
2,2,7,2,2,2,2,2,8,2,2,2,2,148,117,116,72,69,16,223
],[
2,2,7,2,5,5,5,2,5,5,5,2,5,142,27,214,242,97,188,232
],[
2,2,7,2,5,2,2,2,2,5,2,2,5,27,9,158,244,34,189,109
],[
2,2,7,2,5,5,5,2,2,5,2,2,5,6,173,22,174,160,9,195
],[
2,2,7,2,5,2,2,2,2,5,2,2,5,163,12,39,127,110,241,229
],[
2,2,7,2,5,5,5,2,5,5,5,2,5,64,120,37,143,177,20,194
],[
2,2,2,2,2,2,2,2,2,2,2,2,2,166,227,96,124,224,63,108
],[
13,2,2,2,3,3,3,3,3,3,3,3,3,49,111,192,159,194,134,95
],[
2,2,2,2,2,2,2,2,2,2,2,2,2,86,34,26,206,205,172,230
],[
2,2,2,2,2,2,2,2,2,2,2,2,2,104,67,186,177,105,89,115
],[
211,90,188,228,246,208,3,83,26,86,219,207,220,168,97,12,247,34,207,110
],[
11,119,91,100,157,166,92,247,95,42,175,163,178,113,89,101,106,144,109,21
]
]