aLevelData = [
[
2,2,3,3,3,3,3,3,3,3,3,3,3,3,3,3,2,3,2,233
],[
2,2,2,2,2,2,2,2,2,2,2,2,2,2,2,2,2,2,3,94
],[
3,2,3,3,3,3,3,3,3,3,3,2,3,3,3,2,2,2,2,167
],[
2,2,2,2,2,2,2,2,2,2,2,2,2,2,3,2,2,2,2,0
],[
3,2,3,3,3,3,3,3,3,3,3,3,3,2,3,2,2,3,3,196
],[
2,2,3,2,2,2,2,2,2,2,2,2,3,2,3,2,3,2,3,188
],[
3,2,3,2,2,3,3,3,3,3,3,3,3,2,3,2,3,2,3,253
],[
2,2,3,2,2,3,2,2,2,2,2,3,3,2,3,2,3,2,2,239
],[
2,3,3,2,2,3,3,3,3,2,2,2,2,2,3,2,3,3,3,102
],[
2,2,2,2,2,2,2,2,2,3,2,3,2,2,3,2,2,2,3,204
],[
3,3,3,3,2,2,2,2,2,3,2,3,2,2,3,2,3,2,3,45
],[
8,2,6,3,2,3,3,3,3,3,2,3,2,2,3,2,3,2,3,125
],[
2,2,2,3,2,3,2,2,2,3,2,3,2,2,3,2,3,2,3,165
],[
2,2,2,2,2,3,2,2,2,3,2,3,3,3,3,2,3,2,3,153
],[
2,2,2,2,2,3,2,2,2,3,2,2,2,2,2,2,3,2,3,104
],[
40,211,188,50,112,67,207,11,234,10,37,79,144,3,184,91,91,22,99,241
],[
20,185,82,222,103,182,182,217,57,47,189,175,59,224,193,157,191,165,192,253
],[
203,60,12,38,108,75,67,141,77,165,130,48,136,201,214,52,188,172,243,204
],[
96,184,41,94,87,20,147,225,196,38,146,138,31,86,121,167,137,21,138,203
],[
92,30,34,43,7,252,48,72,25,205,235,206,155,69,197,188,163,246,154,198
]
]