aLevelData = [
[
2,2,2,22,130,104,169,187,241,58,17,42,247,120,175,136,110,156,227,74
],[
73,226,203,169,51,89,6,79,115,58,190,87,19,121,229,116,65,155,190,112
],[
245,199,160,217,212,31,247,247,85,81,139,0,34,104,5,143,193,233,175,83
],[
115,27,123,4,92,166,71,156,229,95,95,195,95,99,67,139,233,99,171,93
],[
147,62,201,52,195,213,206,8,216,27,175,142,14,107,41,30,161,31,3,244
],[
54,94,147,156,118,53,131,168,252,233,213,164,113,140,37,76,245,207,46,252
],[
193,23,144,103,11,211,209,140,42,12,161,230,251,61,98,227,131,102,231,152
],[
214,92,124,179,55,99,39,177,128,254,46,81,197,6,217,72,52,250,121,54
],[
63,150,169,217,254,167,212,128,206,29,248,195,63,98,169,114,45,234,88,203
],[
44,12,213,240,42,16,19,152,79,137,44,4,40,229,164,53,5,66,242,92
],[
159,131,60,146,254,163,99,201,154,74,63,2,193,158,44,193,56,92,197,190
],[
37,39,239,222,44,32,26,97,217,182,195,93,62,192,61,107,221,201,178,160
],[
200,170,101,191,6,95,57,172,57,19,119,36,126,125,204,172,149,111,145,199
],[
66,172,79,108,242,251,131,183,162,121,158,223,253,51,80,104,196,244,6,154
],[
115,92,178,49,34,50,202,86,169,251,147,206,7,204,159,114,5,92,148,223
],[
22,93,48,110,130,13,138,103,195,8,155,113,47,96,252,77,216,239,241,196
],[
177,236,167,222,242,189,186,85,189,12,250,73,1,29,111,53,159,95,155,34
],[
203,65,254,27,181,70,224,224,105,92,74,223,244,106,86,95,201,40,168,255
],[
99,51,61,95,43,97,100,29,155,81,9,3,164,71,57,126,77,55,227,82
],[
158,32,220,141,188,156,38,185,85,180,114,86,62,248,227,136,91,208,21,12
]
]