aLevelData = [
[
5,5,199,50,122,187,152,80,174,181,44,83,172,230,90,195,173,48,209,166
],[
4,2,109,244,183,152,232,205,144,30,97,127,98,56,169,42,22,53,158,196
],[
2,2,34,203,242,197,101,103,46,36,82,194,246,131,81,181,142,167,98,78
],[
5,2,157,42,4,35,49,116,85,230,4,231,122,58,254,90,65,197,250,201
],[
2,2,5,135,205,74,211,106,132,67,202,26,238,219,200,22,91,174,67,8
],[
2,2,162,197,116,82,105,197,187,233,160,102,63,102,79,39,213,90,146,65
],[
2,2,35,226,225,217,5,124,149,121,47,25,168,193,20,116,189,90,7,161
],[
5,2,96,44,160,233,142,209,98,213,120,73,154,137,132,239,138,83,149,171
],[
2,2,199,132,140,106,224,127,15,203,64,15,137,27,86,254,113,132,243,227
],[
2,2,208,129,243,59,253,149,31,187,171,61,82,229,38,35,219,218,218,148
],[
2,2,35,111,21,52,144,130,14,241,168,143,37,53,122,126,108,96,57,191
],[
2,2,103,117,43,153,16,19,193,191,30,168,8,37,135,225,64,17,68,101
],[
2,2,201,117,84,194,71,124,3,167,254,99,108,85,126,138,61,80,133,203
],[
2,2,186,90,33,10,5,161,21,13,156,56,126,142,35,196,182,143,100,120
],[
121,238,148,67,70,57,215,71,8,195,7,142,246,248,177,248,184,237,97,120
],[
203,60,32,128,38,14,58,186,30,121,69,249,135,13,94,111,28,169,182,32
],[
33,147,78,150,70,200,254,215,207,145,188,148,242,87,27,163,128,184,18,176
],[
200,219,255,47,185,0,235,148,70,91,16,199,15,34,152,210,61,229,168,221
],[
173,30,157,93,82,9,150,136,212,181,50,12,125,91,155,0,86,240,195,27
],[
141,246,237,36,26,151,112,169,162,244,183,244,156,187,141,59,178,247,151,23
]
]