aLevelData = [
[
6,2,8,191,17,59,74,162,125,245,104,175,101,79,99,223,173,45,228,76
],[
2,2,2,218,147,44,66,209,94,248,152,225,51,167,65,4,182,158,30,98
],[
2,2,3,252,236,22,23,66,42,105,54,223,165,65,14,119,192,139,172,114
],[
2,2,3,147,4,161,172,216,151,5,110,8,230,187,158,193,39,247,50,107
],[
49,254,234,27,214,45,63,183,116,61,151,92,199,197,186,252,1,0,137,76
],[
29,209,238,221,112,4,15,136,129,215,199,16,26,185,86,3,159,81,87,225
],[
159,194,243,128,169,46,85,175,97,121,93,26,210,79,153,110,6,104,113,189
],[
212,10,161,35,250,208,237,170,108,171,15,107,235,38,245,246,216,238,41,244
],[
75,145,145,11,96,134,88,2,209,110,44,38,202,153,170,236,248,204,22,215
],[
228,65,80,156,127,240,3,133,253,13,32,19,231,210,139,231,108,126,20,226
],[
249,158,168,140,9,139,200,178,61,52,59,84,175,29,0,190,132,168,135,244
],[
192,148,33,83,94,195,180,118,161,64,179,87,165,128,77,182,57,232,229,191
],[
241,144,195,231,118,71,9,23,33,215,232,12,200,138,19,254,216,236,116,127
],[
164,211,31,167,253,157,132,110,3,185,232,89,58,105,22,89,225,197,81,240
],[
127,4,142,149,190,247,224,90,124,214,52,204,32,63,62,26,42,124,179,122
],[
15,5,185,201,67,69,156,113,151,161,194,144,197,183,225,87,73,227,111,176
],[
115,8,90,35,187,141,250,250,84,165,68,163,4,212,64,87,50,175,189,249
],[
65,227,67,65,28,120,73,25,18,87,168,71,229,10,80,77,29,196,57,141
],[
162,161,157,177,138,46,101,74,48,44,225,183,134,145,187,73,172,208,46,165
],[
193,90,115,105,249,101,124,18,239,236,229,29,61,247,40,108,75,28,16,236
]
]