aLevelData = [
[
12,2,2,2,2,2,2,2,2,2,2,2,2,2,2,2,2,2,52,16
],[
18,124,95,255,49,152,223,71,71,205,28,60,168,46,174,163,82,209,35,106
],[
207,37,253,150,93,134,251,124,77,15,154,52,169,176,218,75,25,128,69,184
],[
7,84,46,17,2,144,55,255,96,61,22,240,40,92,152,11,47,122,229,105
],[
128,133,7,130,1,222,166,229,84,175,21,45,252,127,147,48,193,4,202,121
],[
85,56,156,249,55,175,31,249,216,39,230,83,253,97,131,226,100,47,73,55
],[
170,207,87,141,108,119,210,255,173,49,113,249,119,233,63,237,197,196,156,71
],[
161,180,133,162,138,74,22,60,24,203,77,167,227,133,17,194,160,99,115,232
],[
141,192,51,103,16,121,134,52,154,70,22,221,210,74,75,190,240,232,201,120
],[
102,217,58,159,198,123,77,179,224,108,254,82,42,88,25,171,102,15,249,54
],[
126,219,150,163,179,16,191,16,246,228,163,126,150,129,150,134,28,89,18,72
],[
116,186,252,165,77,162,41,174,193,212,33,91,57,43,35,129,139,47,105,254
],[
102,230,172,54,240,237,235,196,173,198,105,105,163,116,245,72,188,69,109,86
],[
107,240,133,12,146,223,197,95,164,206,209,241,7,149,237,137,188,66,192,193
],[
65,107,88,254,182,195,111,165,64,234,237,140,171,138,174,175,83,159,132,37
],[
68,22,128,82,160,154,109,93,65,171,158,228,160,240,234,239,245,206,244,35
],[
160,57,176,57,200,202,34,174,66,18,105,187,180,47,253,135,250,156,53,156
],[
200,78,12,151,145,252,36,36,168,190,11,42,166,217,190,67,11,217,107,111
],[
40,225,123,9,60,64,208,250,221,68,75,44,153,83,146,66,222,55,16,134
],[
23,186,61,34,24,115,31,148,188,223,17,92,204,180,195,247,35,113,130,17
]
]