aLevelData = [
[
6,2,2,2,2,2,2,2,2,2,2,2,2,2,2,2,2,36,193,226
],[
2,2,2,2,2,2,2,2,2,2,2,2,2,2,2,2,2,68,192,147
],[
2,2,2,2,2,2,2,2,2,2,2,2,2,2,2,2,2,177,68,183
],[
3,3,3,3,3,3,3,3,3,3,3,3,3,3,3,3,3,3,160,248
],[
2,2,2,2,2,2,2,2,2,2,2,2,2,2,2,2,2,87,54,17
],[
2,2,2,2,2,2,2,2,2,2,2,2,2,2,2,2,2,204,164,48
],[
2,2,2,2,2,3,2,2,3,2,2,3,2,2,2,3,2,194,20,249
],[
2,2,3,3,3,3,3,3,3,3,3,3,3,3,3,3,3,237,152,181
],[
2,2,2,2,2,2,2,2,2,2,2,2,2,2,2,2,2,242,173,155
],[
2,2,2,2,2,2,2,2,2,4,2,2,2,2,2,2,2,34,136,143
],[
3,3,3,3,3,3,3,3,3,3,3,3,3,3,3,3,3,65,139,126
],[
2,2,2,2,2,2,2,2,2,2,2,2,2,2,2,2,2,97,239,81
],[
2,2,2,2,2,2,2,2,2,2,2,2,2,2,2,2,2,253,183,189
],[
2,2,3,3,3,3,3,3,3,3,2,3,3,3,3,3,3,188,123,58
],[
2,2,3,2,2,2,2,2,2,2,2,3,2,2,2,2,2,122,240,225
],[
2,2,3,2,2,2,2,2,2,2,2,3,2,2,2,2,2,67,240,29
],[
2,2,3,3,3,3,3,2,2,2,2,3,2,2,3,2,2,236,169,104
],[
247,211,215,113,102,43,33,222,126,8,88,14,177,102,155,112,67,199,113,69
],[
255,29,21,168,41,233,17,204,179,165,14,134,179,96,235,11,21,168,12,250
],[
141,172,245,157,208,162,23,108,4,103,233,210,117,101,59,52,137,186,200,48
]
]