aLevelData = [
[
6,2,2,2,2,2,2,2,2,2,2,2,2,2,2,2,2,2,246,151
],[
2,2,2,2,2,2,2,2,2,2,2,2,2,2,2,2,2,2,10,34
],[
2,2,2,2,2,2,2,2,2,2,2,2,2,2,2,2,2,2,50,229
],[
3,3,3,3,3,3,3,3,3,3,3,3,3,3,3,3,3,3,82,237
],[
2,2,2,2,2,2,2,2,2,2,2,2,2,2,2,2,2,2,44,47
],[
2,2,2,2,2,2,2,2,2,2,2,2,2,2,2,2,2,2,23,248
],[
2,2,2,2,2,3,2,2,3,2,2,3,2,2,2,3,2,2,57,188
],[
2,2,3,3,3,3,3,3,3,3,3,3,3,3,3,3,3,3,142,118
],[
2,2,2,2,2,2,2,2,2,2,2,2,2,2,2,2,2,2,81,251
],[
2,2,2,2,2,2,2,2,2,4,2,2,2,2,2,2,2,2,124,235
],[
3,3,3,3,3,3,3,3,3,3,3,3,3,3,3,3,3,3,123,37
],[
2,2,2,2,2,2,2,2,2,2,2,2,2,2,2,2,2,3,73,235
],[
2,2,2,2,2,2,2,2,2,2,2,2,2,2,2,2,2,3,134,29
],[
2,2,3,3,3,3,3,3,3,3,2,3,3,3,3,3,3,3,85,37
],[
2,2,3,2,2,2,2,2,2,2,2,3,2,2,2,2,2,3,250,155
],[
2,2,3,2,2,2,2,2,2,2,2,3,2,2,2,2,2,3,143,161
],[
2,2,3,3,3,3,3,2,2,2,2,3,2,2,3,2,2,3,78,137
],[
67,70,91,173,51,159,17,137,234,223,105,127,77,34,154,57,115,245,144,72
],[
182,25,154,11,10,132,99,211,142,169,35,68,97,249,22,255,183,170,46,126
],[
44,183,5,62,88,40,21,36,163,147,43,26,90,227,25,249,3,88,171,171
]
]