aLevelData = [
[
5,5,3,5,5,5,5,5,5,5,3,5,5,5,5,5,5,5,166,34
],[
4,2,3,5,5,5,5,5,5,5,3,5,5,5,5,5,5,5,9,240
],[
89,246,8,195,170,218,15,213,66,233,158,50,77,173,232,214,32,53,142,103
],[
30,103,174,35,220,152,28,23,131,90,239,145,118,149,64,217,53,218,46,28
],[
130,243,37,169,194,191,97,96,165,61,173,102,9,230,113,30,28,64,235,85
],[
193,176,189,189,54,143,168,157,243,129,151,198,213,2,223,201,123,66,197,103
],[
241,51,65,73,139,224,1,242,20,0,177,241,40,203,122,91,223,12,200,120
],[
172,120,81,189,132,62,83,250,66,223,28,213,74,64,208,119,108,254,103,133
],[
12,1,245,82,128,84,46,83,186,51,41,211,39,102,100,231,214,206,9,165
],[
221,62,111,145,249,140,228,88,116,231,170,193,76,106,63,224,145,242,225,141
],[
15,45,82,20,45,244,217,46,21,219,137,48,21,6,197,131,69,62,4,84
],[
107,67,210,140,27,100,24,3,35,78,156,240,38,34,203,165,134,202,183,121
],[
135,140,92,5,178,223,39,147,120,126,185,211,24,188,232,208,195,23,6,35
],[
253,15,102,102,70,57,29,236,250,143,6,175,118,10,9,138,124,115,156,169
],[
217,118,137,61,68,248,242,116,138,170,147,168,232,222,72,215,184,154,207,83
],[
81,235,206,186,40,124,24,41,59,103,44,173,175,75,255,250,183,159,251,96
],[
185,70,71,250,172,99,73,41,197,110,105,64,82,136,24,129,230,11,17,73
],[
182,102,223,135,67,40,160,114,57,90,8,124,151,18,169,129,17,69,113,69
],[
179,221,116,29,198,11,235,236,247,223,125,81,182,22,190,31,221,51,246,14
],[
146,209,35,176,110,55,65,166,223,45,200,19,202,14,119,81,117,31,80,227
]
]