aLevelData = [
[
2,2,2,2,111,104,240,43,115,98,53,12,9,56,35,44,41,153,4,192
],[
2,2,2,2,7,114,91,78,221,170,200,8,234,16,45,90,186,146,15,191
],[
5,2,5,2,169,175,63,216,163,47,185,191,45,17,204,153,169,197,123,106
],[
5,2,5,2,213,155,36,46,150,124,95,37,244,216,41,110,101,223,66,215
],[
5,5,5,2,78,244,211,244,199,94,84,110,159,65,173,158,159,205,155,90
],[
5,2,5,2,19,182,86,15,135,228,113,16,207,107,1,46,74,189,1,137
],[
5,2,5,2,103,31,245,166,103,89,206,193,101,178,14,100,148,27,44,56
],[
2,2,2,12,201,171,58,28,57,75,197,116,131,179,253,195,241,149,21,125
],[
2,2,7,2,250,23,237,22,12,135,239,95,137,74,55,18,16,22,246,171
],[
2,2,7,2,253,98,24,122,51,26,36,247,25,150,100,85,226,205,71,90
],[
2,2,7,2,18,198,3,109,61,80,126,241,18,243,111,209,153,38,192,92
],[
2,2,7,2,185,194,56,84,253,183,86,65,152,254,128,11,166,207,93,200
],[
2,2,7,2,180,19,127,211,131,28,69,30,9,148,255,201,185,179,84,243
],[
2,2,7,2,4,181,225,208,32,140,35,251,8,210,151,14,196,1,31,113
],[
2,2,2,2,234,230,168,111,101,83,10,143,117,21,47,33,247,37,120,23
],[
13,2,2,2,231,35,92,22,35,255,83,205,113,250,242,134,196,205,87,250
],[
187,39,199,106,107,93,150,235,94,93,71,2,219,229,245,112,104,242,242,79
],[
142,122,173,94,220,93,217,154,47,154,203,14,48,190,36,235,29,163,177,219
],[
205,86,143,147,238,89,147,167,146,11,232,163,234,100,250,87,80,229,147,114
],[
139,207,68,83,79,148,7,27,4,139,34,7,200,231,79,253,183,234,25,100
]
]