aLevelData = [
[
2,2,2,5,2,2,2,5,2,2,2,5,52,119,166,97,204,102,251,62
],[
2,2,2,2,2,5,2,2,2,5,2,2,220,128,14,32,38,15,84,182
],[
2,2,3,3,3,3,3,3,3,3,3,3,109,94,59,196,54,110,17,118
],[
2,3,2,2,2,2,2,2,2,2,2,2,204,234,33,244,134,93,31,54
],[
2,3,2,2,2,2,2,2,2,2,8,2,76,163,198,26,88,158,191,180
],[
2,2,2,2,2,5,5,5,5,2,2,2,58,42,197,229,31,82,7,47
],[
2,2,3,3,3,3,2,3,2,3,2,2,82,196,205,199,3,130,95,236
],[
2,2,3,2,2,3,2,3,2,3,3,2,72,219,35,120,97,154,5,181
],[
2,2,3,2,2,3,2,3,2,3,2,3,64,125,27,113,73,232,137,85
],[
4,2,3,2,2,3,2,3,2,3,2,3,86,219,163,114,254,34,82,29
],[
2,2,3,3,3,2,2,3,2,3,2,3,23,203,185,253,121,221,24,98
],[
2,2,3,2,3,2,2,3,2,3,2,2,5,71,240,216,230,23,104,253
],[
2,2,3,2,3,2,2,3,2,3,2,2,23,236,239,143,37,174,35,201
],[
2,2,3,2,2,3,2,3,2,3,2,2,55,124,241,240,75,230,254,41
],[
2,2,3,2,2,3,2,3,2,3,2,2,194,93,70,141,31,231,4,127
],[
2,2,2,2,2,5,5,5,5,2,2,2,12,24,209,61,158,61,15,182
],[
2,3,2,2,2,2,2,2,2,2,9,2,217,218,136,156,119,87,83,185
],[
2,3,3,3,3,2,2,2,2,2,2,2,229,246,248,134,143,8,211,250
],[
2,2,2,2,2,3,3,3,3,3,3,3,93,97,190,160,125,9,234,236
],[
2,2,2,2,2,2,2,2,2,2,2,2,100,52,14,207,15,116,196,137
]
]