aLevelData = [
[
6,2,8,2,9,2,10,2,11,3,2,2,5,2,2,2,172,229,42,126
],[
2,2,2,2,2,2,2,2,12,3,5,2,2,2,5,2,74,250,93,207
],[
2,2,3,3,3,3,3,3,3,3,2,2,3,3,3,3,217,7,77,250
],[
2,2,3,2,2,2,2,2,2,2,5,2,3,2,2,2,169,232,247,86
],[
2,2,3,2,2,2,2,2,2,2,2,2,3,2,2,2,193,91,176,58
],[
2,2,3,2,3,3,3,3,3,3,2,5,3,2,2,2,46,6,19,29
],[
2,2,3,2,2,2,2,5,5,3,2,2,3,2,2,2,155,188,62,252
],[
2,2,3,5,5,5,2,3,3,3,5,2,3,3,3,2,34,252,62,253
],[
2,2,2,2,2,2,2,2,2,2,2,2,5,2,2,2,98,186,199,81
],[
2,3,2,2,3,1,3,2,2,2,2,2,5,2,2,2,210,98,40,94
],[
2,3,2,2,3,2,3,2,2,2,2,5,5,2,2,2,84,27,127,30
],[
2,3,2,3,2,2,2,3,2,2,2,2,5,2,2,2,14,73,41,194
],[
117,85,125,156,170,176,186,59,10,21,61,216,1,15,248,241,30,188,31,51
],[
109,208,36,157,1,220,230,227,208,209,38,16,196,192,58,112,14,227,5,173
],[
190,225,38,56,144,78,112,234,9,113,154,236,195,75,56,212,6,212,234,16
],[
151,136,212,136,213,34,78,127,1,168,220,186,222,167,96,229,122,192,142,50
],[
75,99,161,67,125,219,76,74,139,139,244,111,13,119,28,114,209,6,33,145
],[
44,6,39,172,146,240,83,167,101,109,59,16,11,26,154,1,67,136,73,72
],[
185,136,106,198,216,165,230,21,223,241,27,110,55,5,206,201,4,67,103,69
],[
250,94,93,203,113,29,239,238,188,91,21,22,183,83,182,222,160,26,27,186
]
]