aLevelData = [
[
4,2,2,69,165,175,129,229,32,108,253,158,175,204,248,157,32,116,82,215
],[
5,2,5,224,40,147,63,102,154,116,60,207,127,161,90,198,232,189,64,167
],[
2,5,5,208,166,226,228,241,251,247,167,221,220,174,185,73,241,156,162,172
],[
3,3,5,174,249,18,9,213,13,127,8,60,229,16,76,208,74,186,1,218
],[
2,3,5,244,169,180,129,250,225,104,144,141,37,230,122,230,23,84,156,125
],[
3,3,5,162,9,193,124,149,160,235,115,144,75,81,77,36,106,164,131,54
],[
3,5,5,93,150,143,164,150,157,164,44,242,244,156,137,73,228,50,222,68
],[
3,5,5,65,113,88,110,55,108,15,142,71,48,46,53,140,247,84,147,67
],[
3,5,5,158,58,142,138,89,149,22,104,166,62,178,14,127,144,95,92,212
],[
3,5,5,17,155,167,56,85,189,186,219,32,135,26,184,203,254,143,15,233
],[
3,5,5,121,223,22,42,249,221,236,127,184,162,206,126,5,27,141,9,78
],[
5,5,5,196,63,42,127,178,53,66,139,215,46,99,71,130,202,250,127,37
],[
5,5,5,66,177,68,91,85,147,131,41,134,113,220,132,132,133,176,20,234
],[
5,3,3,86,124,56,40,219,102,74,193,227,22,36,184,181,199,227,68,243
],[
5,3,2,158,235,203,196,58,43,14,49,140,162,162,208,233,33,159,160,93
],[
5,3,3,83,156,53,67,252,218,21,18,126,191,97,122,161,134,184,176,147
],[
5,5,3,54,88,6,46,208,134,190,122,205,49,32,115,199,210,202,12,119
],[
150,72,115,223,191,228,151,200,71,191,232,111,199,33,93,124,152,14,188,51
],[
56,26,22,238,239,126,144,203,178,106,106,162,71,157,57,58,170,52,119,188
],[
176,191,62,103,234,154,81,134,204,123,92,159,14,71,125,238,83,42,2,17
]
]