aLevelData = [
[
5,5,5,175,21,132,2,22,93,111,51,235,233,233,175,254,90,221,62,75
],[
5,2,2,200,211,223,33,88,42,2,132,17,161,247,207,235,29,167,158,41
],[
5,2,5,166,130,234,233,178,184,118,250,166,172,106,237,154,166,62,111,92
],[
2,2,5,199,218,214,184,67,252,249,247,202,217,69,166,71,7,13,153,205
],[
2,2,3,154,34,47,206,142,164,214,143,101,23,210,216,16,185,59,240,19
],[
2,2,3,19,69,201,229,207,197,119,149,201,240,230,179,105,101,205,110,47
],[
4,2,3,110,222,250,143,130,64,53,0,15,62,137,80,119,65,20,58,88
],[
2,2,3,251,6,58,17,230,75,160,130,237,107,228,19,104,174,57,247,78
],[
2,2,2,131,100,178,166,34,207,216,63,113,217,24,161,36,113,122,67,41
],[
2,3,2,227,229,255,67,241,228,194,245,38,169,136,161,103,83,136,241,203
],[
2,3,2,108,171,118,173,182,67,143,255,39,250,141,224,50,8,20,113,72
],[
2,3,2,170,196,229,159,207,25,216,50,20,144,226,9,242,12,107,186,54
],[
2,3,2,119,193,48,178,172,103,171,51,149,177,8,179,144,141,67,207,24
],[
2,3,2,164,58,123,161,162,179,244,195,209,161,246,155,237,163,48,111,52
],[
2,3,2,206,245,144,188,172,52,133,9,132,170,101,223,220,86,133,85,61
],[
2,3,2,45,83,43,54,16,130,93,163,251,104,248,48,127,164,45,24,114
],[
2,3,2,3,164,51,229,165,19,47,86,91,14,29,39,84,33,48,79,249
],[
2,3,3,28,194,80,21,174,152,105,57,53,103,12,95,213,151,146,205,199
],[
2,2,2,70,46,60,244,144,31,58,195,14,42,205,47,156,72,89,28,96
],[
156,195,235,8,167,215,76,82,191,231,83,210,189,181,207,240,247,148,215,48
]
]