aLevelData = [
[
2,2,2,2,5,155,226,114,5,53,216,133,46,211,244,149,27,253,238,133
],[
2,2,2,4,2,237,215,165,203,25,155,193,127,37,70,151,177,172,146,78
],[
5,3,3,3,5,0,168,37,64,104,241,8,163,92,0,90,105,21,249,70
],[
2,3,2,2,2,100,41,233,50,174,95,75,57,72,194,210,220,1,244,98
],[
2,3,2,2,2,244,154,197,95,235,39,4,43,44,184,150,234,216,57,196
],[
2,3,2,2,3,137,187,151,217,254,126,37,237,209,30,61,252,219,157,42
],[
2,3,2,2,3,59,78,247,69,171,245,87,95,238,189,139,95,90,117,181
],[
44,76,210,68,206,190,182,35,208,28,177,48,232,84,201,240,218,45,118,129
],[
153,217,241,208,175,205,174,12,224,208,39,90,10,82,220,202,80,0,152,137
],[
119,149,245,89,144,243,34,63,216,114,228,123,220,120,219,189,225,74,7,150
],[
130,33,139,45,155,129,176,51,102,198,44,25,228,0,165,128,127,0,113,241
],[
237,179,160,206,87,175,60,136,187,12,207,19,143,117,38,151,167,126,85,105
],[
88,56,251,57,222,4,199,141,251,164,59,110,225,152,176,96,82,167,155,152
],[
6,188,14,106,77,243,130,1,245,244,211,82,110,128,140,82,44,73,101,103
],[
77,7,10,29,124,200,30,27,21,135,128,85,137,1,205,131,5,196,38,209
],[
78,137,51,216,240,195,103,205,151,120,134,248,189,80,101,104,133,236,242,230
],[
231,120,115,39,14,132,19,70,254,15,154,113,122,229,124,226,37,44,21,16
],[
231,57,51,39,146,168,213,182,198,171,50,168,18,162,253,118,91,236,232,155
],[
130,253,103,71,65,177,182,87,86,224,29,133,228,51,115,220,22,54,225,112
],[
5,174,232,75,220,44,165,170,58,226,84,106,215,182,20,189,107,149,233,33
]
]