aLevelData = [
[
10,2,2,8,2,71,136,101,227,92,130,11,116,93,162,132,190,162,176,7
],[
105,62,64,107,69,214,52,151,233,180,130,58,154,23,56,188,110,205,189,116
],[
176,4,89,27,135,94,247,128,211,67,42,126,88,123,111,43,30,252,178,83
],[
23,0,19,37,3,91,233,43,145,12,7,128,199,18,63,61,163,129,37,52
],[
3,212,21,225,194,133,120,157,36,219,66,21,116,4,191,251,235,99,144,251
],[
212,43,241,241,238,45,61,89,18,238,179,6,21,253,122,24,240,131,227,40
],[
30,28,239,197,70,229,17,36,26,215,52,19,127,83,0,47,238,253,89,87
],[
26,206,41,96,211,101,96,10,42,158,57,51,214,102,190,75,214,206,142,8
],[
88,94,222,91,218,171,190,162,143,43,157,31,4,73,16,169,3,181,207,161
],[
184,254,0,40,18,98,185,143,108,229,192,15,109,160,149,187,44,92,178,178
],[
152,95,17,153,24,134,239,73,110,148,208,196,225,202,195,110,155,184,231,122
],[
80,82,46,162,32,70,97,27,191,141,100,200,211,64,188,174,157,174,78,168
],[
220,171,105,91,238,43,7,109,57,15,80,242,201,62,96,39,58,248,74,99
],[
217,103,93,74,6,119,166,68,221,232,181,46,21,162,164,79,39,72,86,141
],[
179,15,253,224,32,209,223,8,132,93,89,123,195,18,36,162,250,172,215,68
],[
30,93,173,67,224,32,137,134,212,74,55,54,211,97,245,45,158,50,50,171
],[
195,30,149,75,197,181,65,54,119,134,88,151,169,52,189,79,6,205,31,233
],[
61,88,51,208,95,173,64,191,136,138,225,122,194,226,7,188,38,120,61,112
],[
69,173,48,35,198,150,110,186,80,82,110,96,170,155,209,195,32,154,231,128
],[
41,0,117,219,72,82,181,180,48,132,159,183,43,202,103,210,188,171,71,236
]
]