aLevelData = [
[
5,5,5,5,5,2,2,2,2,2,2,2,2,2,2,2,2,82,164,226
],[
5,2,2,2,2,2,2,2,2,2,2,2,2,2,2,2,2,124,228,121
],[
0,134,211,191,51,37,145,243,141,109,241,104,170,223,129,72,158,141,26,213
],[
44,127,181,245,57,84,128,238,127,44,50,110,134,198,155,206,208,230,127,151
],[
84,250,164,70,47,252,42,76,149,154,27,89,13,149,67,218,222,103,66,193
],[
196,40,223,132,232,178,159,104,15,4,151,255,18,228,126,239,142,201,6,246
],[
220,247,108,43,68,236,78,135,109,251,190,163,24,55,148,195,14,146,8,20
],[
87,70,128,50,173,116,166,237,49,11,190,77,92,236,55,212,55,76,127,2
],[
207,89,28,31,227,32,249,52,225,174,253,91,17,117,226,56,15,242,69,200
],[
126,141,249,89,251,193,161,218,80,124,126,85,234,201,133,186,142,172,181,222
],[
71,77,167,195,163,89,103,26,30,166,130,6,223,22,96,35,162,189,212,199
],[
246,70,242,136,168,146,33,254,127,163,113,202,41,185,46,214,118,186,181,223
],[
196,215,134,49,187,109,155,178,58,41,248,34,144,112,132,161,240,254,23,114
],[
31,205,212,254,112,56,185,28,242,96,116,143,232,207,120,208,121,91,81,15
],[
169,77,52,116,136,195,219,170,169,83,144,158,214,241,135,132,2,19,112,28
],[
127,19,77,51,114,212,129,108,131,168,42,64,217,113,177,68,69,7,160,170
],[
189,218,179,11,13,217,49,100,201,146,124,94,134,154,231,210,73,47,201,140
],[
64,28,208,79,176,221,151,26,47,4,122,170,19,219,169,64,42,75,123,164
],[
172,252,5,106,109,190,236,116,87,40,119,184,24,126,232,67,24,216,13,126
],[
174,129,18,177,147,158,153,197,151,16,12,78,146,155,50,201,158,71,1,33
]
]