aLevelData = [
[
4,2,2,2,2,2,2,2,2,2,8,2,142,177,117,144,62,162,216,4
],[
2,2,3,2,9,2,2,2,2,2,2,2,72,145,37,10,169,83,111,188
],[
2,3,2,2,2,2,3,2,2,3,2,3,36,112,174,128,149,39,180,48
],[
2,3,2,2,2,3,2,2,3,2,2,2,129,178,99,120,241,203,28,127
],[
2,3,2,2,3,2,2,3,2,2,2,2,129,110,122,201,180,225,65,92
],[
2,3,2,3,2,2,3,2,2,3,2,3,138,242,145,33,85,128,96,142
],[
2,2,3,2,2,3,2,2,3,2,2,2,200,60,39,130,81,177,218,112
],[
2,2,2,2,3,2,2,3,2,2,2,2,169,130,30,192,169,243,183,114
],[
2,2,2,3,2,2,3,2,2,3,2,3,95,171,63,5,97,185,30,151
],[
2,2,3,2,2,3,2,2,3,2,2,2,97,212,182,77,2,231,222,245
],[
2,2,5,2,3,2,2,3,2,2,2,2,234,205,146,234,24,88,232,56
],[
2,2,2,3,2,2,3,2,2,3,2,3,120,153,70,1,181,91,211,32
],[
2,2,3,2,5,3,2,2,3,2,2,2,79,241,43,11,237,50,87,254
],[
2,3,2,2,3,5,2,3,2,2,2,2,244,193,252,86,88,146,210,59
],[
2,2,2,3,2,2,3,2,2,3,2,3,179,169,88,129,148,37,199,208
],[
2,2,3,2,2,3,2,5,3,2,2,2,25,126,68,3,192,11,89,207
],[
2,3,2,2,3,2,2,3,5,2,2,2,122,199,166,165,1,84,212,217
],[
2,2,2,3,2,2,3,2,2,3,2,3,108,64,203,3,1,136,37,166
],[
2,2,3,2,2,3,2,2,3,2,1,2,74,90,226,15,107,31,93,128
],[
178,185,126,142,112,9,50,200,7,181,24,153,69,40,126,112,240,218,139,29
]
]