aLevelData = [
[
10,2,2,8,2,2,2,2,2,2,2,2,2,2,196,98,134,148,166,169
],[
2,2,2,2,2,2,2,2,2,2,2,2,2,2,37,147,85,220,16,136
],[
2,2,2,2,2,2,3,3,3,3,2,2,2,2,150,248,93,255,87,136
],[
9,2,2,2,2,2,2,2,2,3,2,2,2,2,124,123,157,200,199,187
],[
3,3,3,3,3,3,3,2,2,3,2,2,2,2,189,9,89,59,207,87
],[
2,2,2,2,2,2,2,2,2,3,2,2,2,2,36,254,96,90,62,139
],[
103,122,124,54,122,70,66,160,66,23,153,129,45,240,130,165,98,169,139,53
],[
250,77,159,56,109,192,34,89,74,165,62,235,44,126,119,42,233,21,134,196
],[
12,28,100,152,134,16,165,189,160,99,7,198,52,217,75,68,29,51,67,141
],[
236,11,45,188,220,255,63,249,9,17,131,251,220,78,229,202,202,174,139,202
],[
62,60,100,245,211,118,4,104,199,247,175,33,173,83,179,7,97,67,251,42
],[
65,2,226,77,154,246,69,162,97,147,220,212,36,125,202,74,63,236,114,171
],[
83,85,141,157,244,71,121,211,162,147,212,70,251,175,74,194,46,92,171,165
],[
179,135,65,228,58,109,96,78,225,3,62,21,169,149,5,138,43,173,39,40
],[
135,54,242,212,158,225,100,99,129,200,64,93,40,82,97,0,104,86,79,136
],[
31,131,16,174,178,255,65,111,185,78,101,14,248,118,124,92,146,96,216,55
],[
121,130,44,81,41,187,230,51,150,126,190,129,98,51,143,127,84,218,102,212
],[
6,242,217,142,221,153,155,103,62,244,77,70,255,209,150,9,28,139,117,130
],[
172,46,214,191,19,220,100,143,120,112,159,65,122,96,46,175,30,232,118,124
],[
12,101,107,153,252,255,166,14,107,138,185,247,146,174,191,204,152,70,55,230
]
]