aLevelData = [
[
2,2,2,2,2,2,2,2,2,6,5,2,2,100,2,26,170,94,71,236
],[
2,3,5,3,5,5,5,3,5,3,5,2,5,141,235,66,87,124,212,167
],[
2,3,2,3,2,2,2,3,5,3,5,2,5,13,237,7,186,17,105,59
],[
2,2,2,2,2,2,2,2,2,2,2,2,5,100,121,61,215,134,115,115
],[
2,3,5,3,5,5,5,3,2,3,5,5,5,16,141,134,0,82,71,26
],[
2,3,5,3,5,5,5,3,2,3,5,5,5,63,226,245,59,158,193,161
],[
2,5,5,5,5,5,5,5,5,5,5,5,5,154,152,211,177,212,227,64
],[
2,3,5,3,5,5,5,3,5,3,5,5,5,189,247,234,27,158,67,125
],[
2,3,5,3,5,5,5,3,5,3,5,5,5,66,199,45,199,133,217,170
],[
2,5,5,5,5,5,5,5,5,5,5,5,5,129,10,113,169,102,239,68
],[
2,3,5,3,2,2,2,3,2,3,2,2,2,225,231,50,111,206,31,206
],[
5,3,5,3,2,2,2,3,2,3,2,2,2,8,246,9,39,249,113,241
],[
168,14,168,40,171,76,93,252,153,133,236,231,82,41,208,7,207,95,104,206
],[
6,84,251,251,13,211,251,201,131,23,134,102,44,221,50,166,219,189,10,249
],[
149,185,212,155,243,23,150,10,200,108,88,189,4,250,42,19,216,59,105,138
],[
27,190,63,49,237,50,105,96,154,193,61,166,193,159,235,3,181,226,3,87
],[
35,148,55,27,245,6,99,79,119,104,202,179,184,151,162,58,52,54,212,188
],[
175,0,253,235,100,92,184,136,95,50,31,215,40,254,143,80,161,35,172,151
],[
49,129,165,174,34,73,186,106,72,16,251,35,228,35,82,176,199,27,195,146
],[
187,177,243,112,30,211,231,196,208,247,15,211,80,175,131,226,33,125,140,167
]
]