aLevelData = [
[
2,2,3,3,3,3,3,3,3,3,3,3,3,3,3,3,193,54,166,92
],[
2,2,2,2,2,2,2,2,2,2,2,2,2,2,2,2,216,119,146,203
],[
3,2,3,3,3,3,3,3,3,3,3,2,3,3,3,2,46,205,203,174
],[
2,2,2,2,2,2,2,2,2,2,2,2,2,2,3,2,30,117,173,190
],[
3,2,3,3,3,3,3,3,3,3,3,3,3,2,3,2,11,150,206,13
],[
2,2,3,2,2,2,2,2,2,2,2,2,3,2,3,2,82,109,141,70
],[
124,167,238,54,185,14,165,139,138,104,112,220,189,156,170,234,158,23,30,38
],[
108,110,25,115,10,69,195,44,247,111,174,105,128,87,176,126,52,158,238,197
],[
153,5,58,158,29,142,159,179,79,222,57,129,79,230,74,20,131,194,139,17
],[
140,225,192,250,121,103,143,174,58,207,146,47,87,213,171,168,226,147,152,175
],[
170,234,199,199,177,35,107,41,224,214,207,196,250,11,234,130,207,160,53,205
],[
178,235,185,82,44,159,108,4,242,244,189,100,21,2,110,0,121,110,162,58
],[
136,73,55,75,39,53,85,136,233,202,71,227,131,56,138,180,129,45,36,186
],[
55,249,55,92,249,240,214,53,143,15,23,208,227,227,106,176,253,167,41,148
],[
49,173,112,249,151,255,46,223,188,69,124,208,151,233,46,31,191,122,168,110
],[
219,78,244,114,89,108,17,251,99,168,141,46,14,16,86,21,213,135,205,91
],[
71,176,28,80,252,14,201,51,205,105,140,177,68,115,94,169,82,171,211,50
],[
64,130,169,223,232,188,161,66,37,26,141,174,136,54,171,65,77,174,49,34
],[
141,132,41,8,181,197,127,252,54,105,89,95,126,123,166,46,40,122,250,133
],[
111,254,153,98,233,158,210,172,114,18,142,116,101,149,40,122,19,141,127,243
]
]