aLevelData = [
[
4,2,2,2,2,2,2,2,2,2,2,87,248,40,142,237,203,53,27,105
],[
5,2,5,3,2,2,2,2,2,2,2,48,187,171,147,95,98,84,255,47
],[
2,5,5,3,3,3,3,3,3,3,3,250,184,143,135,26,33,57,21,6
],[
3,3,5,5,5,5,5,5,5,5,3,209,10,67,214,147,107,103,213,150
],[
2,3,5,5,5,5,5,5,5,5,3,164,58,40,123,158,140,176,173,237
],[
3,3,5,5,5,5,3,3,3,3,3,54,49,241,13,79,179,62,236,163
],[
3,5,5,5,5,5,3,2,2,2,2,40,206,169,96,80,117,156,19,218
],[
3,5,5,3,3,3,3,8,2,2,2,50,150,211,204,4,106,188,36,254
],[
3,5,5,3,2,2,3,3,3,3,2,172,160,191,158,184,248,123,91,246
],[
3,5,5,3,2,2,2,2,2,3,2,33,153,125,93,197,101,49,54,151
],[
3,5,5,3,2,2,3,2,2,3,2,24,221,35,67,253,177,95,164,211
],[
5,5,5,3,2,2,3,2,2,3,2,127,71,56,115,204,26,210,178,39
],[
5,5,5,3,2,2,3,2,2,3,2,253,143,137,185,66,11,115,30,233
],[
5,3,3,3,2,2,3,2,2,3,2,213,23,115,103,32,39,176,167,187
],[
5,3,2,2,2,2,3,2,2,3,2,136,56,79,67,179,175,68,151,91
],[
5,3,3,2,2,2,3,2,5,5,5,12,112,140,80,239,195,226,163,52
],[
5,5,3,3,2,2,3,2,5,3,5,119,119,11,200,153,187,135,187,197
],[
5,5,5,5,3,3,3,2,5,3,5,100,69,151,49,99,195,241,236,22
],[
52,61,104,191,37,231,55,53,96,159,18,217,16,244,31,204,39,36,116,95
],[
253,50,215,203,57,58,199,35,245,2,193,134,29,209,188,153,24,132,246,52
]
]