aLevelData = [
[
2,2,2,2,5,5,2,2,2,2,117,98,17,15,166,26,66,175,108,23
],[
2,2,2,4,2,2,2,2,2,2,164,198,178,228,160,229,86,55,39,15
],[
5,3,3,3,5,5,3,3,3,3,221,211,255,192,101,174,90,45,218,79
],[
2,3,2,2,2,2,2,2,2,3,173,206,109,123,191,26,66,16,1,146
],[
2,3,2,2,2,2,2,2,2,3,105,49,29,0,16,163,209,1,247,119
],[
2,3,2,2,3,2,2,2,2,3,254,193,36,234,252,6,215,137,49,112
],[
2,3,2,2,3,2,2,2,2,3,192,153,226,255,112,181,72,213,14,185
],[
2,3,2,2,3,5,5,3,3,3,231,61,75,223,27,237,151,40,244,136
],[
2,3,3,2,3,2,2,3,2,2,150,254,67,103,205,23,245,153,162,156
],[
2,2,3,2,3,2,2,3,2,1,160,40,131,139,92,158,101,90,212,200
],[
2,2,3,2,3,2,2,3,2,2,112,221,157,186,248,105,198,19,176,58
],[
2,2,3,2,3,2,2,3,2,2,176,131,26,18,31,138,66,35,146,130
],[
2,2,2,2,3,2,2,3,2,2,172,47,208,223,139,238,196,182,51,176
],[
2,2,2,2,3,2,2,3,2,2,138,124,209,67,202,17,90,23,69,252
],[
2,2,2,2,3,2,2,3,2,2,193,160,173,249,109,252,186,177,234,214
],[
6,2,2,2,3,2,2,3,5,5,122,200,223,138,233,28,64,137,193,76
],[
8,2,2,2,3,2,2,3,5,5,196,0,147,120,154,180,23,72,88,48
],[
9,2,2,2,3,2,2,3,5,5,193,48,52,35,148,242,118,4,59,100
],[
45,247,86,115,33,244,18,104,10,38,252,106,255,145,23,68,49,248,43,105
],[
217,254,97,53,111,139,13,118,29,113,203,43,115,80,205,140,92,183,115,74
]
]