aLevelData = [
[
4,2,2,2,2,203,97,188,4,23,77,206,143,107,173,219,34,202,135,163
],[
5,2,5,3,2,6,166,152,192,1,2,232,231,132,212,162,107,36,173,35
],[
2,5,5,3,3,2,78,155,81,204,55,79,46,145,19,123,173,75,135,126
],[
3,3,5,5,5,196,228,96,67,194,64,133,102,227,126,42,153,33,123,71
],[
2,3,5,5,5,71,78,152,73,119,96,190,7,242,12,159,247,168,150,62
],[
3,3,5,5,5,162,80,231,177,85,79,224,37,26,219,238,36,230,96,222
],[
3,5,5,5,5,19,20,34,243,255,18,37,54,153,91,74,14,126,165,186
],[
3,5,5,3,3,16,188,91,135,24,146,77,145,153,120,167,167,49,95,31
],[
3,5,5,3,2,239,129,58,115,136,59,189,19,109,124,101,26,157,93,184
],[
3,5,5,3,2,131,121,197,206,154,109,129,16,176,210,150,64,19,19,213
],[
3,5,5,3,2,186,62,15,177,249,76,191,78,92,179,25,218,42,46,52
],[
5,5,5,3,2,32,213,251,172,90,123,71,72,71,178,231,218,126,133,72
],[
5,5,5,3,2,103,2,186,169,136,22,87,135,16,83,100,89,239,247,241
],[
5,3,3,3,2,126,87,128,91,116,29,122,204,74,97,149,1,88,113,250
],[
5,3,2,2,2,80,45,235,223,233,201,34,89,92,13,195,114,91,111,185
],[
5,3,3,2,2,124,193,242,77,165,212,86,146,203,199,139,0,145,132,108
],[
5,5,3,3,2,95,178,168,170,231,149,206,6,165,34,16,196,32,213,203
],[
5,5,5,5,3,92,61,16,163,114,96,182,199,8,212,245,118,243,109,99
],[
195,139,107,77,149,167,162,75,241,201,216,24,124,149,111,161,59,136,68,92
],[
158,230,214,219,189,244,171,161,225,104,239,52,70,30,95,116,31,12,101,42
]
]