aLevelData = [
[
5,5,3,5,5,5,5,5,5,5,3,5,5,5,147,62,199,58,169,55
],[
4,2,3,5,5,5,5,5,5,5,3,5,5,5,106,234,17,217,58,151
],[
2,2,3,2,3,3,3,3,3,2,3,3,3,3,242,186,73,158,137,57
],[
5,2,2,2,3,2,2,2,2,2,5,5,5,5,66,136,131,90,242,133
],[
170,209,7,22,196,92,24,9,184,86,230,170,243,138,226,56,10,69,239,150
],[
161,175,104,67,139,90,101,140,51,28,58,0,58,26,65,37,97,38,218,105
],[
170,75,175,91,186,165,61,27,130,118,144,15,30,119,77,216,253,108,246,133
],[
67,251,106,6,107,190,171,227,49,151,228,46,175,68,171,182,198,51,131,125
],[
191,151,165,108,50,187,0,70,39,150,126,219,124,161,137,126,135,229,206,184
],[
251,88,64,62,16,105,96,33,222,218,188,69,10,206,182,20,165,35,135,115
],[
81,1,132,245,166,179,159,79,212,182,48,13,137,16,246,131,21,227,88,5
],[
204,66,241,91,171,67,76,111,63,86,236,73,195,213,144,61,137,220,181,99
],[
155,90,91,72,161,104,12,227,5,218,27,203,86,20,42,167,234,32,238,229
],[
200,253,55,175,196,57,42,26,236,194,209,161,35,249,215,211,12,8,140,72
],[
42,117,47,217,69,248,109,16,15,138,37,222,7,191,110,140,158,85,219,244
],[
152,13,254,241,182,185,42,20,146,151,125,153,202,221,30,153,96,149,196,129
],[
97,171,120,194,197,69,155,202,151,82,42,52,86,102,65,59,154,197,222,117
],[
250,190,232,190,46,58,112,113,113,148,54,223,41,171,111,249,202,54,197,80
],[
248,88,160,64,236,117,164,103,24,67,123,92,14,36,212,158,158,179,171,203
],[
62,156,203,19,176,178,146,235,222,59,245,6,9,142,195,129,34,225,46,94
]
]