aLevelData = [
[
4,2,2,2,2,2,2,2,2,2,8,2,2,2,2,3,2,64,235,213
],[
2,2,3,2,9,2,2,2,2,2,2,2,2,3,2,2,3,69,163,238
],[
2,3,2,2,2,2,3,2,2,3,2,3,2,2,3,2,2,139,38,44
],[
2,3,2,2,2,3,2,2,3,2,2,2,3,2,2,3,2,7,98,120
],[
2,3,2,2,3,2,2,3,2,2,2,2,2,3,2,2,3,243,190,86
],[
148,246,236,105,197,105,195,151,101,77,14,11,66,68,186,147,71,164,150,82
],[
88,202,87,181,125,177,223,168,67,195,191,9,95,238,250,92,149,251,12,193
],[
216,27,42,36,179,195,204,180,231,186,105,150,86,113,129,218,31,146,225,174
],[
11,219,35,209,40,45,116,75,179,224,154,92,59,90,53,178,4,224,68,222
],[
170,171,236,9,6,63,117,227,85,248,150,221,151,230,242,152,54,219,226,157
],[
232,193,117,78,214,49,181,29,254,66,44,251,214,159,167,19,50,221,58,185
],[
103,11,132,157,177,138,52,69,210,31,204,186,252,70,166,129,241,201,52,204
],[
105,146,139,242,180,189,35,29,160,242,216,66,157,242,53,87,31,111,242,192
],[
68,33,187,10,183,22,52,219,212,74,57,41,13,119,106,171,140,46,231,141
],[
25,39,88,104,63,214,49,113,170,62,52,241,212,10,55,245,225,218,39,70
],[
199,219,77,155,177,154,208,14,166,26,123,205,101,36,193,18,148,222,254,85
],[
26,159,0,192,202,2,198,227,65,57,135,169,17,164,247,138,31,162,197,3
],[
73,168,104,67,76,144,27,40,229,51,38,105,55,57,96,21,109,48,242,60
],[
160,220,93,235,251,206,191,94,29,56,82,114,190,0,53,89,150,19,111,145
],[
122,252,49,23,201,181,91,216,6,189,66,104,198,106,176,246,205,129,45,128
]
]