aLevelData = [
[
2,2,3,3,3,3,3,3,3,3,3,3,3,3,3,195,246,189,53,145
],[
2,2,2,2,2,2,2,2,2,2,2,2,2,2,2,161,183,145,229,181
],[
3,2,3,3,3,3,3,3,3,3,3,2,3,3,3,142,22,119,213,228
],[
2,2,2,2,2,2,2,2,2,2,2,2,2,2,3,45,34,69,128,214
],[
3,2,3,3,3,3,3,3,3,3,3,3,3,2,3,244,173,252,143,129
],[
2,2,3,2,2,2,2,2,2,2,2,2,3,2,3,25,189,121,124,67
],[
3,2,3,2,2,3,3,3,3,3,3,3,3,2,3,41,182,136,21,19
],[
2,2,3,2,2,3,2,2,2,2,2,3,3,2,3,21,75,106,122,241
],[
2,3,3,2,2,3,3,3,3,2,2,2,2,2,3,196,21,116,86,223
],[
2,2,2,2,2,2,2,2,2,3,2,3,2,2,3,36,101,102,71,102
],[
116,251,124,42,64,142,37,74,206,88,167,104,199,182,246,120,224,210,172,126
],[
153,128,88,153,42,102,24,65,186,96,106,205,211,35,63,56,19,32,81,36
],[
36,171,183,31,238,92,182,38,10,181,219,103,122,6,70,75,152,142,73,180
],[
77,227,50,132,131,148,100,94,221,12,173,176,165,185,211,241,6,110,112,39
],[
123,6,0,173,135,75,57,51,167,22,155,6,133,183,71,146,110,150,20,37
],[
6,27,224,245,58,204,36,101,119,181,203,132,25,13,69,214,39,22,215,88
],[
61,69,53,190,201,163,82,255,122,115,119,19,246,21,147,251,204,42,210,3
],[
169,249,112,68,206,18,208,108,193,48,200,194,67,100,63,100,131,112,251,211
],[
145,113,180,178,21,194,109,203,65,28,4,83,4,2,7,111,129,92,201,247
],[
191,98,181,121,162,187,227,129,26,230,233,23,154,218,244,138,204,233,23,108
]
]