aLevelData = [
[
6,2,8,2,9,2,10,2,11,3,2,2,5,2,2,2,5,2,2,4
],[
2,2,2,2,2,2,2,2,12,3,5,2,2,2,5,2,2,2,5,2
],[
2,2,3,3,3,3,3,3,3,3,2,2,3,3,3,3,3,3,2,2
],[
2,2,3,2,2,2,2,2,2,2,5,2,3,2,2,2,2,3,2,2
],[
2,2,3,2,2,2,2,2,2,2,2,2,3,2,2,2,2,3,2,2
],[
2,2,3,2,3,3,3,3,3,3,2,5,3,2,2,2,2,2,2,2
],[
2,2,3,2,2,2,2,5,5,3,2,2,3,2,2,2,2,2,2,2
],[
74,71,210,162,15,158,29,16,21,218,188,116,103,172,49,150,188,189,14,19
],[
76,55,100,2,226,134,127,216,51,96,208,137,110,2,43,240,20,189,51,113
],[
10,178,18,221,237,218,109,149,165,73,150,243,61,179,4,229,241,47,1,219
],[
137,59,163,228,230,0,253,19,219,216,150,40,62,14,27,108,62,229,80,221
],[
246,219,76,139,67,46,230,66,211,160,107,105,127,119,146,42,219,201,177,212
],[
11,246,48,125,216,118,62,235,3,213,196,181,216,251,151,165,7,177,242,97
],[
176,97,35,74,189,29,132,165,116,227,173,249,76,32,232,183,0,114,230,32
],[
227,178,176,100,115,50,223,7,48,67,16,137,175,251,147,70,234,53,99,155
],[
218,216,91,74,72,93,166,32,224,139,120,213,135,133,251,51,238,7,141,122
],[
103,237,40,4,248,245,33,37,174,197,22,85,52,48,34,145,164,181,82,254
],[
157,72,93,208,150,86,143,106,114,3,7,198,84,182,34,24,180,215,55,174
],[
179,215,133,27,171,113,105,148,11,48,213,154,98,50,253,218,185,43,83,81
],[
38,172,182,179,158,166,230,14,11,42,60,170,158,114,152,53,103,37,154,28
]
]