aLevelData = [
[
5,5,3,5,5,5,5,5,5,160,226,154,45,177,25,246,83,207,77,235
],[
4,2,3,5,5,5,5,5,5,250,133,114,241,205,158,176,219,97,46,92
],[
2,2,3,2,3,3,3,3,3,255,197,215,38,150,90,69,148,102,228,251
],[
5,2,2,2,3,2,2,2,2,175,158,226,82,252,1,27,190,173,70,122
],[
2,2,2,3,2,2,2,2,2,84,25,191,27,137,106,58,166,61,149,37
],[
2,2,2,3,2,2,5,3,3,220,248,144,245,111,115,191,200,23,90,175
],[
2,2,2,2,2,2,5,5,3,72,226,80,6,211,204,52,186,218,143,162
],[
5,2,2,2,2,2,5,5,3,130,135,188,189,138,163,11,44,107,182,239
],[
2,2,5,5,3,2,5,5,3,99,90,112,110,36,159,71,48,69,74,98
],[
2,2,5,5,3,2,5,5,3,214,179,33,182,141,183,220,111,226,120,149
],[
2,2,3,3,3,2,5,5,3,145,216,194,122,223,55,5,197,252,40,161
],[
2,2,3,2,2,2,5,5,3,238,208,255,96,30,45,88,68,232,178,101
],[
2,2,3,2,2,2,5,5,3,132,52,240,134,209,123,204,26,221,58,36
],[
2,2,3,2,5,2,3,3,3,150,30,160,182,212,208,138,61,173,57,178
],[
220,201,48,35,192,182,224,241,2,56,202,38,202,224,9,255,186,224,218,89
],[
138,30,91,102,239,135,147,164,194,166,179,16,94,117,155,151,74,115,160,205
],[
24,246,141,225,140,195,231,209,1,220,118,218,9,153,0,51,84,250,88,250
],[
211,60,152,111,28,170,170,96,17,182,13,228,188,72,213,76,126,86,244,87
],[
105,181,185,165,234,47,150,110,171,213,38,116,183,150,110,54,224,17,100,103
],[
94,168,173,158,184,214,171,79,232,194,183,250,186,20,171,162,117,7,164,129
]
]