aLevelData = [
[
2,2,2,2,2,11,191,43,147,129,178,226,251,228,252,234,111,29,206,64
],[
2,2,2,2,2,2,78,38,8,209,27,126,255,49,107,123,125,143,2,226
],[
5,2,5,2,5,5,10,233,57,181,106,124,163,76,103,127,239,167,209,16
],[
5,2,5,2,5,2,16,3,194,111,156,171,38,106,114,17,123,24,160,29
],[
5,5,5,2,5,5,214,202,132,197,39,63,49,222,189,23,19,50,13,138
],[
5,2,5,2,5,2,215,210,175,90,133,174,169,6,239,98,240,65,79,83
],[
5,2,5,2,5,2,44,162,44,251,188,157,125,129,250,178,17,141,192,228
],[
2,2,2,12,2,2,46,90,43,109,121,13,158,176,21,69,10,111,15,243
],[
2,2,7,2,2,2,109,62,250,108,153,56,214,188,55,240,55,61,11,171
],[
2,2,7,2,5,5,163,105,122,204,59,237,73,143,157,254,167,250,10,240
],[
110,17,196,5,166,74,186,131,75,64,103,9,79,171,248,34,227,144,173,27
],[
243,181,129,18,239,88,13,80,209,32,170,217,92,84,214,64,161,75,217,192
],[
200,36,168,137,13,183,9,88,9,202,248,74,51,137,73,242,166,48,144,169
],[
37,11,62,37,92,160,12,78,104,43,157,76,154,74,94,229,120,250,178,6
],[
5,194,76,159,67,46,219,180,245,127,237,178,169,161,13,255,246,93,47,212
],[
3,208,79,79,72,28,84,196,153,93,58,85,96,223,112,194,42,142,127,130
],[
101,173,237,18,103,203,97,141,179,243,7,125,120,36,54,240,91,0,81,207
],[
118,200,235,108,161,136,46,90,240,143,125,129,125,34,88,113,103,114,128,247
],[
26,203,92,238,209,13,156,88,90,96,28,174,25,36,11,116,80,39,76,15
],[
158,27,28,219,197,71,246,121,176,124,179,102,180,75,246,210,22,117,199,175
]
]