aLevelData = [
[
2,2,2,2,2,2,2,2,2,2,2,2,2,2,2,2,2,2,34,91
],[
2,2,2,2,2,2,2,2,2,2,2,2,2,2,2,2,2,2,206,208
],[
2,2,2,2,2,2,2,2,2,2,2,2,2,2,2,2,2,2,172,161
],[
2,2,2,3,3,3,3,3,3,3,3,3,3,3,3,3,3,3,150,239
],[
2,2,2,2,2,2,2,2,2,2,2,2,2,2,2,2,2,2,42,213
],[
2,2,2,2,2,2,2,2,2,2,2,2,2,2,2,2,2,2,41,225
],[
2,2,2,2,2,3,2,2,3,2,2,3,2,2,2,3,2,2,142,55
],[
2,2,2,3,3,3,3,3,3,3,3,3,3,3,3,3,3,3,158,243
],[
2,2,2,2,2,2,2,2,2,2,2,2,2,2,2,2,2,2,69,140
],[
2,2,2,2,2,2,2,2,2,2,2,2,2,2,2,2,2,2,115,58
],[
2,2,3,3,3,3,3,3,3,3,3,3,3,3,3,3,3,3,95,182
],[
2,2,2,2,2,2,2,2,2,2,2,2,2,2,2,2,2,3,210,201
],[
2,2,2,2,2,2,2,2,2,2,2,2,2,2,2,2,2,3,239,135
],[
2,2,3,3,3,3,3,3,3,2,2,3,3,3,3,3,3,3,18,39
],[
2,2,3,2,2,2,2,2,2,2,2,2,2,2,2,2,2,2,181,215
],[
2,2,3,2,2,2,2,2,2,2,2,2,2,2,2,2,2,2,129,1
],[
2,2,3,3,3,3,2,2,2,2,2,2,2,2,2,2,2,2,250,212
],[
2,2,2,2,2,3,2,2,2,2,2,2,2,2,2,2,2,2,97,27
],[
3,3,3,3,2,3,2,2,2,2,2,2,2,2,2,2,2,2,188,154
],[
2,2,2,2,2,3,2,2,2,2,2,2,1,2,2,2,2,2,48,140
]
]