aLevelData = [
[
12,2,2,2,2,2,2,2,224,91,247,109,222,254,112,22,227,48,91,18
],[
2,2,2,2,2,2,2,2,242,51,255,94,171,124,15,174,121,20,127,249
],[
2,2,3,3,3,3,3,3,12,62,149,55,10,90,67,106,1,9,180,219
],[
11,2,3,2,2,2,2,2,161,146,37,166,40,133,246,120,29,158,1,152
],[
2,2,3,2,2,2,2,2,65,235,42,36,195,49,55,158,179,141,227,167
],[
2,2,3,2,2,2,2,2,185,87,45,9,7,75,246,251,140,235,203,161
],[
10,2,3,2,2,2,2,2,106,31,0,211,171,31,254,31,47,146,221,17
],[
2,2,3,2,2,2,2,2,233,248,54,177,76,69,50,78,255,206,231,122
],[
2,2,3,2,2,2,2,3,216,105,229,86,8,208,11,16,147,71,160,169
],[
9,2,3,2,2,2,2,3,4,127,159,252,94,185,81,252,85,46,33,61
],[
2,2,3,2,2,2,3,2,190,175,173,182,69,137,25,197,94,171,168,115
],[
2,2,3,2,2,3,2,2,126,11,141,250,138,69,254,132,144,133,139,54
],[
8,2,3,2,2,3,2,2,181,168,174,109,110,158,163,71,243,19,121,102
],[
2,2,3,2,3,3,2,2,241,78,106,240,127,89,104,218,84,98,248,103
],[
2,2,3,2,3,2,2,2,55,97,67,235,182,251,106,213,27,166,27,236
],[
6,2,3,2,3,2,2,2,156,15,98,217,210,185,193,230,109,230,130,5
],[
37,186,76,20,244,158,245,95,130,227,151,103,225,167,230,226,122,253,192,2
],[
71,72,6,250,67,232,171,191,31,25,10,11,55,23,125,168,196,135,43,235
],[
83,18,33,127,118,83,165,99,185,243,198,54,215,18,56,179,46,233,95,120
],[
113,174,170,11,157,184,34,30,46,228,67,18,146,55,10,187,222,197,79,99
]
]