aLevelData = [
[
5,5,5,5,5,255,93,141,147,114,240,87,238,121,212,250,84,147,226,254
],[
5,2,2,2,2,4,147,239,238,37,150,244,247,8,56,109,178,174,8,254
],[
5,2,5,3,3,61,138,57,92,144,135,154,107,14,77,200,164,91,192,161
],[
2,2,5,2,3,186,110,202,253,125,231,91,153,254,162,174,84,244,140,205
],[
2,2,3,2,3,158,94,181,87,45,106,167,129,241,150,247,91,75,21,25
],[
2,2,3,2,3,85,122,116,120,1,86,125,198,26,64,92,145,198,89,0
],[
4,2,3,2,2,24,24,242,196,92,217,68,79,122,136,97,184,55,159,107
],[
2,2,3,2,2,238,221,24,4,88,70,48,5,184,54,107,115,85,238,216
],[
2,2,2,2,2,175,89,253,150,236,120,90,151,230,210,176,164,210,27,249
],[
2,3,2,2,2,161,144,249,78,19,40,173,253,223,116,246,221,84,26,50
],[
2,3,2,2,2,222,108,190,199,228,79,117,193,214,25,124,189,241,221,42
],[
2,3,2,3,3,5,99,234,35,252,21,77,207,189,200,151,10,255,99,224
],[
2,3,2,3,6,29,60,139,11,237,18,117,76,115,233,248,232,108,214,231
],[
2,3,2,3,8,60,82,191,157,1,138,192,217,206,223,206,205,222,47,154
],[
2,3,2,3,9,113,20,100,184,29,60,166,1,87,148,208,54,234,139,32
],[
2,3,2,3,10,230,56,200,50,145,208,110,47,13,67,159,66,41,52,63
],[
75,145,175,250,216,241,188,136,81,93,51,47,114,241,209,138,254,180,140,138
],[
178,194,36,186,120,171,251,199,222,22,38,63,198,170,196,153,95,46,142,118
],[
84,238,176,38,67,97,216,110,112,10,140,136,187,156,192,108,207,97,168,78
],[
157,220,203,104,9,174,89,249,226,182,190,142,24,124,119,128,41,208,36,190
]
]