aLevelData = [
[
2,2,2,2,2,2,2,2,2,2,2,2,2,2,2,125,181,69,158,97
],[
2,2,2,2,2,2,2,2,2,2,2,2,2,2,2,222,137,214,244,184
],[
2,2,2,2,2,2,2,2,2,2,2,2,2,2,2,131,141,25,168,213
],[
2,2,2,3,3,3,3,3,3,3,3,3,3,3,3,117,14,7,64,213
],[
2,2,2,2,2,2,2,2,2,2,2,2,2,2,2,75,121,175,126,173
],[
2,2,2,2,2,2,2,2,2,2,2,2,2,2,2,122,119,1,211,58
],[
2,2,2,2,2,3,2,2,3,2,2,3,2,2,2,221,31,201,171,217
],[
2,2,2,3,3,3,3,3,3,3,3,3,3,3,3,129,227,216,25,170
],[
2,2,2,2,2,2,2,2,2,2,2,2,2,2,2,236,120,73,41,128
],[
2,2,2,2,2,2,2,2,2,2,2,2,2,2,2,195,146,19,183,132
],[
2,2,3,3,3,3,3,3,3,3,3,3,3,3,3,96,176,4,112,105
],[
2,2,2,2,2,2,2,2,2,2,2,2,2,2,2,117,92,182,235,50
],[
2,2,2,2,2,2,2,2,2,2,2,2,2,2,2,154,215,52,141,34
],[
2,2,3,3,3,3,3,3,3,2,2,3,3,3,3,184,104,175,196,246
],[
2,2,3,2,2,2,2,2,2,2,2,2,2,2,2,127,61,228,121,141
],[
2,2,3,2,2,2,2,2,2,2,2,2,2,2,2,138,216,76,70,11
],[
2,2,3,3,3,3,2,2,2,2,2,2,2,2,2,146,171,193,11,127
],[
2,2,2,2,2,3,2,2,2,2,2,2,2,2,2,94,124,159,174,70
],[
161,221,53,54,135,73,209,4,124,144,204,223,194,121,36,226,215,24,233,234
],[
249,69,231,165,234,76,133,236,241,230,237,83,33,104,109,254,221,59,29,182
]
]