aLevelData = [
[
6,2,2,2,2,210,164,136,2,150,134,162,182,173,224,243,227,4,127,102
],[
2,2,2,2,2,216,127,74,152,207,59,117,57,195,22,248,180,134,113,64
],[
2,2,2,2,2,18,14,52,36,27,15,19,26,191,208,16,171,181,55,65
],[
3,3,3,3,3,36,98,37,212,143,252,10,80,225,239,176,29,117,128,91
],[
2,2,2,2,2,71,185,176,20,127,40,99,66,99,120,193,122,255,20,221
],[
2,2,2,2,2,152,147,204,148,15,150,203,185,125,252,202,111,131,181,132
],[
2,2,2,2,2,213,211,118,106,233,138,187,151,166,193,13,6,112,94,128
],[
2,2,3,3,3,3,178,48,129,223,198,60,206,232,21,81,198,152,127,227
],[
2,2,2,2,2,227,13,253,22,133,185,132,24,241,91,45,180,153,46,148
],[
2,2,2,2,2,36,158,96,125,39,147,197,190,84,132,205,89,174,54,180
],[
3,3,3,3,3,232,120,177,248,62,75,252,16,75,101,40,91,64,68,143
],[
2,2,2,2,2,87,244,116,94,19,134,165,81,231,69,0,190,98,204,187
],[
2,2,2,2,2,213,132,113,235,38,45,225,154,100,214,4,26,104,127,39
],[
152,120,232,89,244,202,4,21,209,68,171,34,232,134,143,184,161,42,113,228
],[
228,74,149,45,44,67,115,120,222,185,175,41,218,220,75,139,79,233,28,114
],[
211,243,122,31,179,227,60,99,135,190,228,8,10,38,22,108,41,36,79,111
],[
90,36,211,143,47,65,231,82,43,195,65,229,212,230,189,2,9,222,81,22
],[
150,23,67,164,6,193,153,228,185,140,210,177,54,176,211,162,193,49,36,118
],[
49,97,92,181,252,166,218,148,148,125,182,25,246,191,247,129,127,36,7,223
],[
2,5,100,5,25,102,151,167,184,51,106,190,8,202,86,43,114,186,59,157
]
]