aLevelData = [
[
10,2,2,8,2,2,2,2,2,2,14,59,231,123,105,79,131,97,197,83
],[
2,2,2,2,2,2,2,2,2,2,111,246,60,137,51,175,64,48,106,206
],[
2,2,2,2,2,2,3,3,3,3,221,177,35,51,62,25,134,117,115,203
],[
9,2,2,2,2,2,2,2,2,3,187,49,113,119,7,162,90,70,56,114
],[
3,3,3,3,3,3,3,2,2,3,255,87,68,208,164,111,45,195,3,236
],[
2,2,2,2,2,2,2,2,2,3,39,190,147,251,253,116,9,11,177,237
],[
2,2,2,2,2,2,2,2,2,3,31,130,99,218,149,174,115,38,118,254
],[
2,2,2,2,2,2,2,2,2,2,234,205,157,114,22,241,119,80,117,43
],[
2,2,2,2,2,2,2,2,2,2,11,25,213,31,55,187,184,83,60,8
],[
2,2,2,2,3,3,3,3,2,2,253,65,125,103,189,170,131,201,116,46
],[
2,2,2,2,3,2,2,3,2,2,69,223,97,26,166,139,47,129,64,148
],[
2,2,2,2,3,2,2,3,2,2,212,142,96,157,186,24,81,88,28,119
],[
2,2,2,2,3,2,2,3,2,2,222,247,180,150,18,227,147,74,66,177
],[
2,2,2,2,3,2,2,3,2,2,80,226,78,82,100,0,35,137,213,167
],[
2,2,2,2,3,2,2,3,2,2,132,162,18,148,11,98,30,210,106,58
],[
2,2,2,2,3,2,2,3,2,2,241,137,247,191,28,23,104,95,171,97
],[
2,2,2,2,3,2,2,3,2,2,218,76,79,107,25,189,189,39,27,86
],[
81,139,205,228,247,230,19,78,75,116,9,201,255,48,144,74,125,233,6,65
],[
206,152,84,132,187,241,46,137,50,56,150,217,235,86,162,193,74,44,128,75
],[
136,39,183,109,14,21,175,127,33,55,116,242,196,151,183,64,218,155,22,31
]
]