aLevelData = [
[
5,5,3,5,206,244,237,118,116,222,227,185,119,170,58,191,133,100,163,5
],[
4,2,3,5,115,153,65,175,37,177,176,124,175,127,70,250,185,23,152,246
],[
2,2,3,2,40,224,64,55,251,234,222,108,114,129,93,98,118,2,120,122
],[
5,2,2,2,53,237,124,91,13,60,79,228,171,243,177,100,116,249,194,14
],[
2,2,2,3,35,38,196,167,180,157,35,130,130,92,178,174,172,17,56,110
],[
2,2,2,3,188,47,43,233,139,66,187,35,95,128,19,44,87,160,219,152
],[
2,2,2,2,9,239,1,46,105,160,185,229,237,99,194,12,238,58,235,200
],[
5,2,2,2,82,136,215,195,104,107,253,35,19,76,242,185,43,181,235,123
],[
2,2,5,5,32,98,126,53,224,154,168,123,251,192,20,226,5,37,154,112
],[
2,2,5,5,61,32,7,80,107,97,28,202,15,130,217,115,183,223,251,161
],[
2,2,3,3,177,168,195,34,226,52,249,46,246,152,49,153,186,121,77,77
],[
197,30,67,248,94,201,32,2,154,72,77,194,197,199,17,241,3,232,88,95
],[
55,22,179,228,36,22,159,154,211,222,10,73,52,171,19,35,7,78,18,178
],[
253,198,216,14,27,20,56,83,96,75,198,82,167,231,222,135,207,95,232,76
],[
24,254,219,75,208,238,0,57,48,150,249,194,129,38,1,191,130,111,117,175
],[
14,249,148,101,250,79,131,254,61,158,147,22,83,126,199,60,227,16,145,162
],[
159,73,221,25,107,141,80,61,194,128,210,237,86,25,74,255,247,248,168,49
],[
182,249,41,98,74,9,214,2,179,56,79,199,29,16,198,161,6,37,78,241
],[
163,238,86,246,128,211,112,135,104,135,88,8,132,152,49,151,198,69,17,134
],[
137,143,192,14,113,147,189,65,153,22,130,65,237,98,9,176,212,81,143,103
]
]