aLevelData = [
[
2,2,2,2,2,2,2,2,2,2,2,2,2,2,2,44,237,108,219,57
],[
2,2,13,5,5,2,2,12,5,5,2,3,2,5,5,204,252,226,64,161
],[
2,2,2,5,5,2,2,2,5,5,2,3,2,5,5,252,166,235,2,250
],[
2,2,2,2,2,2,2,2,2,2,2,3,2,2,2,141,212,171,16,86
],[
2,2,2,2,2,2,2,2,2,2,2,3,3,3,3,144,114,12,173,236
],[
2,2,2,2,2,2,2,2,2,2,2,2,2,2,6,125,207,252,118,178
],[
2,2,2,2,2,2,2,2,2,2,2,2,2,3,3,243,133,64,111,177
],[
2,2,2,2,2,2,2,2,2,2,2,2,2,2,2,174,224,123,1,155
],[
187,61,2,2,132,44,157,59,255,135,101,151,11,70,194,243,223,80,79,141
],[
148,238,128,22,228,128,136,8,49,111,122,57,200,98,174,177,104,181,102,184
],[
254,39,177,52,179,210,144,50,40,97,88,195,0,125,87,9,160,136,186,145
],[
50,142,174,227,240,120,198,88,159,131,157,44,89,241,188,212,144,255,190,146
],[
80,22,178,70,196,69,192,135,252,239,16,242,237,193,231,194,186,231,19,162
],[
50,128,138,191,153,79,78,32,171,179,147,58,222,217,36,191,232,48,3,184
],[
129,29,79,211,106,241,107,254,174,24,93,52,40,146,116,151,69,168,46,192
],[
11,215,88,83,90,17,119,214,114,37,103,195,182,123,66,219,176,4,132,190
],[
84,113,108,185,137,163,165,223,229,99,37,91,184,84,86,4,77,37,115,50
],[
108,11,53,208,35,111,176,179,199,228,119,42,53,91,7,215,93,154,99,189
],[
2,234,251,153,187,16,210,118,62,127,224,124,221,204,182,9,81,98,96,3
],[
183,119,143,108,216,63,248,54,173,95,247,89,35,164,120,36,27,245,23,208
]
]