aLevelData = [
[
4,2,2,2,2,2,2,2,2,2,2,2,2,250,223,3,84,150,218,223
],[
5,2,5,3,2,2,2,2,2,2,2,2,2,144,178,92,27,217,29,134
],[
2,5,5,3,3,3,3,3,3,3,3,3,3,159,136,161,137,40,116,136
],[
3,3,5,5,5,5,5,5,5,5,3,2,2,25,238,7,94,30,132,152
],[
2,3,5,5,5,5,5,5,5,5,3,6,2,249,172,255,244,183,53,90
],[
3,3,5,5,5,5,3,3,3,3,3,3,3,62,7,253,25,250,43,207
],[
3,5,5,5,5,5,3,2,2,2,2,2,2,45,100,60,239,24,6,110
],[
3,5,5,3,3,3,3,8,2,2,2,5,5,79,81,137,149,5,234,204
],[
3,5,5,3,2,2,3,3,3,3,2,5,3,232,253,112,51,5,235,19
],[
3,5,5,3,2,2,2,2,2,3,2,5,3,66,54,132,6,106,243,238
],[
3,5,5,3,2,2,3,2,2,3,2,5,3,41,34,168,117,230,58,184
],[
5,5,5,3,2,2,3,2,2,3,2,5,3,127,88,108,193,194,179,53
],[
5,5,5,3,2,2,3,2,2,3,2,5,3,34,180,224,227,186,67,103
],[
5,3,3,3,2,2,3,2,2,3,2,5,2,238,243,199,146,139,255,53
],[
5,3,2,2,2,2,3,2,2,3,2,5,2,208,127,98,149,87,49,177
],[
5,3,3,2,2,2,3,2,5,5,5,5,2,182,13,4,153,32,169,227
],[
5,5,3,3,2,2,3,2,5,3,5,5,3,34,74,21,30,53,13,23
],[
5,5,5,5,3,3,3,2,5,3,5,5,2,116,93,89,49,113,202,39
],[
5,5,5,5,5,5,3,2,5,3,5,5,2,198,250,155,174,125,38,93
],[
218,235,79,206,250,108,105,231,185,81,147,26,79,65,236,217,248,217,168,87
]
]