aLevelData = [
[
5,5,3,5,5,5,5,5,5,5,3,5,5,5,5,5,44,211,237,33
],[
4,2,3,5,5,5,5,5,5,5,3,5,5,5,5,5,238,121,120,70
],[
2,2,3,2,3,3,3,3,3,2,3,3,3,3,3,5,102,151,197,173
],[
5,2,2,2,3,2,2,2,2,2,5,5,5,5,5,5,139,93,16,46
],[
2,2,2,3,2,2,2,2,2,2,5,5,5,5,5,5,35,138,242,144
],[
2,2,2,3,2,2,5,3,3,2,3,3,3,3,3,5,40,59,226,252
],[
2,2,2,2,2,2,5,5,3,2,2,2,2,2,2,2,111,0,251,177
],[
5,2,2,2,2,2,5,5,3,2,2,2,2,2,2,2,140,53,0,250
],[
240,144,157,93,84,246,239,22,91,147,71,196,114,41,43,97,251,168,158,119
],[
172,0,162,145,49,51,250,240,25,174,52,128,239,217,231,11,167,237,58,171
],[
61,6,165,133,152,121,252,180,180,103,169,132,0,146,56,225,5,112,26,15
],[
73,126,162,155,115,215,84,145,175,5,95,239,84,23,104,90,197,243,137,16
],[
149,238,154,30,238,154,175,211,51,223,225,116,228,78,82,49,194,177,107,88
],[
52,231,104,201,234,239,23,170,192,66,220,91,229,102,249,172,60,192,12,78
],[
2,170,217,136,178,197,74,43,37,144,180,200,254,58,92,32,69,181,58,220
],[
82,12,253,127,237,246,79,152,179,171,89,60,188,246,138,179,122,140,148,114
],[
228,156,184,73,212,167,68,222,174,146,90,90,67,250,242,98,245,199,34,73
],[
27,4,158,132,167,238,123,94,6,74,56,237,71,252,254,68,128,214,39,234
],[
109,174,254,139,91,179,197,238,68,1,253,39,60,114,225,14,11,183,52,239
],[
28,168,60,131,150,217,15,31,200,110,13,44,202,48,174,215,97,224,126,9
]
]