aLevelData = [
[
5,5,5,5,5,2,2,83,239,56,113,55,135,222,117,141,156,155,140,161
],[
5,2,2,2,2,2,2,153,60,31,196,216,198,240,68,194,10,90,155,55
],[
5,2,5,3,3,3,3,123,219,231,48,61,207,154,162,126,126,115,166,9
],[
2,2,5,2,3,2,2,89,173,216,24,129,118,252,106,137,162,232,150,125
],[
161,158,159,35,174,184,200,128,74,9,170,158,233,129,131,141,235,81,209,168
],[
205,80,32,25,161,157,32,160,187,134,250,144,174,169,228,26,119,89,244,205
],[
247,68,49,94,167,82,240,165,135,208,94,233,87,205,89,93,10,196,132,234
],[
120,124,154,47,83,45,2,199,92,228,164,202,214,40,252,150,59,222,108,207
],[
47,106,215,164,178,23,107,84,153,185,190,241,63,145,29,101,120,112,33,178
],[
198,31,130,126,208,255,48,206,15,237,160,18,203,104,100,98,70,246,255,7
],[
55,195,247,61,121,140,44,55,5,187,103,100,30,212,54,241,203,15,248,143
],[
138,71,52,118,67,18,47,169,123,50,189,124,202,44,87,84,143,54,110,175
],[
226,86,255,100,202,201,104,43,176,162,122,95,20,179,207,3,127,176,93,4
],[
185,146,76,189,59,58,5,192,231,87,140,212,247,137,15,58,52,199,191,53
],[
104,254,222,201,21,250,25,194,103,138,25,248,104,223,85,210,115,54,42,9
],[
235,183,45,174,44,156,192,111,194,149,227,22,218,107,77,82,245,228,188,186
],[
228,232,137,15,240,225,127,193,89,104,237,181,2,29,250,70,106,214,57,138
],[
222,253,125,214,237,51,239,132,29,57,93,243,220,17,213,208,185,96,115,148
],[
212,23,119,78,147,82,154,163,151,129,163,19,239,197,53,126,139,157,235,230
],[
243,193,167,118,57,78,38,195,43,36,216,83,206,140,239,92,8,31,182,205
]
]