aLevelData = [
[
5,5,3,5,5,5,5,5,27,53,242,73,141,22,237,197,25,181,132,222
],[
4,2,3,5,5,5,5,5,109,26,117,241,196,163,114,117,10,155,105,47
],[
2,2,3,2,3,3,3,3,65,14,8,164,35,220,129,212,9,13,138,37
],[
5,2,2,2,3,2,2,2,11,100,168,158,105,55,174,85,42,126,128,43
],[
2,41,29,182,121,183,221,127,74,4,247,110,9,98,69,130,9,236,76,197
],[
125,23,119,128,221,138,163,171,140,48,224,167,183,139,118,48,128,75,39,141
],[
92,31,180,9,185,203,163,167,229,123,62,18,43,86,223,211,63,87,107,198
],[
220,88,29,207,171,112,133,201,103,127,208,191,63,7,73,95,123,62,32,171
],[
99,97,106,242,92,74,106,255,85,69,15,144,97,32,189,10,165,129,81,106
],[
117,124,95,127,186,101,189,87,151,227,70,247,76,70,216,78,90,27,159,108
],[
232,253,150,240,101,174,74,191,111,102,226,252,243,106,92,52,150,225,25,216
],[
84,227,156,241,103,212,143,15,107,240,6,130,191,38,8,205,46,42,76,88
],[
207,198,64,101,41,113,79,69,155,34,100,204,252,102,170,2,126,177,151,27
],[
216,241,40,170,164,105,110,17,5,189,73,60,142,73,116,143,95,183,193,28
],[
145,209,166,26,213,147,249,146,87,133,248,92,233,72,140,74,93,110,207,163
],[
50,143,203,211,116,152,133,96,221,103,58,32,64,149,232,170,40,147,16,10
],[
188,249,186,185,229,26,187,204,179,220,51,107,253,199,89,133,72,91,123,194
],[
234,167,64,185,112,23,49,100,60,142,119,208,115,180,230,25,22,146,59,150
],[
110,92,162,81,174,141,124,186,212,57,94,156,208,159,93,79,232,255,137,48
],[
91,171,183,78,68,95,132,102,194,213,150,18,86,149,37,61,140,11,186,218
]
]