aLevelData = [
[
12,2,2,2,2,2,2,2,2,2,2,2,2,2,2,2,190,204,1,181
],[
83,56,118,106,59,176,197,153,152,24,80,235,0,254,127,253,49,125,16,96
],[
0,97,175,229,147,139,199,23,208,152,151,8,21,189,136,81,42,245,190,84
],[
116,95,237,196,107,225,110,104,78,18,146,27,21,87,54,24,167,76,151,116
],[
77,101,104,236,102,213,34,225,93,174,156,161,217,74,219,232,51,235,43,167
],[
45,158,110,3,225,101,181,161,247,148,13,33,27,124,156,232,174,71,236,35
],[
188,35,134,8,47,163,195,95,66,97,223,66,56,233,79,33,77,210,84,9
],[
237,46,209,37,36,37,90,133,86,220,141,30,48,156,165,18,222,48,76,50
],[
126,142,177,193,213,186,219,123,65,232,61,214,239,225,138,136,78,167,202,73
],[
196,92,174,218,159,96,32,70,78,186,31,104,209,185,202,173,110,218,186,28
],[
166,237,149,147,103,116,224,83,131,76,21,190,97,143,246,96,243,184,32,45
],[
231,8,227,9,34,41,81,142,106,18,149,9,98,42,135,197,188,176,125,141
],[
170,90,99,108,149,60,14,183,18,236,205,77,18,228,65,30,88,39,111,234
],[
49,40,20,75,95,231,56,246,86,93,6,62,171,26,219,218,201,45,157,231
],[
230,68,78,49,53,20,225,174,93,251,76,75,43,228,222,235,131,108,211,173
],[
157,67,38,110,110,212,166,144,99,40,76,249,85,7,204,94,186,97,106,193
],[
24,237,15,56,192,16,156,241,184,0,126,115,249,41,131,38,218,208,235,22
],[
205,246,195,244,73,127,110,94,7,147,133,95,113,69,225,58,88,114,245,99
],[
229,236,97,207,210,216,197,109,217,85,211,245,109,95,169,224,169,242,93,183
],[
134,114,217,145,80,74,233,216,91,212,146,75,242,121,166,73,144,25,149,76
]
]