aLevelData = [
[
2,2,2,2,2,2,2,2,2,2,2,2,2,2,2,2,2,2,37,143
],[
2,2,2,2,2,2,2,2,2,2,2,2,2,2,2,2,2,2,74,160
],[
191,241,216,28,26,176,109,44,191,130,243,223,16,144,3,63,127,216,180,214
],[
253,208,177,113,181,76,143,36,251,161,93,142,127,11,124,94,199,76,177,22
],[
220,150,120,16,67,171,155,190,46,67,4,53,244,174,207,237,191,186,164,194
],[
132,215,68,63,57,121,97,28,66,190,179,5,44,81,72,158,157,142,28,195
],[
139,231,233,20,173,134,64,177,47,51,217,66,170,121,40,59,83,4,48,94
],[
115,78,156,129,23,123,12,145,8,129,173,215,253,139,12,122,16,160,44,69
],[
111,127,214,171,84,206,48,8,55,116,145,42,66,68,148,16,5,219,107,241
],[
107,203,118,129,236,249,20,111,5,67,186,50,229,102,66,5,106,31,133,48
],[
75,145,43,138,151,231,194,60,94,58,14,199,173,181,160,73,192,247,170,252
],[
116,184,18,255,251,176,197,89,211,180,78,59,249,35,167,133,90,128,79,140
],[
138,96,156,26,184,135,83,183,226,78,118,39,69,72,93,52,24,36,8,174
],[
121,213,180,175,168,241,172,35,115,87,98,136,241,21,190,243,115,137,182,84
],[
184,198,31,250,96,56,195,90,163,140,179,12,67,202,223,22,191,196,227,109
],[
202,180,36,185,251,33,28,89,198,2,242,167,171,38,78,125,173,211,107,248
],[
6,174,110,123,25,218,246,247,168,100,244,106,71,223,189,166,17,75,93,84
],[
153,60,46,56,36,56,170,183,21,96,126,150,168,82,223,4,227,79,33,219
],[
202,153,134,35,211,31,84,216,153,92,42,236,212,125,147,144,137,194,220,176
],[
126,38,35,188,241,66,177,174,137,111,138,73,141,43,65,158,84,190,17,213
]
]