aLevelData = [
[
2,2,2,5,2,2,2,5,2,2,2,5,2,2,2,5,2,2,23,33
],[
126,232,91,96,230,131,78,120,8,36,158,53,14,151,241,111,2,17,193,141
],[
65,203,106,72,45,240,129,178,35,185,104,118,173,214,31,97,248,17,93,33
],[
136,46,224,77,42,21,1,166,42,51,139,157,199,29,205,21,228,118,238,105
],[
0,20,129,177,104,94,89,65,171,248,159,115,79,163,33,167,194,94,237,135
],[
147,209,31,144,226,236,247,206,22,204,47,230,206,222,139,90,25,70,177,9
],[
233,130,59,245,197,74,11,73,191,187,222,155,166,181,36,110,124,130,16,251
],[
42,184,235,49,115,96,173,250,39,87,206,192,153,245,90,48,82,237,68,61
],[
7,116,252,104,201,166,67,63,124,37,63,36,138,3,202,80,217,226,16,24
],[
250,89,89,110,163,154,35,170,95,82,116,139,132,209,110,120,101,107,36,12
],[
202,30,172,210,157,117,118,77,230,171,219,60,250,20,249,27,238,185,191,237
],[
82,66,68,57,28,26,93,83,227,205,110,220,78,181,128,140,203,213,148,47
],[
132,5,55,238,143,80,87,208,100,154,85,129,149,133,91,81,185,150,240,127
],[
169,148,202,184,240,49,227,219,124,237,207,255,154,54,76,183,33,212,27,149
],[
236,132,14,236,142,227,99,218,66,142,80,134,33,136,223,167,152,220,252,70
],[
24,131,204,196,15,135,65,30,24,105,236,112,110,193,18,184,167,36,1,221
],[
159,74,164,240,178,112,86,177,46,252,244,85,7,96,54,134,205,64,63,172
],[
220,215,114,107,211,151,136,108,71,15,223,97,184,18,21,67,195,22,214,222
],[
154,218,242,144,178,76,179,78,187,169,109,231,213,230,86,141,1,79,152,145
],[
213,110,165,110,117,46,203,9,190,64,8,55,196,190,31,128,127,14,235,35
]
]