aLevelData = [
[
2,2,2,2,2,198,44,75,40,87,37,153,211,214,106,197,161,179,57,98
],[
2,2,2,2,2,232,191,180,94,243,234,145,225,82,81,20,120,115,120,58
],[
2,2,3,2,3,115,119,211,56,140,62,140,35,201,196,128,241,163,177,139
],[
160,103,43,5,181,221,239,140,232,40,160,4,30,237,94,221,151,183,155,148
],[
105,154,42,125,45,23,153,191,248,64,193,160,141,28,155,3,208,77,86,46
],[
126,240,166,209,28,197,94,68,45,144,65,17,168,191,21,178,169,76,250,156
],[
103,229,250,124,102,75,225,192,238,248,79,89,187,4,11,191,246,73,154,54
],[
100,198,17,81,222,65,39,180,1,48,142,29,38,218,132,166,148,186,165,68
],[
245,36,3,148,7,43,120,215,148,193,59,58,164,32,178,92,241,105,135,10
],[
155,139,254,77,29,103,134,166,128,50,142,152,207,26,153,103,202,44,149,32
],[
222,117,104,217,85,103,205,58,203,127,94,60,225,37,241,49,53,212,40,5
],[
145,122,68,195,98,34,58,90,108,208,9,162,189,172,74,154,223,99,9,244
],[
82,203,211,211,57,198,16,211,84,104,148,74,46,92,112,205,152,131,14,246
],[
85,223,125,101,23,176,9,5,171,220,15,144,112,148,15,86,13,53,3,58
],[
99,108,239,253,193,158,186,191,87,135,60,194,238,33,152,114,214,199,204,162
],[
31,154,134,25,12,36,58,77,196,59,113,110,75,40,100,166,177,9,201,160
],[
137,116,237,71,157,93,3,208,224,58,187,250,164,100,23,148,13,193,123,64
],[
198,160,3,120,242,228,24,206,102,101,70,120,21,147,72,11,203,93,101,135
],[
31,81,0,148,163,4,106,11,93,180,250,184,123,44,96,95,66,232,54,252
],[
72,122,216,79,227,44,118,152,225,231,103,160,121,83,192,248,130,64,38,133
]
]