aLevelData = [
[
2,2,2,2,2,2,2,2,2,6,5,2,103,141,96,70,230,190,248,54
],[
2,3,5,3,5,5,5,3,5,3,5,2,39,2,92,193,163,122,112,73
],[
2,3,2,3,2,2,2,3,5,3,5,2,1,191,194,52,223,140,109,65
],[
2,2,2,2,2,2,2,2,2,2,2,2,206,183,61,28,158,102,19,48
],[
2,3,5,3,5,5,5,3,2,3,5,5,221,127,139,188,154,96,221,41
],[
2,3,5,3,5,5,5,3,2,3,5,5,110,209,1,155,190,54,23,198
],[
58,10,5,3,169,136,98,162,233,171,147,130,49,89,51,224,154,219,185,109
],[
222,145,84,163,95,228,26,88,107,123,98,148,190,178,110,160,72,72,78,95
],[
49,87,0,225,27,138,220,54,167,138,48,128,58,185,39,76,1,35,239,35
],[
50,178,26,91,149,161,69,51,68,50,248,32,175,164,206,97,226,95,214,217
],[
11,115,56,30,54,64,28,206,92,118,199,34,156,65,7,197,200,189,210,230
],[
35,176,42,140,105,120,67,41,16,66,232,115,206,125,27,111,91,143,252,206
],[
120,198,236,125,48,145,241,120,94,240,92,223,111,41,170,75,105,189,169,98
],[
44,154,220,169,249,146,31,154,48,12,142,247,94,249,164,93,118,10,160,28
],[
95,32,45,70,175,5,65,6,183,89,70,51,191,207,120,37,146,153,142,200
],[
62,32,156,238,21,249,56,234,247,20,220,90,212,55,139,68,108,171,183,101
],[
89,54,99,197,80,73,133,143,164,121,174,32,11,51,236,94,165,172,240,75
],[
58,24,108,218,196,28,191,1,45,133,212,15,89,58,71,64,103,111,202,142
],[
52,28,200,203,33,174,72,237,23,252,19,169,200,124,25,67,55,183,17,164
],[
122,250,96,173,190,79,60,203,141,171,17,203,76,105,35,240,8,247,118,67
]
]