aLevelData = [
[
4,2,98,87,81,4,118,48,193,3,203,127,47,229,221,88,177,121,20,24
],[
5,2,126,41,2,156,83,207,229,176,21,202,116,202,183,80,216,249,94,5
],[
2,5,248,24,195,205,249,71,217,223,5,156,177,28,76,21,154,158,73,209
],[
3,3,140,147,71,128,199,76,35,25,183,145,83,203,27,56,39,53,102,246
],[
2,3,79,217,101,116,158,206,35,165,14,182,10,88,3,240,74,9,212,15
],[
3,3,127,253,135,138,142,142,220,180,207,195,142,239,114,35,213,29,27,203
],[
3,5,47,88,208,191,96,227,21,126,183,96,85,217,148,67,132,4,39,134
],[
3,5,3,238,122,159,196,206,178,175,174,254,146,252,67,13,64,161,128,16
],[
3,5,76,132,4,56,238,137,117,170,143,5,32,138,139,118,223,89,54,113
],[
3,5,64,130,29,219,227,47,142,92,36,97,90,17,250,64,217,129,31,176
],[
47,211,114,36,206,62,153,183,60,192,234,121,23,19,140,6,86,221,217,94
],[
209,39,7,240,4,16,8,248,15,194,174,11,2,166,19,240,88,212,56,178
],[
193,206,236,243,37,109,240,131,229,27,88,50,100,67,52,226,198,6,112,224
],[
247,48,249,116,239,106,33,182,53,177,69,164,162,6,173,114,104,103,179,33
],[
83,255,40,83,78,154,243,94,40,91,251,159,152,177,72,17,127,135,101,29
],[
110,187,8,180,104,210,244,156,233,234,31,7,38,239,16,106,151,18,140,140
],[
179,119,113,222,251,46,226,10,57,101,164,206,10,220,200,11,154,153,139,25
],[
175,220,122,94,233,85,218,31,72,149,70,149,238,195,154,68,38,144,16,136
],[
166,108,169,113,17,251,207,208,192,194,56,146,194,39,13,77,33,152,76,25
],[
103,10,107,161,97,165,62,122,35,189,26,179,76,5,59,173,140,255,99,44
]
]