aLevelData = [
[
12,2,2,2,2,2,2,2,2,2,2,2,2,2,2,240,49,32,178,140
],[
2,2,2,2,2,2,2,2,2,2,2,2,13,2,2,59,167,106,191,209
],[
2,2,3,3,3,3,3,3,3,3,2,3,3,3,2,154,182,172,219,76
],[
11,2,3,2,2,2,2,2,2,3,2,3,2,3,2,110,90,145,40,32
],[
2,2,3,2,2,2,2,2,2,3,2,3,2,3,2,173,154,70,88,149
],[
2,2,3,2,2,2,2,2,2,3,2,3,2,3,2,117,60,30,133,25
],[
10,2,3,2,2,2,2,2,2,2,2,2,2,2,2,55,193,39,216,74
],[
2,2,3,2,2,2,2,2,3,3,3,3,3,2,2,211,78,137,5,117
],[
2,2,3,2,2,2,2,3,2,2,2,2,1,3,2,44,230,74,213,197
],[
9,2,3,2,2,2,2,3,2,2,2,2,2,2,3,51,92,244,163,33
],[
2,2,3,2,2,2,3,2,2,2,2,2,2,2,2,57,173,203,241,42
],[
2,2,3,2,2,3,2,2,2,2,2,2,2,2,2,243,241,220,152,90
],[
8,2,3,2,2,3,2,2,2,2,2,2,2,2,2,232,179,33,216,92
],[
2,2,3,2,3,3,2,2,2,2,2,2,2,2,2,195,235,205,195,251
],[
56,66,145,81,59,110,171,97,43,127,31,87,149,151,18,16,246,20,250,124
],[
137,20,13,71,94,56,248,184,172,169,213,217,104,89,87,216,22,140,72,173
],[
224,150,54,253,229,230,105,62,211,67,24,29,184,86,220,28,21,105,100,128
],[
53,110,107,106,188,67,231,68,131,52,131,94,163,194,80,217,208,162,183,197
],[
233,9,179,134,204,39,61,124,111,241,7,227,45,36,108,247,93,135,167,92
],[
41,112,68,190,158,137,213,181,255,212,230,235,95,237,51,128,110,144,24,173
]
]