aLevelData = [
[
12,2,2,2,2,2,2,2,2,2,2,2,2,2,2,2,2,2,232,203
],[
2,2,2,2,2,2,2,2,2,2,2,2,13,2,2,2,2,2,215,201
],[
2,2,3,3,3,3,3,3,3,3,2,3,3,3,2,3,3,3,40,29
],[
11,2,3,2,2,2,2,2,2,3,2,3,2,3,2,3,2,3,244,120
],[
2,2,3,2,2,2,2,2,2,3,2,3,2,3,2,3,2,3,68,141
],[
2,2,3,2,2,2,2,2,2,3,2,3,2,3,2,3,2,3,152,241
],[
10,2,3,2,2,2,2,2,2,2,2,2,2,2,2,2,2,3,233,165
],[
2,2,3,2,2,2,2,2,3,3,3,3,3,2,2,2,2,3,118,41
],[
2,2,3,2,2,2,2,3,2,2,2,2,1,3,2,2,2,3,13,24
],[
9,2,3,2,2,2,2,3,2,2,2,2,2,2,3,2,2,2,195,143
],[
2,2,3,2,2,2,3,2,2,2,2,2,2,2,2,3,3,2,46,247
],[
2,2,3,2,2,3,2,2,2,2,2,2,2,2,2,2,3,2,155,229
],[
8,2,3,2,2,3,2,2,2,2,2,2,2,2,2,2,3,2,219,40
],[
160,78,118,21,228,168,56,161,9,27,117,96,166,242,34,7,237,170,148,33
],[
139,73,138,4,208,242,110,4,16,181,216,230,73,171,84,152,5,67,101,31
],[
130,215,202,208,17,131,255,195,188,54,7,133,43,9,105,13,201,208,121,241
],[
34,239,216,218,143,112,62,54,22,82,119,44,140,35,172,213,252,209,228,169
],[
77,189,202,55,30,17,177,26,245,84,213,40,153,59,228,236,188,194,189,87
],[
221,124,119,178,109,39,165,215,49,132,216,161,231,102,102,161,44,8,106,18
],[
157,163,12,15,61,64,3,4,23,203,88,99,36,106,108,152,110,13,60,62
]
]