aLevelData = [
[
2,2,2,2,2,2,2,2,2,6,5,2,2,2,2,200,134,62,242,51
],[
2,3,5,3,5,5,5,3,5,3,5,2,5,3,5,137,168,147,237,187
],[
2,3,2,3,2,2,2,3,5,3,5,2,5,3,5,51,215,178,248,18
],[
2,2,2,2,2,2,2,2,2,2,2,2,5,5,5,180,239,13,180,109
],[
2,3,5,3,5,5,5,3,2,3,5,5,5,3,2,36,133,70,12,141
],[
2,3,5,3,5,5,5,3,2,3,5,5,5,3,2,191,121,12,1,68
],[
2,5,5,5,5,5,5,5,5,5,5,5,5,2,2,133,86,26,88,110
],[
2,3,5,3,5,5,5,3,5,3,5,5,5,3,5,111,150,207,133,239
],[
2,3,5,3,5,5,5,3,5,3,5,5,5,3,5,253,34,51,53,132
],[
2,5,5,5,5,5,5,5,5,5,5,5,5,5,5,194,242,89,50,172
],[
2,3,5,3,2,2,2,3,2,3,2,2,2,3,2,156,98,65,62,232
],[
5,3,5,3,2,2,2,3,2,3,2,2,2,3,2,185,199,73,49,222
],[
5,5,5,5,5,5,5,5,5,5,5,5,5,5,5,150,103,122,90,96
],[
5,3,5,3,5,5,5,3,5,3,5,5,2,3,2,143,176,245,31,230
],[
5,3,5,3,5,5,5,3,5,3,5,5,2,3,2,46,40,179,216,135
],[
1,5,5,5,5,5,5,5,5,5,5,5,5,5,5,213,205,104,127,54
],[
13,196,90,20,103,29,90,57,203,181,131,39,5,58,161,10,226,82,140,236
],[
148,119,171,40,87,5,183,33,85,145,193,51,199,125,119,234,94,201,163,114
],[
225,44,244,79,23,100,1,78,231,202,139,188,190,41,2,213,49,208,75,127
],[
228,230,193,57,170,254,122,78,237,235,203,78,81,214,14,190,148,142,162,15
]
]