aLevelData = [
[
2,2,2,39,53,61,121,249,77,132,54,73,8,152,112,129,243,97,186,245
],[
2,2,2,225,243,41,118,51,192,184,35,87,12,235,131,143,162,179,209,244
],[
2,2,2,198,146,151,186,106,255,127,181,165,12,101,28,96,70,176,142,83
],[
2,2,2,221,227,82,48,5,111,227,29,155,204,172,104,12,199,16,118,115
],[
2,2,2,30,173,253,1,74,226,115,162,156,142,199,221,139,27,78,252,77
],[
2,2,2,188,0,110,164,242,228,105,251,85,201,212,177,145,55,99,181,175
],[
2,2,2,165,4,83,150,236,122,77,209,252,71,46,146,206,208,219,247,154
],[
2,2,2,188,107,141,73,157,56,19,45,210,54,128,240,172,132,71,202,207
],[
2,2,2,65,217,247,219,161,107,105,76,64,250,186,159,182,141,100,183,107
],[
2,2,2,187,52,126,173,108,252,207,255,228,137,148,180,253,212,43,189,179
],[
2,2,3,124,15,192,230,116,180,106,92,249,178,5,6,200,38,77,132,141
],[
85,127,234,158,147,180,197,233,100,109,89,44,224,111,45,100,92,209,202,135
],[
70,83,191,117,81,241,232,44,210,184,240,60,106,217,21,124,230,252,43,250
],[
99,214,228,56,182,254,78,149,11,252,157,9,203,163,43,21,196,162,189,250
],[
132,85,8,42,5,225,116,252,144,127,31,163,219,24,37,97,117,19,31,248
],[
99,107,233,98,12,4,169,193,82,63,12,153,2,204,211,61,110,191,143,135
],[
88,230,168,204,18,90,164,15,228,85,166,117,174,67,53,249,206,28,63,97
],[
68,240,94,113,20,196,89,94,236,156,238,134,7,217,207,93,81,197,234,171
],[
204,109,237,245,50,175,10,56,220,147,248,222,226,223,58,234,132,229,163,118
],[
201,160,26,95,101,255,155,63,224,129,126,155,245,2,252,94,57,213,239,134
]
]