aLevelData = [
[
4,2,2,2,2,2,2,2,2,2,2,2,2,2,145,66,211,158,119,48
],[
5,2,5,3,2,2,2,2,2,2,2,2,2,2,105,2,20,60,222,20
],[
2,5,5,3,3,3,3,3,3,3,3,3,3,3,207,126,2,51,20,3
],[
3,3,5,5,5,5,5,5,5,5,3,2,2,2,183,134,4,184,74,249
],[
2,3,5,5,5,5,5,5,5,5,3,6,2,2,106,137,3,130,241,203
],[
3,3,5,5,5,5,3,3,3,3,3,3,3,3,250,169,149,215,45,71
],[
3,5,5,5,5,5,3,2,2,2,2,2,2,2,88,248,208,142,54,136
],[
3,5,5,3,3,3,3,8,2,2,2,5,5,5,228,73,90,85,11,101
],[
3,5,5,3,2,2,3,3,3,3,2,5,3,3,146,74,155,177,1,75
],[
3,5,5,3,2,2,2,2,2,3,2,5,3,5,241,226,20,96,8,218
],[
3,5,5,3,2,2,3,2,2,3,2,5,3,5,183,22,74,42,200,34
],[
5,5,5,3,2,2,3,2,2,3,2,5,3,5,165,213,203,72,226,87
],[
5,5,5,3,2,2,3,2,2,3,2,5,3,3,224,123,50,229,243,70
],[
10,247,51,106,49,4,197,201,24,140,185,130,105,92,61,94,226,14,16,107
],[
100,207,58,230,71,101,251,94,241,112,1,23,167,239,221,173,162,7,184,249
],[
102,0,66,56,79,145,236,106,109,93,87,249,146,189,12,155,168,192,109,121
],[
72,112,236,145,137,87,122,89,22,66,66,165,132,69,152,202,226,255,44,4
],[
145,31,132,21,86,39,169,47,173,113,32,20,96,111,27,124,89,54,241,183
],[
180,62,204,147,25,99,161,128,73,48,102,242,246,93,127,7,216,150,121,106
],[
253,127,250,119,97,244,248,160,190,149,42,15,165,130,188,140,206,99,71,162
]
]