aLevelData = [
[
6,2,8,2,9,2,10,2,11,3,2,2,5,2,2,140,213,60,245,239
],[
2,2,2,2,2,2,2,2,12,3,5,2,2,2,5,193,129,77,177,88
],[
2,2,3,3,3,3,3,3,3,3,2,2,3,3,3,90,28,113,214,236
],[
137,7,187,127,69,177,103,202,193,109,230,112,158,165,13,202,101,17,198,231
],[
120,218,168,209,72,251,203,18,201,237,218,119,35,131,105,20,171,19,137,136
],[
17,214,154,131,218,145,97,133,17,117,91,232,58,68,80,32,136,182,42,66
],[
80,27,8,195,188,65,143,130,196,152,128,9,90,148,144,16,229,83,116,67
],[
241,128,59,70,37,119,224,245,117,170,32,240,153,67,137,87,189,11,212,210
],[
122,138,116,213,5,112,111,34,166,51,109,143,108,250,14,9,32,186,129,217
],[
119,158,83,38,139,173,132,187,140,167,224,11,179,47,140,114,120,47,224,190
],[
5,121,116,238,234,170,126,58,18,84,91,83,246,92,107,235,16,160,34,120
],[
147,221,92,53,89,209,241,106,29,156,138,238,234,108,179,234,211,89,49,223
],[
229,142,149,235,90,170,17,72,15,102,139,21,57,119,240,89,83,182,203,69
],[
91,126,22,185,61,85,79,10,144,207,207,3,128,176,88,41,11,81,237,67
],[
113,69,230,26,229,59,67,126,137,38,65,137,153,156,43,40,230,124,115,214
],[
135,212,1,171,203,2,203,150,114,25,166,231,28,134,91,16,1,243,254,172
],[
227,107,123,192,65,191,114,65,206,41,69,215,33,48,111,225,174,203,23,185
],[
245,201,228,57,249,112,20,126,244,101,200,235,73,204,162,113,186,175,146,14
],[
219,164,237,148,198,170,192,172,17,85,99,26,253,43,81,67,240,77,54,236
],[
38,90,74,68,163,144,222,37,108,52,52,151,246,52,148,150,223,12,156,21
]
]