aLevelData = [
[
2,2,2,2,2,11,35,185,181,187,40,15,195,158,151,188,14,6,191,100
],[
2,2,2,2,2,2,249,224,173,111,156,233,242,185,177,12,166,139,177,235
],[
172,203,58,188,56,111,180,86,143,55,52,139,14,156,160,185,110,4,21,156
],[
70,55,133,102,209,22,165,18,242,139,6,245,117,188,129,150,152,132,217,191
],[
202,35,156,212,178,52,74,100,115,224,185,254,47,82,184,70,202,106,243,71
],[
240,182,23,11,89,158,54,105,75,222,108,31,97,58,195,33,140,108,84,48
],[
87,98,175,173,111,166,125,176,98,30,100,85,167,245,43,86,223,217,31,223
],[
90,103,181,157,221,227,112,25,162,45,5,68,161,240,190,82,14,29,28,204
],[
35,152,192,225,31,49,139,254,143,213,5,158,204,5,251,98,197,136,109,100
],[
254,93,167,201,217,244,173,149,21,158,220,195,148,65,207,150,97,80,128,42
],[
241,250,175,78,169,162,136,150,161,144,128,171,168,230,128,230,136,213,69,29
],[
139,16,7,189,61,129,88,25,116,60,80,2,142,177,231,152,250,37,162,95
],[
250,99,114,150,166,174,217,196,53,251,78,147,120,93,227,225,167,193,37,21
],[
96,219,67,175,237,96,115,36,198,118,146,232,86,105,10,204,2,159,249,138
],[
104,206,144,158,228,108,185,88,89,103,252,48,46,23,163,89,150,113,28,153
],[
21,125,160,87,64,10,18,246,196,160,42,97,169,182,210,231,216,37,208,74
],[
219,221,166,18,229,214,182,39,18,74,170,159,239,34,19,213,61,174,80,187
],[
242,152,178,113,129,27,222,22,91,112,114,222,182,137,235,100,141,2,198,66
],[
232,85,229,224,93,77,53,137,215,189,142,196,150,113,218,225,119,101,122,210
],[
118,53,229,60,113,213,146,206,47,130,25,210,160,248,149,1,102,230,76,156
]
]