aLevelData = [
[
2,2,2,2,2,2,2,2,2,2,2,2,2,2,2,2,2,2,2,121
],[
2,2,2,2,2,2,2,2,2,2,2,2,2,2,2,2,2,2,2,89
],[
2,2,2,2,2,2,2,2,2,2,2,2,2,2,2,2,2,2,2,190
],[
2,2,2,3,3,3,3,3,3,3,3,3,3,3,3,3,3,3,2,111
],[
2,2,2,2,2,2,2,2,2,2,2,2,2,2,2,2,2,2,2,239
],[
2,2,2,2,2,2,2,2,2,2,2,2,2,2,2,2,2,2,2,38
],[
2,2,2,2,2,3,2,2,3,2,2,3,2,2,2,3,2,2,3,16
],[
2,2,2,3,3,3,3,3,3,3,3,3,3,3,3,3,3,3,3,145
],[
2,2,2,2,2,2,2,2,2,2,2,2,2,2,2,2,2,2,2,130
],[
2,2,2,2,2,2,2,2,2,2,2,2,2,2,2,2,2,2,2,195
],[
2,2,3,3,3,3,3,3,3,3,3,3,3,3,3,3,3,3,2,119
],[
2,2,2,2,2,2,2,2,2,2,2,2,2,2,2,2,2,3,2,228
],[
2,2,2,2,2,2,2,2,2,2,2,2,2,2,2,2,2,3,2,48
],[
8,249,169,65,235,71,25,33,255,55,5,107,59,116,186,70,253,116,39,244
],[
78,171,66,168,104,255,167,152,118,123,130,84,154,71,176,86,52,216,33,218
],[
98,100,129,240,195,153,23,207,129,142,237,108,142,250,49,75,45,164,219,149
],[
181,26,144,108,145,166,198,123,140,126,42,209,76,59,62,239,27,140,71,31
],[
238,44,102,8,159,17,5,128,126,231,116,161,8,188,212,31,246,253,53,216
],[
122,161,251,173,197,164,134,145,204,183,18,223,76,54,219,241,11,90,133,238
],[
98,176,188,227,248,201,24,22,208,51,67,151,134,169,93,23,213,135,159,253
]
]