aLevelData = [
[
12,2,2,2,2,2,127,252,10,0,175,32,196,161,155,42,114,108,252,7
],[
2,2,2,2,2,2,35,195,248,77,225,23,141,20,55,92,51,7,240,186
],[
2,2,3,3,3,3,189,187,32,134,129,63,105,112,184,244,119,254,40,158
],[
11,2,3,2,2,2,205,57,0,188,196,166,3,21,208,119,232,148,6,3
],[
2,2,3,2,2,2,1,85,219,116,28,0,47,191,167,86,138,218,23,9
],[
2,2,3,2,2,2,165,41,138,209,44,57,170,188,194,176,213,198,70,132
],[
10,2,3,2,2,2,124,169,84,108,201,246,15,148,133,101,30,149,56,105
],[
2,2,3,2,2,2,245,164,146,8,86,9,9,234,23,212,196,176,37,203
],[
2,2,3,2,2,2,184,135,201,166,17,252,42,127,211,18,20,132,193,145
],[
247,239,126,162,51,56,242,153,146,136,239,18,22,114,20,63,246,222,242,128
],[
227,69,110,52,143,36,102,208,112,170,152,46,194,180,191,39,203,252,254,99
],[
98,141,130,112,178,123,100,18,60,208,204,218,27,201,92,250,140,67,204,88
],[
173,112,209,225,133,206,68,32,69,90,128,15,205,1,12,45,114,87,122,208
],[
255,139,142,189,249,155,163,246,40,196,75,211,82,61,54,84,74,36,85,182
],[
42,185,62,68,220,202,211,112,223,110,30,34,71,246,128,80,6,33,11,207
],[
107,143,44,105,232,120,141,47,24,158,57,16,0,128,2,171,150,209,32,98
],[
127,40,26,176,29,249,234,188,201,196,92,46,93,140,183,65,246,139,159,25
],[
248,36,58,88,82,25,146,236,3,254,58,42,221,238,53,33,136,124,19,40
],[
203,236,93,186,7,164,51,132,4,221,52,187,240,158,158,179,165,235,182,174
],[
43,58,107,242,126,38,54,30,145,103,68,189,146,2,215,28,112,189,234,89
]
]