aLevelData = [
[
12,2,140,48,171,118,12,87,132,63,244,20,41,0,234,203,124,219,23,77
],[
2,2,29,200,32,251,243,221,88,47,9,206,52,215,156,176,255,99,114,2
],[
2,2,206,226,109,237,183,103,95,203,62,178,32,231,16,12,222,131,244,115
],[
11,2,181,32,254,247,127,249,5,100,238,209,88,33,216,238,173,88,209,102
],[
2,2,90,87,255,153,200,55,42,255,36,187,19,36,87,122,7,240,57,65
],[
2,2,179,44,1,179,58,66,1,50,133,68,144,3,219,48,71,172,177,115
],[
10,2,112,161,195,171,187,32,99,177,51,90,17,215,113,211,77,110,15,11
],[
2,2,169,140,96,94,34,12,94,41,176,213,228,46,28,96,30,58,18,116
],[
2,2,61,5,119,52,111,89,252,92,14,118,244,200,23,182,99,54,223,109
],[
9,2,87,76,1,19,123,221,155,165,233,104,186,72,64,225,18,48,246,180
],[
243,192,240,8,120,242,80,64,2,250,143,200,228,38,203,14,96,9,98,206
],[
211,216,191,147,44,20,116,123,162,105,137,58,167,215,20,97,23,15,10,225
],[
182,32,85,202,217,82,39,89,99,82,141,50,243,144,71,234,92,230,215,200
],[
86,122,216,205,115,229,145,241,84,149,202,176,28,111,222,197,37,185,18,54
],[
242,56,37,144,101,149,41,116,50,6,145,82,148,42,138,117,63,52,143,64
],[
149,75,55,183,28,49,82,65,48,35,53,171,245,1,82,113,144,175,12,57
],[
151,187,201,161,197,64,72,58,243,10,53,212,67,250,250,253,159,172,217,196
],[
98,88,55,195,84,246,59,92,220,166,152,66,113,78,167,59,82,133,185,37
],[
119,176,171,55,199,106,187,138,139,42,153,216,35,31,194,131,247,95,9,217
],[
177,65,118,150,170,7,84,170,161,193,134,61,179,110,26,241,135,99,33,103
]
]