aLevelData = [
[
5,5,3,5,5,5,5,5,5,85,117,231,203,99,0,106,28,38,218,183
],[
4,2,3,5,5,5,5,5,5,227,6,216,34,182,146,94,76,62,35,117
],[
2,2,3,2,3,3,3,3,3,237,233,188,30,209,222,53,231,33,54,153
],[
5,2,2,2,3,2,2,2,2,187,228,105,204,254,197,6,113,218,23,168
],[
2,2,2,3,2,2,2,2,2,10,211,22,37,97,162,112,8,40,64,4
],[
2,2,2,3,2,2,5,3,3,66,220,65,233,28,239,99,178,112,37,103
],[
2,2,2,2,2,2,5,5,3,240,25,63,31,249,168,215,201,232,88,139
],[
5,2,2,2,2,2,5,5,3,155,229,69,93,159,167,216,90,193,54,134
],[
2,2,5,5,3,2,5,5,3,122,39,246,186,200,192,225,15,194,32,20
],[
2,2,5,5,3,2,5,5,3,195,3,139,141,105,31,79,51,221,207,87
],[
2,2,3,3,3,2,5,5,3,22,125,78,254,249,150,2,33,14,29,95
],[
2,2,3,2,2,2,5,5,3,120,0,160,9,38,54,123,56,142,87,79
],[
97,105,9,176,19,21,255,30,31,48,50,55,251,102,110,42,104,135,17,111
],[
83,221,16,182,249,188,58,29,79,90,193,165,161,225,246,231,121,195,84,3
],[
194,78,192,218,45,128,15,125,212,28,201,228,30,253,44,228,226,171,116,91
],[
207,44,90,174,11,29,219,117,26,1,58,116,2,216,72,206,172,244,227,117
],[
142,8,189,229,135,130,95,18,10,26,109,158,127,171,43,80,230,66,64,194
],[
190,117,186,89,37,247,83,122,64,105,242,251,221,114,117,216,87,17,174,40
],[
186,50,171,79,40,128,59,116,124,123,173,54,44,202,219,154,116,210,104,72
],[
177,135,69,248,11,130,122,39,86,85,35,14,58,27,184,212,146,83,146,3
]
]