aLevelData = [
[
2,2,2,2,5,5,2,2,2,2,2,2,170,76,247,180,237,223,98,62
],[
2,2,2,4,2,2,2,2,2,2,2,5,42,216,172,6,34,63,199,4
],[
5,3,3,3,5,5,3,3,3,3,3,3,126,108,190,231,193,39,72,89
],[
2,3,2,2,2,2,2,2,2,3,2,2,122,13,157,131,190,54,136,212
],[
2,3,2,2,2,2,2,2,2,3,2,2,213,20,190,254,52,158,110,66
],[
2,3,2,2,3,2,2,2,2,3,2,2,171,174,25,238,224,168,164,36
],[
2,3,2,2,3,2,2,2,2,3,2,2,252,93,172,220,164,47,25,44
],[
2,3,2,2,3,5,5,3,3,3,3,3,43,117,246,200,6,33,128,197
],[
128,160,124,162,175,1,206,136,166,90,72,209,236,103,192,200,45,117,101,175
],[
48,126,83,7,9,150,100,11,144,133,73,126,17,182,218,166,69,80,171,153
],[
129,162,224,183,46,196,66,120,121,123,146,104,75,94,29,111,124,55,144,86
],[
68,172,14,135,242,31,128,20,224,210,44,251,166,79,138,169,142,7,82,188
],[
72,57,218,13,223,21,159,238,236,34,33,176,10,221,245,105,137,163,21,243
],[
103,208,122,56,123,41,237,173,244,119,26,29,2,117,230,168,211,236,2,11
],[
193,29,192,34,202,95,38,171,64,9,66,76,193,146,188,216,106,247,178,206
],[
72,93,191,34,15,248,93,64,15,43,110,79,99,241,21,178,108,123,202,213
],[
126,27,174,38,216,96,27,97,218,131,128,17,114,1,108,84,216,138,232,222
],[
123,26,10,64,59,102,199,106,216,121,9,111,170,159,1,137,147,130,191,93
],[
51,147,0,128,90,171,71,57,195,242,47,137,255,1,255,104,175,67,127,82
],[
246,161,10,2,46,94,229,126,218,63,207,83,220,240,217,34,233,163,120,91
]
]