aLevelData = [
[
4,2,2,2,2,2,2,2,2,2,8,2,2,2,2,3,2,2,213,227
],[
2,2,3,2,9,2,2,2,2,2,2,2,2,3,2,2,3,2,136,28
],[
2,3,2,2,2,2,3,2,2,3,2,3,2,2,3,2,2,3,11,172
],[
2,3,2,2,2,3,2,2,3,2,2,2,3,2,2,3,2,2,48,97
],[
196,35,30,211,247,56,28,104,201,70,163,4,166,221,147,85,145,196,38,251
],[
184,62,39,237,76,141,95,24,143,181,81,73,47,130,39,76,210,204,235,86
],[
242,250,250,160,235,197,182,85,82,63,124,174,137,19,214,91,144,14,241,38
],[
30,222,81,211,241,26,195,74,98,131,147,248,60,138,0,114,206,18,237,91
],[
63,118,217,137,34,206,17,99,74,110,36,141,224,176,152,200,178,244,219,19
],[
206,228,124,22,80,253,155,193,120,75,159,49,0,115,39,211,172,247,66,203
],[
34,182,226,151,252,178,142,239,28,22,88,240,63,120,15,122,213,91,181,215
],[
17,248,51,157,60,62,76,213,78,23,208,92,191,237,18,138,155,109,155,18
],[
213,138,32,41,221,197,178,235,116,172,53,250,192,161,19,104,155,221,50,215
],[
49,181,35,222,202,27,156,175,228,103,40,247,133,88,29,6,207,85,206,48
],[
213,249,3,115,173,207,166,90,199,90,191,32,124,89,163,25,234,72,103,78
],[
0,42,155,103,213,134,53,207,62,176,204,18,159,73,7,138,1,9,84,58
],[
101,188,221,250,88,139,184,213,200,125,93,175,22,62,94,42,108,30,82,203
],[
81,92,18,89,123,165,41,134,228,216,133,210,32,12,115,171,237,212,202,217
],[
12,194,101,25,79,41,215,8,244,39,91,67,49,227,10,205,16,20,81,177
],[
125,195,161,232,157,81,104,124,98,187,65,238,93,29,103,214,211,117,112,201
]
]