aLevelData = [
[
4,2,5,5,2,2,2,2,2,211,221,59,159,38,233,75,23,10,155,91
],[
2,2,2,2,2,2,5,2,2,174,47,178,195,176,190,131,18,188,237,62
],[
2,2,2,2,2,2,3,3,3,72,37,210,115,70,152,116,213,130,255,40
],[
3,3,3,3,3,3,3,2,2,61,255,166,27,242,125,156,43,39,237,93
],[
2,2,3,2,2,2,2,2,2,251,197,39,173,70,107,223,199,115,179,213
],[
13,2,3,2,2,2,2,2,2,183,106,184,77,5,167,213,191,147,140,175
],[
2,5,3,2,2,2,2,2,2,207,200,252,117,127,238,37,102,164,217,157
],[
2,12,3,2,2,2,2,2,2,148,151,202,177,232,44,147,250,103,232,251
],[
5,2,3,3,3,3,3,3,3,49,179,110,99,67,213,59,170,168,57,147
],[
11,2,3,2,2,2,2,2,2,79,241,250,187,213,161,97,105,108,62,168
],[
2,5,3,2,2,2,2,2,2,121,205,168,3,225,102,169,225,231,183,204
],[
2,10,3,2,2,2,2,2,2,110,146,252,115,93,94,12,36,230,51,129
],[
5,2,2,2,2,2,2,2,2,36,10,152,25,71,30,37,92,6,135,54
],[
2,2,2,2,2,2,2,2,2,127,210,195,231,137,168,169,60,180,230,241
],[
9,5,3,2,2,2,2,2,2,159,22,93,246,144,128,167,187,152,167,186
],[
2,2,3,2,2,2,2,2,3,44,126,129,190,167,190,242,28,187,55,168
],[
216,48,36,68,32,71,77,186,37,66,127,250,41,39,57,208,217,194,168,8
],[
222,233,213,215,175,4,30,118,169,204,227,16,97,82,129,222,57,67,132,145
],[
49,107,24,240,0,121,193,194,100,2,76,238,182,200,6,225,193,59,43,48
],[
212,64,161,126,22,50,230,161,26,38,72,0,179,116,84,63,10,115,144,31
]
]