aLevelData = [
[
2,2,2,2,2,2,2,2,2,2,2,2,65,43,220,45,255,107,237,201
],[
2,2,2,2,2,2,2,2,2,2,2,2,252,60,98,239,62,155,23,152
],[
2,2,2,2,2,2,2,2,2,2,2,2,41,108,50,231,163,13,96,93
],[
2,2,2,3,3,3,3,3,3,3,3,3,117,49,98,80,244,236,201,153
],[
2,2,2,2,2,2,2,2,2,2,2,2,226,10,253,142,143,165,132,48
],[
2,2,2,2,2,2,2,2,2,2,2,2,67,247,129,165,224,108,123,232
],[
2,2,2,2,2,3,2,2,3,2,2,3,196,251,96,191,237,183,202,237
],[
2,2,2,3,3,3,3,3,3,3,3,3,96,161,128,169,203,193,64,80
],[
2,2,2,2,2,2,2,2,2,2,2,2,105,117,188,87,38,8,226,131
],[
2,2,2,2,2,2,2,2,2,2,2,2,4,134,96,92,189,207,104,223
],[
2,2,3,3,3,3,3,3,3,3,3,3,170,235,176,115,227,157,190,30
],[
2,2,2,2,2,2,2,2,2,2,2,2,168,59,98,249,255,188,132,225
],[
2,2,2,2,2,2,2,2,2,2,2,2,159,19,31,112,13,188,142,43
],[
2,2,3,3,3,3,3,3,3,2,2,3,5,148,7,253,27,237,101,229
],[
2,2,3,2,2,2,2,2,2,2,2,2,162,226,42,235,205,232,196,88
],[
2,2,3,2,2,2,2,2,2,2,2,2,20,166,15,38,217,7,28,182
],[
76,141,49,193,140,232,16,145,15,199,124,113,67,238,250,98,117,136,213,15
],[
243,191,100,3,109,139,143,26,161,199,144,53,56,138,247,50,234,180,241,28
],[
233,199,201,158,125,249,175,190,235,135,185,200,156,75,39,135,123,145,235,187
],[
159,39,105,200,42,179,123,172,113,73,184,51,93,61,246,110,17,54,13,97
]
]