aLevelData = [
[
2,2,2,2,2,11,27,148,11,115,128,125,68,40,131,80,126,163,217,56
],[
2,2,2,2,2,2,70,11,157,57,159,43,253,22,82,118,51,114,133,72
],[
5,2,5,2,5,5,183,53,143,111,178,49,11,234,182,6,43,240,173,66
],[
5,2,5,2,5,2,80,53,16,205,215,104,90,133,53,0,187,37,70,56
],[
5,5,5,2,5,5,16,107,226,88,19,122,178,55,207,125,65,254,88,141
],[
5,2,5,2,5,2,86,46,184,213,130,229,44,243,245,93,145,162,149,181
],[
5,2,5,2,5,2,25,150,82,244,66,168,179,75,9,51,181,154,90,190
],[
2,2,2,12,2,2,214,54,204,219,109,234,139,78,60,59,149,114,72,240
],[
2,2,7,2,2,2,42,217,233,210,125,51,29,177,176,113,33,167,255,42
],[
2,2,7,2,5,5,67,161,60,61,242,26,123,184,23,42,14,248,168,192
],[
2,2,7,2,5,2,180,18,121,43,13,114,86,224,81,194,80,119,66,14
],[
2,2,7,2,5,5,84,246,95,37,2,82,91,66,187,51,205,235,252,248
],[
2,2,7,2,5,2,41,26,235,251,239,155,48,22,34,181,6,102,252,12
],[
2,2,7,2,5,5,146,78,224,198,115,191,144,237,154,183,160,20,92,8
],[
2,2,2,2,2,2,43,62,197,91,196,251,48,116,175,212,20,184,82,233
],[
13,2,2,2,3,3,33,236,230,217,140,63,114,226,167,139,250,74,180,216
],[
2,2,2,2,2,2,243,253,251,34,251,119,26,92,199,228,157,180,93,134
],[
206,25,131,88,206,250,119,241,229,81,224,170,23,225,5,3,248,187,61,67
],[
193,7,166,95,162,1,26,29,90,66,95,121,6,65,158,72,54,25,23,27
],[
70,141,18,102,236,73,25,226,13,106,100,47,213,65,149,190,6,84,166,238
]
]