aLevelData = [
[
2,2,2,5,2,2,2,5,2,2,162,221,246,56,0,115,101,158,246,92
],[
2,2,2,2,2,5,2,2,2,5,143,180,54,77,229,120,221,194,130,229
],[
2,2,3,3,3,3,3,3,3,3,4,68,97,95,145,231,206,81,83,24
],[
2,3,2,2,2,2,2,2,2,2,26,21,79,149,147,20,84,189,179,46
],[
2,3,2,2,2,2,2,2,2,2,214,10,152,92,249,220,180,147,235,120
],[
2,2,2,2,2,5,5,5,5,2,198,236,119,80,9,3,215,133,171,156
],[
2,2,3,3,3,3,2,3,2,3,202,170,128,141,231,203,248,216,49,173
],[
2,2,3,2,2,3,2,3,2,3,79,23,235,88,3,29,174,211,139,218
],[
2,2,3,2,2,3,2,3,2,3,184,47,70,127,135,198,178,227,167,197
],[
222,37,200,232,34,148,19,133,13,203,190,204,159,32,222,77,184,64,125,187
],[
209,19,237,239,234,230,91,47,195,200,167,177,79,52,116,91,102,241,123,205
],[
186,55,36,161,12,19,87,241,160,12,143,26,238,7,49,192,154,104,29,19
],[
166,122,130,80,231,17,246,138,181,110,198,170,231,98,138,181,255,183,253,77
],[
161,203,12,123,74,126,45,171,62,78,242,248,194,193,222,170,140,4,119,253
],[
120,209,156,37,124,149,25,142,222,211,121,104,164,195,28,99,77,64,137,183
],[
190,225,4,104,127,101,100,200,39,84,31,61,21,227,167,68,97,24,249,182
],[
18,48,114,75,146,62,229,92,95,20,236,237,2,102,123,234,69,45,187,177
],[
161,74,21,209,246,108,140,17,127,51,81,181,4,150,145,252,81,130,146,237
],[
232,195,254,83,243,40,127,7,124,226,139,109,224,46,130,65,129,52,246,148
],[
188,46,73,17,27,204,126,133,203,215,73,159,80,22,104,244,119,110,54,69
]
]