aLevelData = [
[
2,2,3,3,3,3,3,3,3,3,3,3,3,3,3,130,248,244,219,197
],[
2,2,2,2,2,2,2,2,2,2,2,2,2,2,2,149,41,84,80,84
],[
3,2,3,3,3,3,3,3,3,3,3,2,3,3,3,15,122,144,188,158
],[
2,2,2,2,2,2,2,2,2,2,2,2,2,2,3,185,83,53,46,86
],[
3,2,3,3,3,3,3,3,3,3,3,3,3,2,3,218,203,46,82,47
],[
2,2,3,2,2,2,2,2,2,2,2,2,3,2,3,47,24,145,185,254
],[
164,59,13,70,61,99,7,71,177,230,26,118,44,150,228,200,103,152,5,44
],[
29,11,50,89,191,234,133,203,104,52,23,8,19,74,209,40,12,152,127,148
],[
164,119,38,14,41,82,152,242,21,8,69,187,134,146,84,200,238,230,243,97
],[
12,27,235,245,27,205,119,165,73,195,86,7,106,207,31,35,238,246,213,194
],[
16,209,187,233,81,51,105,160,37,13,32,247,236,142,91,75,35,142,166,198
],[
220,44,179,37,107,182,171,190,99,202,194,193,193,187,14,190,102,54,153,103
],[
203,38,181,152,240,212,143,148,149,83,7,146,173,27,191,120,16,244,114,230
],[
112,22,136,118,142,142,231,66,173,227,11,167,71,250,89,73,0,55,176,87
],[
216,229,66,17,164,216,162,135,191,80,29,163,253,33,78,105,224,17,237,126
],[
15,130,232,231,3,81,181,20,4,253,230,29,84,12,254,75,170,170,131,218
],[
225,148,84,253,242,52,61,35,32,13,201,121,114,90,87,176,102,242,112,0
],[
228,111,88,109,113,143,227,73,165,219,138,250,223,134,190,253,55,151,125,43
],[
180,75,34,59,192,180,129,137,216,167,51,21,136,213,47,207,151,56,154,18
],[
127,177,225,110,31,239,4,170,180,146,53,9,6,144,161,205,223,216,142,250
]
]