aLevelData = [
[
12,2,2,2,2,2,2,2,2,2,234,196,100,104,97,92,234,51,50,150
],[
2,2,2,2,2,2,2,2,2,2,117,36,226,50,216,151,247,244,214,18
],[
2,2,3,3,3,3,3,3,3,3,101,73,53,18,73,46,21,11,217,78
],[
11,2,3,2,2,2,2,2,2,3,128,170,155,106,66,93,214,254,251,21
],[
2,2,3,2,2,2,2,2,2,3,71,34,114,75,20,174,44,65,6,161
],[
2,2,3,2,2,2,2,2,2,3,62,138,242,196,95,204,120,138,65,197
],[
240,59,34,140,162,81,158,25,53,35,199,8,107,192,119,154,11,30,229,253
],[
30,116,119,205,93,228,215,218,235,93,73,44,64,192,60,68,101,65,30,165
],[
103,17,117,147,6,58,44,27,173,202,42,83,167,51,42,227,143,242,198,196
],[
8,111,212,72,175,36,246,91,78,2,109,8,83,16,46,63,128,86,56,213
],[
227,249,36,204,9,167,254,213,111,53,83,19,57,135,139,34,38,177,121,88
],[
196,91,49,74,224,106,26,146,65,221,68,208,150,244,251,239,172,152,156,170
],[
228,247,167,78,229,111,22,193,142,173,237,195,46,22,19,116,248,101,96,22
],[
177,150,247,21,172,4,214,68,248,206,171,106,216,126,233,253,115,237,28,45
],[
205,97,122,37,246,249,186,141,130,75,41,83,56,75,250,171,15,111,221,84
],[
86,16,212,29,50,20,66,169,77,202,69,111,205,21,70,4,131,205,207,157
],[
101,98,156,208,63,194,244,154,165,125,58,166,44,39,191,204,218,255,218,217
],[
218,205,59,142,116,17,124,235,61,89,249,173,139,243,226,21,44,196,142,235
],[
88,120,18,195,227,220,19,127,183,135,216,21,130,192,163,146,172,156,66,95
],[
140,103,225,195,219,69,34,170,105,25,112,165,14,166,144,49,228,245,120,60
]
]