aLevelData = [
[
5,5,3,5,5,5,5,5,5,5,3,5,5,5,5,5,5,5,42,41
],[
4,2,3,5,5,5,5,5,5,5,3,5,5,5,5,5,5,5,53,164
],[
2,2,3,2,3,3,3,3,3,2,3,3,3,3,3,5,5,3,147,66
],[
5,2,2,2,3,2,2,2,2,2,5,5,5,5,5,5,5,3,46,49
],[
2,2,2,3,2,2,2,2,2,2,5,5,5,5,5,5,5,3,194,120
],[
2,2,2,3,2,2,5,3,3,2,3,3,3,3,3,5,5,3,135,118
],[
2,2,2,2,2,2,5,5,3,2,2,2,2,2,2,2,2,3,70,41
],[
5,2,2,2,2,2,5,5,3,2,2,2,2,2,2,2,2,3,249,211
],[
2,2,5,5,3,2,5,5,3,2,3,3,3,5,5,3,5,3,88,192
],[
2,2,5,5,3,2,5,5,3,6,3,3,5,5,5,3,5,3,16,54
],[
118,207,233,215,77,95,59,37,220,132,148,255,215,52,229,40,73,88,65,245
],[
126,36,226,73,32,164,109,195,160,152,118,54,215,130,71,90,238,253,221,193
],[
123,80,52,12,236,67,197,94,41,50,76,17,117,95,206,168,149,140,219,5
],[
53,202,17,221,135,140,225,104,45,255,150,93,89,158,146,29,51,1,219,46
],[
123,245,215,236,111,210,84,123,239,9,203,0,223,253,230,17,205,20,63,106
],[
211,13,107,225,191,148,55,156,114,19,49,129,134,204,107,238,52,37,123,170
],[
116,66,198,28,101,217,255,187,240,66,234,198,168,206,102,53,245,90,170,239
],[
114,36,207,61,147,221,143,127,139,255,76,30,109,96,83,193,145,8,99,196
],[
57,63,105,230,116,235,142,65,67,25,115,128,251,218,187,76,234,80,203,7
],[
61,8,205,189,33,138,251,87,41,47,26,18,240,51,68,48,255,11,235,238
]
]