aLevelData = [
[
2,2,2,5,2,2,2,5,2,2,2,33,38,37,111,109,212,172,106,17
],[
105,171,115,32,253,235,4,188,125,178,23,135,80,221,233,90,58,47,254,58
],[
129,233,101,135,79,155,61,119,88,57,120,195,188,113,223,160,47,60,86,241
],[
87,180,98,187,117,37,232,217,72,102,56,241,47,106,73,166,141,18,70,15
],[
113,69,74,104,119,67,105,8,233,54,239,147,42,11,236,113,85,127,240,127
],[
33,125,19,4,8,167,56,230,168,51,147,30,105,248,105,105,96,200,23,64
],[
115,1,86,11,190,95,189,146,54,20,136,180,140,27,151,91,85,201,186,175
],[
103,165,43,138,134,121,92,44,64,169,243,49,21,196,19,192,219,89,222,4
],[
97,12,56,224,83,232,205,222,93,247,85,105,147,16,23,61,17,241,171,27
],[
222,142,5,193,23,168,175,25,73,160,86,177,30,142,136,107,60,142,188,118
],[
106,90,147,124,244,30,93,29,81,135,223,157,4,29,84,217,192,212,177,128
],[
207,221,45,127,181,194,1,189,16,178,108,9,194,26,251,81,82,117,7,20
],[
144,100,127,25,120,1,232,98,89,112,161,92,55,184,108,88,109,209,42,62
],[
150,255,230,128,174,94,21,78,117,189,28,9,20,175,19,249,3,224,201,66
],[
42,166,8,20,71,216,26,35,143,227,139,87,152,26,49,196,118,78,106,220
],[
37,159,165,227,39,145,36,164,109,99,0,99,123,156,109,18,200,230,63,200
],[
99,31,173,110,220,174,85,188,98,19,129,100,41,194,169,140,15,50,57,130
],[
126,49,147,171,148,122,88,189,129,137,228,46,49,174,23,237,44,97,91,79
],[
186,213,226,76,74,208,48,235,20,185,218,251,254,243,141,4,188,105,81,125
],[
60,106,15,63,65,184,81,58,78,219,74,103,197,187,22,253,80,110,67,232
]
]