aLevelData = [
[
2,2,2,2,2,2,2,2,2,2,2,2,2,2,2,2,147,189,76,38
],[
2,2,2,2,2,2,2,2,3,3,3,3,3,3,3,3,244,163,191,165
],[
2,2,3,2,3,2,2,2,2,3,2,2,2,2,2,2,55,224,52,0
],[
2,2,3,2,3,2,2,2,2,2,3,2,2,2,2,2,53,251,233,18
],[
2,2,3,2,3,2,2,2,2,2,2,3,2,2,2,2,175,190,77,27
],[
2,2,3,2,2,2,2,2,2,2,2,2,3,2,2,3,52,141,7,182
],[
2,2,3,2,3,3,3,3,3,3,3,3,3,2,2,2,68,247,58,12
],[
2,2,3,2,2,2,2,2,2,2,2,2,2,2,2,2,181,139,7,72
],[
2,2,3,2,3,3,3,3,3,3,3,3,3,3,3,3,86,237,84,75
],[
2,2,3,2,2,2,2,2,2,2,2,2,2,2,2,2,211,41,204,160
],[
2,2,3,3,3,3,3,3,3,3,3,3,3,3,3,3,216,70,39,178
],[
1,2,3,2,2,2,2,2,2,2,2,2,2,2,2,2,121,31,172,60
],[
2,2,3,5,5,2,2,2,5,5,5,5,5,5,5,5,210,110,244,2
],[
2,2,3,2,2,5,5,5,5,5,2,2,2,2,2,2,234,42,240,191
],[
6,5,3,3,3,2,5,2,2,2,2,2,2,2,2,2,222,19,46,94
],[
5,2,3,2,2,3,2,5,2,2,2,2,2,2,2,5,59,139,87,108
],[
5,3,2,2,2,2,3,2,5,5,2,2,2,2,5,3,171,167,253,206
],[
5,3,2,2,2,2,2,3,2,5,2,2,2,5,3,2,212,134,147,175
],[
125,225,189,189,242,228,203,149,170,60,127,123,40,114,23,79,31,119,135,188
],[
217,128,7,179,217,19,205,24,192,98,28,187,109,217,125,137,104,243,77,4
]
]