aLevelData = [
[
4,2,2,2,2,2,2,132,54,29,158,232,86,25,216,247,60,117,222,214
],[
5,2,5,3,2,2,2,5,40,221,214,77,174,109,250,163,174,175,180,57
],[
2,5,5,3,3,3,3,218,152,240,224,22,140,83,52,221,47,197,20,225
],[
3,3,5,5,5,5,5,120,45,86,242,7,123,184,33,184,236,25,37,120
],[
137,233,254,87,242,222,216,223,89,232,49,164,209,104,62,29,201,157,139,178
],[
211,94,227,22,171,15,111,215,116,206,33,52,68,237,84,46,227,165,172,226
],[
208,8,68,21,133,56,8,17,252,215,95,176,114,190,14,182,107,242,89,99
],[
246,211,106,73,50,151,247,92,17,247,32,72,92,40,150,7,248,13,2,178
],[
103,171,165,151,145,221,59,141,197,73,38,132,251,146,200,96,92,208,49,8
],[
4,61,250,185,6,48,112,161,176,80,246,169,17,1,164,146,185,35,52,67
],[
192,252,31,97,10,114,3,33,200,126,72,90,66,221,3,223,213,9,26,11
],[
55,103,170,157,3,194,165,198,113,248,192,129,100,243,140,35,171,219,226,51
],[
128,138,133,123,85,65,3,95,209,153,220,110,21,188,230,55,67,212,240,94
],[
65,196,166,239,186,23,181,241,102,53,47,63,140,221,48,147,197,207,194,228
],[
2,201,254,242,208,181,116,31,219,33,205,128,177,239,175,52,201,78,225,244
],[
196,233,176,236,242,94,145,201,24,241,7,20,113,130,199,190,242,188,27,252
],[
210,144,132,85,74,225,163,248,154,129,89,84,76,93,46,227,188,244,239,70
],[
216,14,155,151,37,170,129,251,3,56,162,118,49,8,92,4,147,3,74,229
],[
51,153,102,56,135,250,112,203,242,137,148,50,140,141,71,22,38,42,114,208
],[
137,145,210,54,255,115,158,181,21,187,107,161,158,124,78,200,251,40,64,77
]
]