aLevelData = [
[
10,2,2,8,2,2,2,2,2,2,2,2,2,2,2,2,2,2,81,106
],[
2,2,2,2,2,2,2,2,2,2,2,2,2,2,2,2,2,2,45,234
],[
2,2,2,2,2,2,3,3,3,3,2,2,2,2,2,3,3,3,19,38
],[
9,2,2,2,2,2,2,2,2,3,2,2,2,2,2,3,2,2,53,102
],[
3,3,3,3,3,3,3,2,2,3,2,2,2,2,2,2,2,2,41,141
],[
2,2,2,2,2,2,2,2,2,3,2,2,2,2,2,3,2,2,75,132
],[
2,2,2,2,2,2,2,2,2,3,3,2,2,2,2,3,2,2,241,16
],[
2,2,2,2,2,2,2,2,2,2,3,2,2,2,2,3,2,2,108,93
],[
2,2,2,2,2,2,2,2,2,2,3,2,2,2,2,3,2,2,239,184
],[
2,2,2,2,3,3,3,3,2,2,3,2,2,2,2,3,2,2,210,84
],[
2,2,2,2,3,2,2,3,2,2,3,2,2,2,2,3,2,2,204,21
],[
2,2,2,2,3,2,2,3,2,2,3,3,3,5,2,3,2,2,24,168
],[
2,2,2,2,3,2,2,3,2,2,2,2,3,2,2,3,2,2,159,120
],[
160,69,108,98,50,224,234,59,229,66,138,71,67,228,180,215,168,189,84,188
],[
235,88,149,1,64,41,236,218,93,33,89,215,220,128,234,93,225,235,128,87
],[
252,190,213,41,81,163,190,229,246,100,174,194,156,253,124,202,114,246,102,210
],[
70,239,85,175,237,125,99,167,230,52,154,38,58,5,254,178,166,203,206,33
],[
252,32,8,10,199,117,43,121,46,98,64,231,27,58,27,105,156,227,223,39
],[
137,228,192,16,103,192,13,204,140,131,109,242,132,154,105,124,180,231,42,120
],[
61,21,132,0,35,41,52,107,175,90,102,197,17,35,123,125,74,150,8,94
]
]