aLevelData = [
[
2,2,2,2,5,5,118,101,197,81,21,65,67,216,187,220,9,6,245,35
],[
2,2,2,4,2,156,88,28,149,204,111,31,250,152,99,130,81,76,89,167
],[
5,3,3,3,5,10,236,88,77,117,213,88,86,123,162,156,205,140,77,66
],[
2,3,2,2,2,39,216,150,25,201,194,169,178,203,145,251,186,252,105,117
],[
2,3,2,2,2,134,38,123,212,240,147,120,80,98,207,75,123,48,176,7
],[
2,3,2,2,3,109,43,148,30,30,115,234,213,19,140,244,244,61,180,202
],[
2,3,2,2,3,194,30,116,163,48,45,118,80,85,124,150,9,26,152,59
],[
2,3,2,2,3,108,55,176,232,195,94,250,14,134,181,83,37,33,138,38
],[
2,3,3,2,3,250,246,67,142,75,166,147,191,145,140,244,162,29,139,81
],[
2,2,3,2,3,191,102,10,2,96,162,60,254,243,147,165,76,177,164,218
],[
2,2,3,2,3,187,125,52,136,211,15,50,183,11,81,234,80,61,9,30
],[
2,2,3,2,3,221,86,185,89,145,82,195,128,136,104,209,170,79,129,116
],[
2,2,2,2,3,49,167,239,12,10,134,92,231,81,95,0,173,40,163,24
],[
251,194,136,147,78,187,9,14,35,171,46,2,92,250,141,60,230,246,17,142
],[
153,34,250,197,95,209,37,218,153,244,142,109,190,49,19,110,69,53,123,30
],[
198,74,182,54,92,44,102,101,77,24,159,0,237,39,235,246,191,218,146,2
],[
222,246,24,36,155,146,6,81,104,110,238,106,245,134,169,107,152,231,227,229
],[
242,194,218,174,208,191,98,214,79,147,45,222,68,213,73,37,218,13,234,163
],[
125,15,106,217,247,135,142,8,217,212,11,162,29,26,72,254,9,146,102,79
],[
87,37,126,215,146,58,41,88,195,204,70,204,77,191,247,85,22,116,237,119
]
]