aLevelData = [
[
4,2,2,2,2,2,103,160,159,16,32,187,186,190,94,103,190,215,225,185
],[
5,2,5,3,2,2,126,184,31,151,85,26,129,29,2,148,206,64,182,97
],[
2,5,5,3,3,3,231,177,108,100,182,4,121,105,97,18,100,174,195,156
],[
3,3,5,5,5,5,247,162,28,49,150,236,7,81,208,175,173,210,52,12
],[
2,3,5,5,5,5,57,131,102,233,140,16,114,241,49,37,95,220,147,214
],[
3,3,5,5,5,5,8,241,109,63,39,201,131,103,179,85,144,107,108,35
],[
3,5,5,5,5,5,127,216,180,220,221,88,160,18,143,145,79,56,192,74
],[
3,5,5,3,3,3,122,242,30,207,77,144,70,151,117,212,124,37,123,252
],[
3,5,5,3,2,2,160,44,80,252,93,246,41,12,164,6,140,98,89,253
],[
3,5,5,3,2,2,171,65,76,186,242,50,106,197,220,146,53,238,10,76
],[
3,5,5,3,2,2,113,49,150,232,32,221,165,197,177,246,59,162,117,215
],[
84,99,82,27,48,18,187,190,238,37,223,128,92,255,33,138,14,185,201,84
],[
173,33,249,198,146,3,226,158,147,168,55,17,29,157,226,181,132,181,247,158
],[
150,81,230,199,118,223,244,180,168,161,236,86,104,176,17,47,64,64,88,183
],[
217,37,212,253,18,151,114,145,79,50,230,162,19,64,229,100,210,59,149,180
],[
0,142,66,255,110,156,82,96,214,3,123,8,181,34,51,227,88,217,104,121
],[
58,143,114,18,141,122,70,29,23,26,236,210,63,7,51,23,104,237,163,160
],[
125,213,179,91,205,166,60,11,26,235,46,50,236,214,130,53,43,133,111,187
],[
237,133,225,86,141,149,39,101,253,172,235,57,93,61,104,118,204,185,215,188
],[
126,86,42,135,14,15,253,84,22,235,202,6,254,131,92,135,17,190,134,178
]
]