aLevelData = [
[
2,2,2,2,2,2,2,180,71,90,176,44,174,250,145,134,232,182,95,89
],[
255,255,21,189,125,201,44,93,47,60,119,205,41,173,76,30,10,204,228,176
],[
129,31,4,72,16,175,221,98,16,1,50,201,246,71,184,100,212,216,194,83
],[
35,222,29,59,191,78,57,221,51,30,138,238,55,178,46,34,119,151,208,139
],[
150,115,204,33,115,60,148,162,171,169,82,156,95,230,207,199,55,140,147,153
],[
166,208,78,21,112,251,118,228,106,26,50,166,129,246,119,138,254,70,112,28
],[
9,36,36,95,107,190,83,28,152,78,160,121,236,76,246,205,53,225,36,179
],[
114,160,202,94,218,113,121,44,32,205,22,125,246,49,127,197,208,204,113,224
],[
234,123,170,166,140,248,74,192,141,79,127,186,22,145,97,88,168,203,27,46
],[
96,57,76,107,122,184,173,246,21,122,243,188,53,253,247,72,14,62,20,148
],[
128,42,208,30,222,85,191,63,243,238,165,184,71,243,219,142,158,161,244,25
],[
194,47,159,87,130,187,207,134,251,133,26,241,22,91,95,10,82,84,172,185
],[
196,193,95,244,92,97,139,144,105,212,157,86,95,82,63,90,216,157,124,136
],[
218,52,37,128,88,202,116,164,251,246,240,110,34,44,144,8,39,236,35,22
],[
228,57,239,214,117,77,153,108,64,139,69,119,51,181,253,232,77,95,87,20
],[
96,164,82,8,21,23,130,28,48,252,109,203,21,185,52,193,139,135,118,54
],[
193,109,113,123,143,111,106,210,253,3,79,131,9,196,156,44,165,106,123,89
],[
0,250,47,84,6,58,178,63,42,104,157,95,99,43,73,187,116,202,52,230
],[
113,156,166,25,127,192,148,132,219,13,196,230,30,76,50,92,191,165,179,118
],[
217,88,216,144,46,174,21,96,109,46,34,203,176,19,162,253,73,254,3,184
]
]