aLevelData = [
[
2,233,79,154,240,61,151,54,4,133,112,214,227,239,99,177,119,11,201,141
],[
2,251,119,222,132,177,187,23,8,216,114,182,37,217,171,155,6,193,142,93
],[
187,243,67,153,57,31,15,138,162,110,192,218,199,255,76,184,236,151,181,43
],[
203,148,47,166,219,35,133,220,209,179,185,213,103,170,235,66,93,86,123,14
],[
190,38,114,53,101,26,30,217,191,120,253,147,211,193,221,7,127,227,64,187
],[
4,176,5,41,197,143,69,18,75,113,124,22,141,7,233,130,110,51,55,105
],[
136,188,92,246,40,69,194,0,153,128,164,223,166,159,188,126,90,11,27,178
],[
10,89,88,202,150,122,236,104,235,49,221,143,204,202,154,252,211,10,38,186
],[
178,98,121,241,191,103,36,255,176,135,51,201,162,244,87,83,97,229,69,143
],[
227,254,89,115,21,12,127,78,219,246,83,92,81,241,135,152,88,242,133,209
],[
78,105,86,0,28,44,195,217,118,177,186,160,94,129,243,62,234,233,210,148
],[
72,243,144,15,255,149,150,125,119,39,41,31,188,26,76,255,127,232,226,131
],[
94,71,20,67,101,162,242,24,212,201,93,117,34,232,36,251,67,182,109,71
],[
39,238,87,15,131,3,221,109,211,16,254,122,160,13,26,31,254,73,160,40
],[
90,20,230,154,114,188,88,71,165,188,213,159,109,47,86,201,42,139,209,243
],[
33,139,93,230,196,109,150,221,52,94,67,151,4,51,54,171,64,89,116,28
],[
173,15,150,45,83,210,111,118,57,25,239,56,112,67,71,238,82,206,78,36
],[
12,201,36,140,90,140,21,79,146,166,192,161,228,23,120,152,224,192,234,62
],[
56,23,0,229,200,31,6,186,211,152,12,157,144,114,139,48,229,136,75,46
],[
114,139,131,255,209,60,67,137,28,223,15,72,176,236,204,161,49,7,225,115
]
]