aLevelData = [
[
4,2,2,2,2,2,2,2,2,2,8,2,255,170,106,212,197,217,150,102
],[
2,2,3,2,9,2,2,2,2,2,2,2,14,56,7,168,199,210,44,160
],[
2,3,2,2,2,2,3,2,2,3,2,3,236,129,5,157,157,181,216,29
],[
2,3,2,2,2,3,2,2,3,2,2,2,115,113,38,237,20,150,221,146
],[
2,3,2,2,3,2,2,3,2,2,2,2,5,100,207,232,192,62,99,9
],[
2,3,2,3,2,2,3,2,2,3,2,3,7,173,138,112,119,168,245,95
],[
2,2,3,2,2,3,2,2,3,2,2,2,96,19,134,125,212,133,4,196
],[
2,2,2,2,3,2,2,3,2,2,2,2,254,78,18,154,181,185,98,62
],[
2,2,2,3,2,2,3,2,2,3,2,3,81,142,38,102,190,219,199,39
],[
2,2,3,2,2,3,2,2,3,2,2,2,207,244,218,20,212,185,80,170
],[
2,2,5,2,3,2,2,3,2,2,2,2,110,23,236,236,162,210,251,74
],[
2,2,2,3,2,2,3,2,2,3,2,3,45,129,63,199,23,218,44,91
],[
2,2,3,2,5,3,2,2,3,2,2,2,139,47,87,150,230,57,43,135
],[
2,3,2,2,3,5,2,3,2,2,2,2,14,21,221,220,5,140,163,74
],[
2,2,2,3,2,2,3,2,2,3,2,3,190,151,33,48,47,34,36,119
],[
2,2,3,2,2,3,2,5,3,2,2,2,167,17,147,188,98,129,163,177
],[
91,80,73,192,97,223,245,242,109,22,125,16,51,169,87,8,247,154,12,145
],[
162,0,233,18,21,6,248,192,189,54,47,7,103,248,230,44,86,85,143,48
],[
147,1,161,247,133,153,213,170,193,41,149,89,35,241,177,229,30,105,85,29
],[
80,130,56,39,90,47,21,34,238,36,95,9,42,221,49,218,36,227,132,248
]
]