aLevelData = [
[
10,2,2,169,128,197,11,170,103,145,94,200,8,255,101,1,186,21,222,167
],[
2,2,2,212,225,111,88,205,11,235,49,162,177,209,63,120,110,21,54,131
],[
2,2,2,188,35,102,38,125,34,234,92,212,117,35,86,57,136,101,102,205
],[
9,2,2,201,239,27,234,244,33,174,255,148,233,156,155,199,127,149,199,65
],[
3,3,3,82,149,153,147,66,81,6,173,15,212,248,162,17,106,160,172,42
],[
2,2,2,189,14,112,250,62,255,131,81,198,246,44,234,125,142,108,86,252
],[
2,2,2,14,59,54,174,62,21,173,124,121,181,21,169,4,33,241,250,158
],[
2,2,2,230,35,27,88,165,96,62,167,206,224,5,184,172,90,162,3,162
],[
2,2,2,47,61,35,180,230,149,229,72,216,235,159,46,44,28,195,223,6
],[
2,2,2,13,179,2,252,75,215,53,202,243,238,9,70,208,161,78,150,196
],[
2,2,2,94,146,160,105,99,228,194,247,25,222,195,105,164,226,10,219,184
],[
2,2,2,163,14,55,174,231,14,16,215,140,2,206,16,201,209,12,150,183
],[
2,2,2,196,62,28,16,59,151,27,54,159,42,106,119,151,79,14,143,127
],[
2,2,2,72,83,110,22,36,28,60,118,228,119,155,74,221,116,44,59,93
],[
56,84,171,145,77,64,166,166,60,38,21,47,94,206,53,199,239,82,72,247
],[
100,34,139,90,254,74,103,254,160,248,235,14,222,56,122,174,86,3,193,39
],[
67,120,236,68,79,105,26,252,169,25,14,80,88,68,39,119,207,96,146,57
],[
193,35,190,153,54,69,16,182,223,135,217,243,166,244,133,86,138,103,21,46
],[
170,77,207,249,159,172,51,132,15,101,50,84,127,182,155,69,105,2,214,113
],[
143,213,212,83,142,35,70,45,182,208,13,166,25,117,242,184,226,98,152,201
]
]