aLevelData = [
[
2,2,59,172,90,193,230,89,139,195,104,129,76,28,198,102,223,215,117,247
],[
2,3,140,239,19,175,241,87,85,187,154,61,65,91,209,144,157,138,183,192
],[
2,3,167,225,148,197,6,185,108,98,1,144,211,171,239,174,1,197,238,7
],[
41,237,216,100,7,187,115,190,185,168,232,234,207,207,119,124,165,240,104,229
],[
241,186,69,222,152,74,70,10,198,239,13,214,61,48,147,165,237,16,99,42
],[
197,144,6,20,202,118,190,241,102,77,119,76,2,173,250,25,215,188,100,84
],[
0,245,214,228,212,40,111,197,116,194,119,102,160,79,221,80,207,61,228,9
],[
126,227,25,56,200,194,136,9,55,10,47,211,218,96,179,249,151,222,82,14
],[
195,91,25,60,240,237,87,230,6,173,81,140,150,186,55,239,106,129,87,118
],[
97,59,145,209,122,182,11,220,46,89,38,198,3,99,176,114,94,115,91,29
],[
152,77,109,66,85,219,186,186,17,114,207,40,252,87,113,148,8,130,70,86
],[
64,161,209,54,91,96,164,209,145,232,208,63,173,165,161,242,100,77,136,225
],[
229,30,89,230,177,103,182,101,173,73,203,47,117,191,61,166,244,220,92,33
],[
50,84,160,146,108,62,83,102,106,24,139,172,13,12,91,122,40,113,74,140
],[
144,149,4,47,119,186,80,93,245,94,66,42,232,192,178,95,254,159,237,100
],[
16,69,169,99,178,196,63,170,8,128,20,81,219,237,88,29,235,154,244,165
],[
135,111,189,179,92,51,238,237,139,80,213,181,254,219,204,77,251,207,107,63
],[
249,153,252,252,179,218,47,195,124,104,16,196,210,150,53,134,53,181,60,134
],[
58,218,117,33,219,226,219,179,17,180,73,1,165,198,234,212,66,227,242,231
],[
208,43,139,3,253,91,18,105,28,78,132,112,51,196,51,111,79,99,190,221
]
]