aLevelData = [
[
4,2,5,5,2,2,2,2,2,2,2,2,2,2,2,2,2,245,54,61
],[
2,2,2,2,2,2,5,2,2,2,5,2,2,2,5,3,3,183,203,125
],[
2,2,2,2,2,2,3,3,3,3,3,3,3,2,2,2,2,75,32,19
],[
3,3,3,3,3,3,3,2,2,2,2,2,3,2,2,2,2,84,238,254
],[
2,2,3,2,2,2,2,2,2,2,2,2,3,2,2,2,2,107,185,191
],[
13,2,3,2,2,2,2,2,2,3,2,2,3,2,2,2,2,206,106,176
],[
2,5,3,2,2,2,2,2,2,3,2,2,3,2,2,2,2,59,114,120
],[
2,12,3,2,2,2,2,2,2,3,2,2,3,2,2,2,2,211,44,215
],[
5,2,3,3,3,3,3,3,3,3,2,2,3,3,3,3,3,227,9,101
],[
11,2,3,2,2,2,2,2,2,2,2,2,2,2,2,2,2,213,47,150
],[
2,5,3,2,2,2,2,2,2,2,2,2,2,2,2,2,2,178,86,173
],[
2,10,3,2,2,2,2,2,2,2,2,2,2,2,2,2,2,84,15,187
],[
5,2,2,2,2,2,2,2,2,2,2,2,2,2,2,2,2,79,63,24
],[
2,2,2,2,2,2,2,2,2,2,2,2,2,2,2,2,2,123,186,55
],[
9,5,3,2,2,2,2,2,2,2,2,2,2,2,2,2,2,193,13,157
],[
2,2,3,2,2,2,2,2,3,3,3,3,3,3,2,2,2,2,71,9
],[
5,8,3,2,2,2,2,2,3,2,2,2,2,3,2,2,2,65,145,103
],[
2,2,3,2,2,2,2,2,5,2,1,2,2,3,2,2,2,138,98,132
],[
6,5,3,3,3,3,3,3,3,2,2,2,2,3,3,3,3,205,214,62
],[
2,2,2,2,2,2,2,2,2,2,2,2,2,2,2,2,2,240,207,65
]
]