aLevelData = [
[
2,2,2,5,2,2,2,5,2,2,2,5,2,2,2,5,2,2,2,204
],[
2,2,2,2,2,5,2,2,2,5,2,2,2,5,2,2,2,2,2,21
],[
2,2,3,3,3,3,3,3,3,3,3,3,3,3,3,3,2,2,2,78
],[
2,3,2,2,2,2,2,2,2,2,2,2,2,5,2,5,2,2,2,216
],[
2,3,2,2,2,2,2,2,2,2,8,2,2,2,2,2,2,2,2,75
],[
2,2,2,2,2,5,5,5,5,2,2,2,2,5,2,3,3,3,2,172
],[
2,2,3,3,3,3,2,3,2,3,2,2,2,3,2,3,2,2,3,146
],[
2,2,3,2,2,3,2,3,2,3,3,2,2,3,2,3,2,2,3,53
],[
2,2,3,2,2,3,2,3,2,3,2,3,2,3,2,3,2,2,2,248
],[
4,2,3,2,2,3,2,3,2,3,2,3,2,3,2,3,2,2,2,152
],[
2,2,3,3,3,2,2,3,2,3,2,3,2,3,2,3,2,3,3,48
],[
2,2,3,2,3,2,2,3,2,3,2,2,3,3,2,3,2,2,3,108
],[
2,2,3,2,3,2,2,3,2,3,2,2,3,3,2,3,2,2,3,92
],[
143,29,113,44,198,200,195,121,86,243,241,39,228,193,93,160,129,16,64,201
],[
207,8,238,54,101,244,92,154,117,81,223,129,172,37,54,65,90,147,203,45
],[
211,171,54,13,21,135,3,203,171,147,181,111,209,44,10,77,216,109,129,125
],[
204,69,26,140,85,205,93,113,219,217,157,195,237,206,126,41,228,179,181,17
],[
195,138,15,165,98,224,181,250,204,163,174,139,229,52,165,231,80,189,237,166
],[
143,197,194,161,108,1,210,99,152,109,252,218,147,156,87,82,203,76,118,165
],[
8,62,234,171,7,69,9,248,101,156,238,199,192,124,193,49,24,238,57,163
]
]