aLevelData = [
[
2,190,0,89,28,219,56,67,241,236,156,151,178,174,128,173,104,220,68,181
],[
2,154,176,203,83,99,168,46,141,199,134,178,231,71,154,248,204,179,67,116
],[
2,48,64,180,32,116,219,244,114,138,188,40,139,89,61,21,177,99,237,225
],[
2,255,165,224,25,91,190,74,249,169,84,76,231,62,180,14,64,152,184,14
],[
2,87,76,238,184,187,63,246,54,185,25,44,137,34,247,136,217,79,97,194
],[
2,9,97,123,185,143,205,127,21,131,25,106,43,245,224,246,34,132,28,201
],[
2,84,44,165,236,247,96,244,126,253,89,45,170,56,173,93,214,194,35,255
],[
2,29,156,198,198,0,149,56,150,88,110,73,211,143,59,200,223,16,12,154
],[
2,222,252,205,8,189,31,107,93,114,34,57,177,133,2,145,0,207,193,190
],[
2,127,130,91,25,47,105,251,115,178,113,111,179,94,105,217,192,144,6,168
],[
2,162,66,42,199,228,224,101,20,60,88,189,20,110,113,170,229,109,93,101
],[
116,195,145,98,240,52,212,27,126,158,150,16,46,36,132,12,45,139,89,169
],[
61,228,247,22,99,108,182,24,223,176,252,79,97,245,14,187,122,214,37,127
],[
81,47,197,228,151,58,74,160,189,248,196,89,100,211,4,101,21,129,247,212
],[
50,43,51,176,44,207,208,131,247,227,121,26,187,59,194,137,205,44,188,111
],[
221,242,200,123,113,79,168,47,146,117,220,228,196,38,43,15,60,26,128,194
],[
78,161,247,118,37,137,56,7,182,66,4,0,246,64,13,25,75,161,11,254
],[
65,16,12,82,127,233,11,244,249,157,197,129,103,89,200,26,245,226,205,103
],[
60,196,71,219,113,171,60,58,220,17,84,89,140,25,48,38,74,187,252,231
],[
203,34,72,199,42,82,19,142,149,14,41,176,70,249,176,137,180,251,253,231
]
]