aLevelData = [
[
6,2,2,2,2,2,7,78,145,53,240,248,166,255,184,116,253,216,210,114
],[
2,2,2,2,2,2,85,18,155,244,126,209,245,93,24,192,50,203,157,2
],[
2,2,2,2,2,2,53,167,162,108,211,123,89,241,127,3,91,93,39,134
],[
3,3,3,3,3,3,164,71,89,102,223,64,170,247,229,81,88,141,128,165
],[
2,2,2,2,2,2,46,217,116,130,168,117,192,126,88,189,33,239,136,225
],[
2,2,2,2,2,2,216,163,33,56,173,209,204,215,52,80,86,99,79,7
],[
2,2,2,2,2,3,89,35,244,165,25,89,48,146,172,211,108,37,94,189
],[
2,2,3,3,3,3,240,23,83,185,165,55,110,50,31,96,114,236,218,168
],[
2,2,2,2,2,2,103,224,196,219,64,72,252,40,186,246,218,25,135,233
],[
2,2,2,2,2,2,47,201,172,34,206,81,40,180,75,131,214,27,2,219
],[
3,3,3,3,3,3,148,206,91,178,165,24,77,181,84,35,33,150,218,86
],[
2,2,2,2,2,2,121,1,130,224,144,210,11,149,195,133,78,250,81,237
],[
2,2,2,2,2,2,33,155,95,41,122,165,63,213,216,176,241,125,222,221
],[
2,2,3,3,3,3,234,87,65,33,21,49,229,224,24,168,67,190,216,155
],[
14,178,63,223,22,92,61,52,108,152,12,120,199,83,185,27,38,157,224,211
],[
183,0,183,145,248,16,77,179,28,68,20,123,176,4,158,192,126,3,164,227
],[
178,207,76,5,59,167,171,119,116,140,137,114,4,154,101,9,3,153,185,91
],[
94,208,128,13,124,25,244,248,33,59,156,30,147,115,134,227,252,84,210,122
],[
16,210,112,157,239,153,41,129,77,163,228,9,208,9,34,58,185,25,204,239
],[
199,170,46,205,88,172,67,122,210,3,51,10,65,150,26,186,66,162,11,225
]
]