aLevelData = [
[
6,2,8,2,198,104,206,42,29,27,205,34,146,230,52,222,209,17,51,153
],[
2,2,2,2,182,94,155,177,189,165,244,98,186,188,202,212,202,153,71,88
],[
2,2,3,3,137,187,7,238,133,198,39,12,243,109,159,154,161,148,210,65
],[
2,2,3,2,44,182,100,229,115,133,76,112,75,209,42,210,117,171,218,70
],[
2,2,3,2,205,202,73,214,195,46,135,33,15,2,30,92,161,199,163,151
],[
2,2,3,2,215,175,138,65,243,71,62,239,204,89,114,89,196,17,177,165
],[
2,2,3,2,249,94,61,233,192,155,22,235,79,111,89,43,185,242,203,35
],[
2,2,3,5,32,17,182,205,37,51,244,102,164,29,73,114,159,18,246,0
],[
2,2,2,2,119,63,138,47,98,87,252,241,25,123,247,15,209,92,117,109
],[
2,3,2,2,109,163,143,144,242,145,147,93,59,226,88,35,238,248,206,220
],[
2,3,2,2,174,53,217,176,146,169,96,187,214,237,161,16,209,78,199,254
],[
2,3,2,3,39,46,190,146,64,168,70,92,249,115,70,118,153,9,99,195
],[
2,3,2,3,6,8,210,117,57,216,106,210,239,142,254,55,161,16,233,93
],[
183,122,234,219,249,193,51,236,70,151,188,115,136,142,221,60,231,127,28,133
],[
61,45,68,189,202,38,183,139,42,234,4,18,131,79,188,116,3,36,130,148
],[
138,21,98,33,163,206,100,208,185,100,96,232,136,240,19,4,209,125,115,20
],[
82,36,64,166,245,117,220,100,72,25,92,221,45,182,223,136,211,19,30,5
],[
228,125,69,167,0,105,2,48,107,90,219,219,2,5,196,160,116,179,241,179
],[
174,232,233,78,151,66,220,176,254,163,54,102,208,147,116,201,143,223,54,200
],[
255,134,150,231,35,214,185,136,103,211,163,105,31,216,80,111,48,129,0,162
]
]