aLevelData = [
[
6,2,8,2,9,2,10,2,11,3,2,2,5,2,2,2,5,32,90,123
],[
2,2,2,2,2,2,2,2,12,3,5,2,2,2,5,2,2,28,216,183
],[
17,144,31,59,195,8,80,31,238,61,206,142,39,65,245,193,208,191,81,105
],[
233,132,14,77,41,62,176,52,77,132,5,5,177,23,87,45,29,104,229,65
],[
225,90,149,228,36,72,227,236,121,74,29,192,179,180,210,4,251,224,136,121
],[
31,46,173,30,45,72,208,156,65,171,17,224,155,99,214,10,244,21,192,134
],[
18,67,222,120,155,204,32,94,39,178,14,241,152,32,185,75,174,172,242,79
],[
214,217,187,70,67,224,251,198,64,176,118,216,197,51,251,89,72,211,223,161
],[
213,61,171,99,97,100,18,212,92,201,38,16,133,251,203,185,2,89,107,225
],[
176,31,235,42,184,161,222,43,99,209,249,22,47,7,199,152,34,2,158,1
],[
94,42,210,165,246,23,40,130,0,87,142,35,235,108,9,196,19,21,238,182
],[
147,207,85,5,90,154,203,89,130,0,71,26,221,84,96,215,208,56,188,233
],[
100,97,204,83,154,159,182,237,255,23,147,194,129,211,219,182,129,126,29,108
],[
41,104,244,102,0,209,54,110,187,99,110,53,87,0,141,59,100,190,220,238
],[
164,48,53,22,212,232,115,112,202,57,39,153,192,66,141,46,240,39,190,50
],[
97,162,38,176,0,187,57,161,242,211,98,15,41,231,60,123,53,19,5,125
],[
93,85,80,170,239,148,249,186,212,225,94,235,103,252,204,160,136,26,56,78
],[
235,229,48,152,182,197,17,185,76,94,121,35,99,90,255,101,93,104,34,82
],[
213,132,128,96,120,122,73,78,22,165,242,10,248,253,46,209,117,81,26,152
],[
192,208,183,171,4,206,158,148,179,197,239,62,27,154,139,90,58,34,131,2
]
]