aLevelData = [
[
2,2,2,2,2,2,2,2,2,2,2,2,2,2,2,97,31,104,48,96
],[
2,2,2,2,2,2,2,2,2,2,2,2,2,2,2,235,229,82,104,194
],[
2,2,2,2,2,2,2,2,2,2,2,2,2,2,2,212,111,154,207,2
],[
2,2,2,13,2,2,2,2,2,2,2,2,2,2,2,42,220,242,27,143
],[
2,2,2,2,2,2,2,2,2,2,2,2,2,2,2,217,185,206,166,73
],[
2,2,2,2,2,2,2,2,2,2,2,2,2,2,2,140,44,71,115,39
],[
2,2,2,2,2,2,2,2,2,2,2,2,2,2,2,81,47,240,78,71
],[
2,2,2,2,2,2,2,2,2,1,2,2,2,2,2,84,177,187,39,118
],[
2,2,11,2,2,2,2,2,2,2,2,2,2,2,2,68,92,129,247,82
],[
2,2,2,2,2,2,2,2,2,2,2,2,2,2,2,187,254,236,109,190
],[
2,2,2,2,2,2,2,2,2,2,2,2,2,2,2,68,116,8,144,26
],[
2,2,2,2,2,2,2,2,2,2,2,2,2,2,2,73,199,223,205,148
],[
2,2,2,2,2,2,2,2,2,2,2,2,2,2,2,250,72,210,6,100
],[
2,2,2,2,2,2,2,2,2,2,2,2,2,2,2,15,172,36,64,20
],[
2,9,2,2,2,2,2,2,2,2,2,2,2,2,2,17,226,134,2,72
],[
2,2,2,2,2,2,2,2,2,2,2,2,2,2,2,116,106,202,213,97
],[
2,2,2,2,2,2,2,2,2,2,2,2,2,2,2,37,80,88,217,249
],[
99,179,72,111,243,107,43,228,126,81,35,67,204,97,71,20,220,234,191,182
],[
30,239,143,232,227,205,176,143,17,31,101,179,27,223,204,202,48,206,179,57
],[
179,21,174,24,236,44,102,53,253,251,52,92,23,63,239,214,237,48,2,48
]
]