aLevelData = [
[
5,5,3,5,5,5,5,5,5,5,3,5,5,192,158,51,149,0,59,136
],[
4,2,3,5,5,5,5,5,5,5,3,5,5,87,183,93,131,123,74,236
],[
2,2,3,2,3,3,3,3,3,2,3,3,3,66,56,96,254,82,122,139
],[
5,2,2,2,3,2,2,2,2,2,5,5,5,238,114,144,42,174,153,36
],[
2,2,2,3,2,2,2,2,2,2,5,5,5,142,94,58,113,91,29,198
],[
2,2,2,3,2,2,5,3,3,2,3,3,3,176,49,31,115,211,140,255
],[
2,2,2,2,2,2,5,5,3,2,2,2,2,60,118,233,87,40,19,43
],[
5,2,2,2,2,2,5,5,3,2,2,2,2,143,208,117,60,242,27,111
],[
2,2,5,5,3,2,5,5,3,2,3,3,3,247,7,77,205,70,30,64
],[
2,2,5,5,3,2,5,5,3,6,3,3,5,139,135,41,240,69,53,205
],[
2,2,3,3,3,2,5,5,3,5,5,3,5,62,239,196,185,237,198,204
],[
2,2,3,2,2,2,5,5,3,5,5,5,3,55,241,134,106,0,233,222
],[
2,2,3,2,2,2,5,5,3,5,5,5,3,228,85,234,33,139,75,126
],[
2,2,3,2,5,2,3,3,3,5,5,5,3,62,230,103,236,242,12,106
],[
2,2,2,2,5,2,3,5,5,5,5,5,5,186,60,82,110,113,18,38
],[
2,2,2,2,5,2,5,5,5,5,5,5,5,50,160,82,59,179,35,251
],[
2,2,3,3,3,2,3,3,5,5,5,5,3,231,252,165,157,201,62,100
],[
2,2,3,5,5,2,3,5,5,5,5,3,5,14,174,35,52,95,181,96
],[
2,3,3,5,5,2,3,5,3,5,5,5,5,199,14,178,138,43,125,209
],[
2,3,2,5,5,2,5,5,3,5,5,5,5,42,148,163,124,19,92,2
]
]