aLevelData = [
[
2,2,2,2,5,5,2,2,2,2,2,2,2,2,2,2,2,2,2,2
],[
90,133,14,68,98,61,188,252,55,4,210,188,50,164,129,65,41,103,124,195
],[
137,217,173,212,165,208,40,140,78,170,93,227,164,214,145,94,43,150,143,238
],[
34,2,154,21,16,81,167,74,159,84,201,159,173,67,237,161,161,188,199,127
],[
251,9,12,111,48,162,226,78,180,242,149,134,88,94,139,53,214,132,122,140
],[
170,192,216,117,36,245,147,120,188,138,3,223,165,178,29,24,165,241,233,92
],[
35,220,54,142,130,32,140,102,173,197,98,206,243,180,145,140,22,119,9,34
],[
158,65,194,242,115,46,246,166,171,203,142,207,161,217,218,204,71,78,132,238
],[
189,157,199,218,34,55,220,46,170,82,181,103,240,233,238,2,142,4,1,225
],[
236,57,185,241,85,115,233,10,80,242,93,22,45,147,17,118,222,82,161,161
],[
8,13,1,14,90,139,110,85,30,188,164,145,13,66,82,8,104,49,203,14
],[
68,19,254,38,38,48,168,107,207,12,200,46,89,48,84,225,131,45,42,51
],[
74,223,73,125,185,239,65,93,1,155,232,160,204,186,79,102,207,250,244,128
],[
158,109,57,29,197,68,21,166,20,218,10,230,58,244,87,110,150,71,110,56
],[
73,58,168,138,144,238,56,29,81,123,94,127,243,125,221,182,115,208,174,38
],[
180,151,246,181,23,131,54,44,76,82,193,224,104,149,116,147,55,183,161,149
],[
211,59,76,46,117,69,154,65,140,92,134,41,12,110,214,231,9,20,77,127
],[
132,24,35,159,133,53,178,130,106,29,114,20,126,193,39,87,205,204,89,5
],[
55,112,5,119,196,102,146,197,55,48,6,47,230,162,122,187,200,160,204,32
],[
208,41,147,227,121,149,88,192,163,26,3,75,157,149,147,215,131,135,18,151
]
]