aLevelData = [
[
12,2,2,2,2,2,2,199,220,226,52,128,133,171,206,20,225,137,149,219
],[
2,2,2,2,2,2,2,122,54,108,249,115,144,201,224,6,64,195,23,49
],[
2,2,3,3,3,3,3,153,109,57,171,194,99,64,29,24,162,3,143,206
],[
11,2,3,2,2,2,2,157,254,32,214,141,82,251,5,8,12,134,114,213
],[
2,2,3,2,2,2,2,170,221,31,255,220,126,219,40,135,70,102,32,15
],[
2,2,3,2,2,2,2,156,215,182,214,236,59,206,0,87,127,180,122,168
],[
10,2,3,2,2,2,2,144,176,58,138,192,219,200,249,108,48,253,247,219
],[
230,10,128,106,254,189,191,230,24,0,130,58,138,163,236,74,179,91,105,30
],[
141,10,231,67,130,64,68,110,129,2,2,99,80,203,66,21,36,209,240,15
],[
111,137,59,18,249,109,72,0,50,253,39,248,199,4,6,195,115,28,164,111
],[
24,116,9,57,14,209,117,177,186,211,150,24,99,122,253,13,66,232,211,105
],[
216,105,200,103,133,176,77,8,85,100,3,181,29,219,115,38,199,37,255,132
],[
234,76,24,202,158,218,178,113,142,156,245,76,78,166,54,177,239,151,37,217
],[
209,30,72,137,185,189,168,242,35,205,202,215,218,195,224,237,197,177,65,135
],[
4,16,23,114,60,188,87,30,46,64,247,255,143,84,91,51,19,164,16,101
],[
204,211,188,241,178,192,85,73,131,8,146,151,205,204,159,164,72,180,21,248
],[
106,51,41,67,54,13,36,251,85,23,19,71,103,62,191,28,155,203,223,165
],[
125,230,141,233,16,88,247,168,29,149,87,133,202,249,37,107,110,82,138,41
],[
164,159,25,95,159,23,186,158,189,109,230,203,94,83,26,196,246,61,133,70
],[
97,103,4,15,119,25,81,63,225,42,120,4,43,195,138,118,25,101,148,192
]
]