aLevelData = [
[
6,2,8,2,9,2,10,2,11,3,2,2,5,2,2,2,5,2,153,1
],[
2,2,2,2,2,2,2,2,12,3,5,2,2,2,5,2,2,2,62,219
],[
2,2,3,3,3,3,3,3,3,3,2,2,3,3,3,3,3,3,248,241
],[
2,2,3,2,2,2,2,2,2,2,5,2,3,2,2,2,2,3,137,234
],[
2,2,3,2,2,2,2,2,2,2,2,2,3,2,2,2,2,3,57,41
],[
2,2,3,2,3,3,3,3,3,3,2,5,3,2,2,2,2,2,51,52
],[
2,2,3,2,2,2,2,5,5,3,2,2,3,2,2,2,2,2,201,109
],[
2,2,3,5,5,5,2,3,3,3,5,2,3,3,3,2,2,3,196,172
],[
2,2,2,2,2,2,2,2,2,2,2,2,5,2,2,2,2,5,31,111
],[
2,3,2,2,3,1,3,2,2,2,2,2,5,2,2,2,2,5,245,185
],[
2,3,2,2,3,2,3,2,2,2,2,5,5,2,2,2,2,5,88,228
],[
2,3,2,3,2,2,2,3,2,2,2,2,5,2,2,2,2,5,114,231
],[
2,3,2,3,2,2,2,3,3,3,2,2,3,3,3,2,2,3,31,221
],[
2,3,2,3,2,2,2,3,2,2,5,2,5,2,2,2,2,5,222,221
],[
2,3,2,3,2,2,3,3,2,2,2,2,5,2,2,2,2,5,208,85
],[
23,143,221,6,188,180,112,130,237,123,82,126,82,121,11,113,95,230,75,94
],[
214,10,136,237,141,242,233,193,113,103,99,6,203,33,34,73,194,55,42,141
],[
33,218,62,155,91,67,0,153,205,234,91,222,66,249,30,5,188,0,233,64
],[
114,234,77,239,21,48,47,114,87,76,109,59,174,113,197,39,85,121,242,14
],[
149,31,23,153,66,110,97,83,136,121,232,3,232,77,215,58,125,36,205,40
]
]