aLevelData = [
[
2,2,2,2,2,2,2,2,2,2,2,2,2,2,2,248,217,77,151,248
],[
137,104,1,199,53,85,168,204,124,200,187,135,165,118,112,108,43,133,164,242
],[
121,65,194,231,242,16,229,6,52,168,65,203,158,127,191,134,16,131,231,175
],[
241,12,3,121,119,15,129,169,34,148,154,169,138,106,49,216,91,25,254,37
],[
158,24,235,220,58,64,190,191,186,129,249,89,80,212,254,143,26,112,119,120
],[
165,65,245,111,176,150,215,102,50,26,110,125,158,5,95,211,101,147,72,155
],[
188,182,166,115,161,7,246,242,24,3,26,128,187,116,255,107,113,45,125,55
],[
126,250,126,53,188,215,99,87,39,96,163,66,159,137,181,165,234,143,49,201
],[
249,47,50,106,108,21,254,198,88,151,233,243,71,163,118,117,128,246,192,16
],[
137,143,24,219,235,100,240,150,53,83,248,61,67,91,134,221,192,12,59,167
],[
234,60,228,67,149,252,158,103,115,203,62,167,146,9,239,143,38,174,29,239
],[
137,59,146,118,128,241,223,130,192,65,254,55,177,133,53,207,113,237,61,48
],[
28,188,164,196,75,180,112,133,218,206,5,87,239,47,73,155,55,88,5,1
],[
115,157,143,157,52,216,166,62,226,94,157,251,3,50,188,14,186,121,227,230
],[
142,46,112,119,109,23,99,213,241,248,192,1,226,6,53,2,251,158,253,56
],[
241,55,4,238,177,150,76,46,233,65,143,217,203,53,38,247,14,219,41,75
],[
53,57,216,42,19,101,57,142,143,64,3,103,165,96,187,49,173,78,29,203
],[
224,242,189,135,24,75,238,126,215,100,227,38,139,131,20,38,16,163,227,104
],[
119,36,128,112,6,194,10,237,127,196,247,142,166,117,181,23,253,216,145,180
],[
210,152,217,141,123,62,61,154,225,166,123,185,59,180,60,254,28,67,56,74
]
]