aLevelData = [
[
4,2,2,2,2,201,230,149,161,163,219,107,69,138,238,22,214,98,4,59
],[
5,2,5,3,2,116,155,93,101,145,178,15,168,0,251,179,133,79,157,94
],[
2,5,5,3,3,14,87,222,211,74,17,161,246,219,172,44,132,222,220,47
],[
3,3,5,5,5,2,19,116,2,243,62,55,47,78,205,235,48,47,186,176
],[
2,3,5,5,5,122,205,179,144,186,172,121,87,94,20,134,165,87,193,242
],[
3,3,5,5,5,65,29,220,151,176,244,42,116,7,111,132,79,253,50,135
],[
3,5,5,5,5,158,68,251,140,168,26,228,218,232,27,226,27,178,89,146
],[
13,25,174,53,122,15,81,248,106,206,168,122,151,119,93,136,33,249,180,43
],[
131,53,28,228,198,96,4,54,245,168,239,101,208,26,203,126,196,195,126,151
],[
27,21,195,88,113,141,52,186,103,147,167,15,155,162,190,67,215,168,186,97
],[
136,176,144,88,114,190,63,0,163,250,96,88,165,17,255,18,248,217,169,81
],[
191,52,198,177,186,54,42,136,116,138,230,107,190,17,100,244,91,205,179,195
],[
253,254,31,195,113,138,5,174,22,162,229,212,147,163,185,24,201,58,133,59
],[
7,204,48,93,125,21,146,192,244,15,206,208,188,21,226,96,229,72,124,55
],[
178,50,16,203,74,169,39,76,177,246,250,228,247,55,63,62,175,2,67,69
],[
163,75,57,46,198,136,209,184,106,18,13,178,179,207,81,190,76,14,185,86
],[
88,178,174,12,172,147,188,22,59,33,158,9,209,75,155,229,5,159,22,82
],[
105,178,96,41,3,194,208,54,1,154,22,61,168,182,204,58,142,168,78,237
],[
9,186,204,150,231,213,157,254,95,161,214,182,72,238,28,163,137,83,182,187
],[
209,20,230,9,136,73,122,247,5,61,158,204,1,21,244,116,75,178,231,128
]
]