aLevelData = [
[
5,139,180,94,93,25,171,216,23,181,185,72,54,71,116,255,155,188,106,96
],[
5,236,179,9,54,148,121,188,75,11,56,87,54,87,107,181,116,211,149,159
],[
5,186,47,51,240,138,184,239,247,5,217,22,29,0,226,76,200,89,9,127
],[
2,127,139,175,25,78,129,228,122,108,168,44,165,27,72,131,57,208,20,160
],[
2,164,148,0,119,147,170,82,1,172,114,252,63,128,141,41,125,187,66,22
],[
212,158,32,35,242,176,229,42,30,176,159,15,118,205,17,152,123,26,88,127
],[
208,60,207,198,63,101,47,75,253,135,251,156,47,193,27,12,172,30,198,7
],[
5,126,166,162,195,212,55,118,239,146,113,175,216,98,166,96,16,23,173,26
],[
184,227,64,188,253,202,163,140,227,86,134,135,66,141,45,246,13,32,206,66
],[
218,229,59,9,159,135,192,113,186,125,79,189,53,56,218,30,71,161,1,203
],[
30,194,237,83,219,195,124,50,223,25,158,163,69,250,255,182,175,20,230,162
],[
70,126,93,92,252,239,146,105,21,46,125,240,229,201,195,19,219,10,218,127
],[
190,39,110,66,55,185,4,222,144,111,222,155,187,4,30,33,150,110,46,69
],[
109,89,94,36,192,211,207,110,71,73,145,5,52,178,8,199,184,10,148,167
],[
200,2,112,3,33,246,219,50,138,31,118,92,89,10,238,142,56,72,218,13
],[
41,104,231,235,200,34,50,217,208,213,245,60,225,52,102,131,129,59,220,183
],[
96,105,52,83,224,41,115,87,212,145,172,152,136,78,37,90,3,223,181,32
],[
136,2,112,195,99,108,135,194,226,189,105,217,161,179,46,213,10,158,54,166
],[
29,20,13,182,109,229,146,121,107,81,89,70,231,121,77,101,212,20,154,105
],[
76,99,202,191,212,103,45,136,224,81,127,164,154,58,197,15,223,20,120,113
]
]