aLevelData = [
[
4,2,5,5,2,133,163,189,129,173,173,84,222,113,23,55,16,135,11,250
],[
2,2,2,2,2,45,69,215,192,149,19,147,84,192,33,4,118,58,85,193
],[
2,2,2,2,2,115,235,136,148,249,156,241,35,40,183,225,208,236,78,177
],[
3,3,3,3,3,221,139,95,249,212,122,87,3,38,117,212,128,18,206,175
],[
2,2,3,2,2,121,200,6,58,136,207,154,198,71,164,31,105,9,164,145
],[
13,2,3,2,2,254,200,43,233,108,95,254,237,44,249,230,76,5,202,158
],[
2,5,3,2,2,234,26,253,239,121,39,237,26,73,8,151,118,97,123,80
],[
2,12,3,2,2,90,206,38,179,61,59,220,222,28,194,28,222,29,2,218
],[
5,2,3,3,3,103,113,114,130,200,126,244,59,31,62,174,105,201,226,21
],[
11,2,3,2,2,117,29,188,74,208,90,91,170,53,221,248,161,47,152,17
],[
2,5,3,2,2,190,220,191,83,13,240,196,189,161,252,134,3,112,241,198
],[
2,10,3,2,2,48,100,224,218,144,174,3,165,205,94,1,198,88,48,110
],[
5,2,2,2,2,16,10,169,145,58,12,99,107,216,244,166,244,138,48,55
],[
2,2,2,2,2,168,116,168,117,66,238,159,161,200,124,218,126,199,0,5
],[
9,5,3,2,2,26,224,46,82,235,131,65,99,29,251,236,106,43,171,148
],[
2,2,3,2,2,143,173,151,188,146,113,38,193,177,204,38,199,204,50,16
],[
5,8,3,2,2,243,199,5,141,219,48,171,58,58,33,227,168,233,104,89
],[
168,10,230,120,197,134,53,127,17,187,142,215,37,110,233,164,99,7,101,154
],[
126,253,235,17,61,143,14,92,123,181,54,87,115,86,254,64,58,187,218,200
],[
141,68,253,105,205,89,122,249,72,164,169,128,186,125,204,71,20,166,242,49
]
]