aLevelData = [
[
2,2,2,2,2,11,2,214,51,97,247,0,245,150,38,81,174,173,94,114
],[
47,191,163,105,54,38,62,109,239,235,95,248,186,126,7,31,47,170,37,31
],[
95,199,0,56,93,50,212,190,254,250,192,109,220,220,223,253,161,114,182,246
],[
130,167,206,198,9,110,161,16,24,180,187,72,43,146,25,125,221,200,213,117
],[
174,103,5,255,3,205,224,133,110,214,34,225,48,81,178,113,252,177,130,110
],[
254,5,183,121,28,43,11,119,124,64,111,159,70,90,244,209,171,122,235,42
],[
38,188,75,213,1,209,84,36,28,175,114,223,234,135,100,220,188,248,157,207
],[
66,130,235,100,78,61,86,139,220,203,75,19,80,139,250,123,254,15,252,5
],[
239,209,57,11,226,33,9,150,146,98,153,45,55,118,145,235,79,119,243,213
],[
158,168,70,106,116,171,245,123,46,244,242,60,255,125,158,156,241,187,237,210
],[
38,210,197,56,100,5,168,93,209,112,147,85,250,249,38,84,26,132,4,124
],[
154,102,125,242,212,28,107,55,28,62,89,182,1,174,235,153,208,21,122,225
],[
90,144,254,182,247,166,49,251,203,126,241,38,72,78,230,79,244,23,102,134
],[
109,144,149,106,170,95,209,248,131,143,77,160,116,63,251,158,158,151,176,135
],[
14,1,131,34,66,149,118,122,233,212,88,49,235,154,233,23,169,78,64,251
],[
134,92,106,194,166,229,84,182,246,181,234,32,108,117,129,24,144,33,114,156
],[
59,189,8,224,158,68,157,229,135,226,255,77,224,98,25,110,120,234,207,165
],[
7,230,41,236,108,66,180,175,56,220,37,220,112,57,64,58,143,119,248,251
],[
203,130,216,148,153,139,161,204,115,182,53,19,217,19,179,22,150,208,228,144
],[
68,173,214,99,18,175,198,231,197,25,67,130,253,152,145,121,186,190,76,5
]
]