aLevelData = [
[
10,2,2,8,2,2,2,2,131,184,74,109,45,103,124,98,239,126,96,123
],[
2,2,2,2,2,2,2,2,154,218,115,13,191,26,229,93,31,74,168,99
],[
2,2,2,2,2,2,3,3,99,191,199,205,13,65,249,71,175,112,118,250
],[
9,2,2,2,2,2,2,2,90,96,9,82,90,135,102,5,32,217,191,81
],[
3,3,3,3,3,3,3,2,128,49,146,133,29,243,197,194,33,239,244,3
],[
2,2,2,2,2,2,2,2,49,137,10,91,160,23,14,126,226,139,64,131
],[
2,2,2,2,2,2,2,2,68,82,101,232,219,124,95,215,186,28,0,167
],[
2,2,2,2,2,2,2,2,104,242,32,166,146,71,237,22,252,25,131,117
],[
189,120,189,2,172,48,74,124,22,168,3,45,178,10,123,39,214,164,216,206
],[
234,143,226,150,30,142,90,14,88,56,141,30,112,90,41,140,160,151,78,197
],[
54,81,232,219,140,205,61,202,58,145,194,255,138,17,51,27,45,139,226,244
],[
44,48,80,220,33,132,250,39,166,7,117,231,14,21,189,250,83,11,203,71
],[
80,171,101,68,48,194,58,188,39,7,46,207,96,71,243,58,54,191,217,216
],[
166,202,231,105,4,188,42,147,238,13,77,38,127,186,106,164,196,232,32,1
],[
116,202,230,167,219,198,158,189,24,211,110,169,136,38,203,211,130,13,214,172
],[
69,27,236,240,46,133,120,40,47,204,12,114,124,156,177,132,135,245,123,239
],[
47,136,96,161,52,100,73,174,239,209,106,80,64,124,207,44,199,213,56,214
],[
87,182,39,152,167,69,55,111,75,27,175,87,227,166,87,200,147,203,139,129
],[
179,208,141,132,199,122,32,98,177,114,82,184,37,237,153,250,94,140,33,111
],[
15,129,101,125,157,244,253,39,139,165,182,212,54,210,232,82,194,91,4,26
]
]