aLevelData = [
[
4,2,2,2,2,187,25,43,98,165,150,71,157,143,77,7,233,66,176,169
],[
2,2,3,2,9,226,249,224,90,79,115,112,239,2,71,108,213,0,120,153
],[
2,3,2,2,2,75,226,73,255,206,123,82,165,213,187,212,156,191,211,74
],[
2,3,2,2,2,62,10,154,64,184,197,48,104,198,72,225,235,190,34,76
],[
2,3,2,2,3,253,208,83,196,180,140,188,246,26,164,211,204,129,244,155
],[
2,3,2,3,2,146,22,191,212,88,185,60,110,151,12,81,68,23,202,158
],[
2,2,3,2,2,7,15,91,189,120,143,165,200,219,27,36,28,168,152,61
],[
93,131,109,207,187,110,226,12,115,62,203,135,152,75,107,141,19,108,147,185
],[
233,35,10,195,188,20,49,153,149,188,231,177,224,95,171,157,184,66,0,224
],[
101,27,22,0,35,198,166,220,37,57,30,64,218,186,254,183,111,80,130,160
],[
149,119,129,132,132,23,149,167,64,183,124,221,27,238,190,159,123,27,144,94
],[
221,86,249,23,26,167,51,40,233,117,84,98,166,65,46,95,82,148,115,22
],[
218,53,29,172,156,160,12,142,39,180,241,188,66,172,108,104,49,80,113,191
],[
51,108,240,7,79,130,181,234,80,188,141,17,15,36,170,245,240,23,72,242
],[
175,247,145,158,93,33,190,88,165,31,128,36,84,30,158,182,25,162,223,204
],[
136,120,42,193,101,237,236,95,32,61,186,246,156,78,56,170,52,158,57,17
],[
0,122,39,254,84,114,166,151,138,9,116,174,2,177,147,78,102,246,171,147
],[
51,249,170,191,117,32,173,139,210,12,35,187,201,203,47,245,60,79,79,211
],[
44,31,60,55,197,77,17,223,154,168,174,57,49,50,95,120,194,213,185,231
],[
60,81,197,125,137,121,97,178,19,159,226,146,135,77,254,16,217,54,234,156
]
]