aLevelData = [
[
6,2,2,2,2,2,2,2,2,2,155,61,70,14,252,149,14,135,99,39
],[
2,2,2,2,2,2,2,2,2,2,65,113,87,111,61,70,189,207,166,170
],[
2,2,2,2,2,2,2,2,2,2,249,42,171,157,86,174,139,244,168,241
],[
3,3,3,3,3,3,3,3,3,3,88,10,48,64,252,179,191,52,121,113
],[
2,2,2,2,2,2,2,2,2,2,30,133,117,235,174,35,245,154,76,131
],[
2,2,2,2,2,2,2,2,2,2,105,198,119,55,233,177,181,194,190,18
],[
2,2,2,2,2,3,2,2,3,2,50,170,36,196,171,207,78,192,138,250
],[
2,2,3,3,3,3,3,3,3,3,171,73,83,185,104,102,62,107,54,149
],[
2,2,2,2,2,2,2,2,2,2,38,151,77,190,161,130,176,102,113,0
],[
2,2,2,2,2,2,2,2,2,4,179,37,27,138,187,90,213,145,70,29
],[
3,3,3,3,3,3,3,3,3,3,165,18,43,117,200,107,34,203,81,109
],[
2,2,2,2,2,2,2,2,2,2,134,159,18,178,90,122,191,48,139,36
],[
81,15,116,22,169,184,167,50,118,47,235,178,88,162,129,95,70,66,172,3
],[
45,81,112,32,217,124,153,226,25,108,255,83,30,152,9,206,37,93,112,182
],[
86,80,69,103,235,211,54,109,148,230,13,245,26,64,121,128,67,159,17,223
],[
247,92,150,91,160,66,120,52,215,160,156,77,60,157,93,37,165,204,209,9
],[
124,0,77,136,98,98,43,40,24,192,202,87,160,40,215,164,159,182,203,47
],[
6,170,181,94,241,189,58,210,208,182,218,154,196,56,117,166,76,222,13,126
],[
32,138,205,52,93,249,74,150,227,155,10,169,251,162,67,83,62,89,228,88
],[
178,184,217,136,53,53,139,54,31,220,167,235,35,162,33,92,118,247,120,154
]
]