aLevelData = [
[
2,2,147,36,34,202,222,169,158,113,215,50,232,33,88,65,74,145,135,113
],[
2,2,193,85,253,9,73,13,40,209,90,221,237,37,179,29,146,71,86,81
],[
2,2,220,250,212,91,116,76,202,239,143,179,172,72,206,91,193,25,99,191
],[
2,2,111,199,118,119,185,213,199,80,6,160,148,162,36,76,189,222,140,254
],[
2,2,38,103,232,75,93,163,210,241,125,81,223,197,82,29,220,237,189,113
],[
2,2,87,79,90,143,98,73,97,221,147,163,202,127,79,194,181,43,72,30
],[
2,2,8,57,69,246,90,250,34,66,16,75,23,233,197,106,61,52,240,8
],[
2,2,77,130,192,159,171,62,75,5,164,15,232,66,244,78,217,159,140,189
],[
46,255,146,118,229,114,168,33,86,8,113,106,207,227,81,179,123,144,117,5
],[
136,152,20,77,136,81,244,197,24,250,47,176,192,7,55,74,27,186,24,255
],[
56,243,253,219,63,73,246,66,88,89,248,225,200,94,38,228,93,3,78,105
],[
13,117,183,53,218,187,26,166,249,74,238,233,50,212,232,109,138,98,195,152
],[
32,162,61,184,85,130,98,60,47,253,12,36,0,53,171,182,66,195,66,115
],[
198,75,178,73,14,83,59,10,247,85,64,29,154,18,74,116,117,42,80,189
],[
198,234,54,221,56,101,147,154,193,198,183,151,203,228,237,134,146,23,253,153
],[
205,75,245,57,144,82,41,251,113,127,121,208,234,112,210,124,254,43,248,73
],[
31,109,130,252,80,62,38,8,135,201,54,2,85,107,107,85,200,10,226,55
],[
145,168,100,219,98,55,234,232,154,175,96,43,36,95,170,136,156,128,229,55
],[
180,16,239,45,215,222,41,215,12,225,123,14,28,205,153,72,247,232,133,11
],[
84,26,86,168,152,68,55,37,249,211,178,123,227,149,47,2,154,203,183,41
]
]