aLevelData = [
[
2,2,3,3,3,3,3,3,3,3,3,221,220,21,250,15,52,137,105,155
],[
2,2,2,2,2,2,2,2,2,2,2,64,146,9,208,166,142,202,168,10
],[
3,2,3,3,3,3,3,3,3,3,3,227,144,75,129,157,66,213,72,89
],[
2,2,2,2,2,2,2,2,2,2,2,29,89,182,97,79,38,111,24,193
],[
3,2,3,3,3,3,3,3,3,3,3,73,219,153,52,83,214,155,143,92
],[
2,2,3,2,2,2,2,2,2,2,2,169,152,119,71,57,46,33,72,127
],[
3,2,3,2,2,3,3,3,3,3,3,197,100,164,56,114,19,184,222,27
],[
2,2,3,2,2,3,2,2,2,2,2,137,61,214,220,133,202,235,170,57
],[
2,3,3,2,2,3,3,3,3,2,2,154,251,54,157,144,240,20,9,120
],[
242,29,3,144,220,18,86,71,236,130,100,68,190,237,188,170,123,41,239,155
],[
78,5,160,251,23,45,219,118,100,77,168,196,157,121,223,43,126,205,61,70
],[
202,80,184,6,62,30,16,246,196,199,167,195,234,242,146,251,146,70,240,21
],[
235,138,122,178,160,10,92,34,79,61,68,42,60,166,184,4,71,248,172,168
],[
27,125,84,74,169,184,55,36,213,74,133,117,110,18,170,202,100,152,35,124
],[
53,172,144,122,169,74,11,72,191,193,185,72,231,20,158,57,113,161,182,253
],[
70,0,65,159,214,46,94,148,81,235,219,65,26,96,76,190,121,5,90,218
],[
144,194,94,95,144,85,47,151,44,243,55,14,78,50,205,154,9,38,191,153
],[
208,202,45,122,229,162,158,127,19,159,77,192,160,67,196,116,126,5,172,108
],[
193,247,228,224,86,166,208,110,241,66,244,96,71,255,193,46,126,186,174,67
],[
225,224,139,4,217,140,18,15,24,239,192,192,24,245,227,250,196,37,243,36
]
]