aLevelData = [
[
5,5,3,5,5,5,5,5,5,5,3,5,5,5,5,5,5,74,154,210
],[
4,2,3,5,5,5,5,5,5,5,3,5,5,5,5,5,5,227,247,152
],[
2,2,3,2,3,3,3,3,3,2,3,3,3,3,3,5,5,13,214,110
],[
5,2,2,2,3,2,2,2,2,2,5,5,5,5,5,5,5,122,203,173
],[
2,2,2,3,2,2,2,2,2,2,5,5,5,5,5,5,5,245,4,18
],[
2,2,2,3,2,2,5,3,3,2,3,3,3,3,3,5,5,104,90,88
],[
2,2,2,2,2,2,5,5,3,2,2,2,2,2,2,2,2,204,86,124
],[
5,2,2,2,2,2,5,5,3,2,2,2,2,2,2,2,2,107,108,45
],[
2,2,5,5,3,2,5,5,3,2,3,3,3,5,5,3,5,12,182,212
],[
2,2,5,5,3,2,5,5,3,6,3,3,5,5,5,3,5,90,149,46
],[
2,2,3,3,3,2,5,5,3,5,5,3,5,5,5,3,5,118,150,186
],[
2,2,3,2,2,2,5,5,3,5,5,5,3,5,5,3,5,117,186,186
],[
2,2,3,2,2,2,5,5,3,5,5,5,3,3,5,3,5,192,82,160
],[
2,2,3,2,5,2,3,3,3,5,5,5,3,3,5,3,5,212,76,95
],[
167,122,109,1,237,94,220,157,151,35,131,9,115,111,61,65,220,66,221,92
],[
223,134,113,190,156,231,200,142,238,228,49,107,78,38,134,90,244,17,105,3
],[
64,154,206,30,89,88,186,40,20,221,73,90,23,70,246,219,62,17,23,53
],[
61,47,167,6,135,90,72,248,111,169,136,242,141,98,100,144,100,15,11,209
],[
65,212,228,16,102,255,209,54,104,225,182,45,214,221,53,152,27,190,188,193
],[
166,77,194,210,72,36,77,73,221,189,184,166,46,206,179,102,22,217,139,53
]
]