aLevelData = [
[
2,2,2,5,2,2,2,5,2,2,2,5,2,244,139,116,221,165,244,2
],[
2,2,2,2,2,5,2,2,2,5,2,2,2,25,128,244,140,30,202,78
],[
2,2,3,3,3,3,3,3,3,3,3,3,3,25,229,102,230,75,156,155
],[
2,3,2,2,2,2,2,2,2,2,2,2,2,121,63,249,23,140,181,207
],[
2,3,2,2,2,2,2,2,2,2,8,2,2,51,162,113,223,120,178,225
],[
2,2,2,2,2,5,5,5,5,2,2,2,2,240,98,216,255,34,101,75
],[
2,2,3,3,3,3,2,3,2,3,2,2,2,121,127,46,143,15,211,43
],[
2,2,3,2,2,3,2,3,2,3,3,2,2,236,61,189,77,30,27,7
],[
2,2,3,2,2,3,2,3,2,3,2,3,2,13,78,129,51,173,65,110
],[
4,2,3,2,2,3,2,3,2,3,2,3,2,86,192,208,171,42,236,152
],[
2,2,3,3,3,2,2,3,2,3,2,3,2,171,94,239,242,182,48,224
],[
2,2,3,2,3,2,2,3,2,3,2,2,3,38,71,62,183,219,178,153
],[
2,2,3,2,3,2,2,3,2,3,2,2,3,16,210,9,28,44,212,65
],[
2,2,3,2,2,3,2,3,2,3,2,2,2,252,57,233,145,159,211,203
],[
2,2,3,2,2,3,2,3,2,3,2,2,2,27,178,202,154,206,118,38
],[
209,139,90,104,121,134,207,19,157,240,88,107,253,211,224,125,6,61,81,95
],[
2,160,98,185,141,121,177,132,72,48,17,18,209,63,37,79,242,151,46,70
],[
24,63,33,231,7,63,253,7,205,188,91,168,244,100,70,123,252,13,78,163
],[
9,152,216,188,216,28,184,28,247,65,2,88,54,233,28,10,89,22,24,210
],[
15,8,65,155,40,165,244,32,2,30,178,174,68,208,114,43,207,104,60,87
]
]