aLevelData = [
[
2,2,2,2,2,2,2,2,2,2,2,2,2,2,2,2,2,2,2,4
],[
207,53,68,127,11,100,80,215,208,238,106,161,103,133,203,67,113,216,190,237
],[
44,191,2,112,242,185,112,84,2,153,221,36,131,124,66,13,198,254,27,168
],[
204,174,12,19,8,191,202,70,101,0,57,164,139,14,210,209,94,199,72,196
],[
200,3,107,29,185,127,76,184,108,26,162,130,235,68,108,139,213,179,216,93
],[
95,87,100,141,153,145,67,143,243,160,2,206,255,92,107,252,120,38,170,167
],[
132,31,174,14,54,152,210,50,87,202,189,48,102,199,134,205,221,177,28,83
],[
182,42,230,156,46,11,166,108,201,89,163,4,150,117,7,243,180,146,134,48
],[
21,108,64,102,130,56,233,143,223,214,39,196,177,78,59,83,221,122,228,19
],[
178,0,128,244,42,132,117,218,109,27,207,172,151,2,43,167,187,144,211,249
],[
40,105,42,139,235,245,75,30,149,16,237,153,62,3,138,161,201,179,192,107
],[
106,25,247,206,102,242,68,157,26,184,141,51,63,208,238,79,108,5,92,35
],[
220,53,136,167,114,74,6,51,250,108,175,77,178,118,68,192,9,166,84,238
],[
166,152,95,102,172,117,59,185,61,104,183,138,61,81,127,229,88,190,63,210
],[
70,23,11,41,77,24,255,167,8,132,34,66,104,24,144,186,248,190,217,113
],[
101,4,164,124,61,204,152,250,247,69,124,164,52,26,156,166,68,233,111,174
],[
236,246,120,66,102,33,106,86,170,21,143,30,236,195,106,33,102,15,156,143
],[
87,200,4,212,76,222,42,109,158,207,222,250,60,99,28,149,170,153,51,99
],[
74,225,38,104,219,139,83,160,63,128,82,75,129,48,32,136,22,203,125,37
],[
99,180,146,182,128,51,215,228,60,106,52,8,97,138,103,249,57,70,165,33
]
]