aLevelData = [
[
5,5,5,5,5,2,2,2,2,2,2,2,2,2,201,11,85,250,116,251
],[
5,2,2,2,2,2,2,2,2,2,2,2,2,2,241,26,116,23,135,226
],[
5,2,5,3,3,3,3,3,3,3,2,2,3,3,188,156,40,173,143,202
],[
2,2,5,2,3,2,2,2,2,2,2,2,3,2,231,212,45,245,152,106
],[
2,2,3,2,3,2,2,2,2,2,2,2,3,2,177,217,216,41,58,46
],[
2,2,3,2,3,3,3,3,3,3,2,2,3,5,78,171,73,124,48,222
],[
4,2,3,2,2,2,2,2,2,3,2,2,3,2,106,49,8,178,23,241
],[
2,2,3,2,2,3,3,3,3,3,2,2,3,3,184,20,217,45,187,32
],[
2,2,2,2,2,3,2,2,2,2,2,2,2,2,176,247,175,146,181,20
],[
2,3,2,2,2,3,2,2,2,3,2,2,3,3,16,126,254,83,71,66
],[
2,3,2,2,2,3,2,2,2,3,2,2,3,5,194,30,227,184,189,79
],[
38,176,214,69,195,157,0,54,230,142,94,198,117,96,170,217,149,50,215,166
],[
113,26,245,14,55,22,86,43,98,70,239,43,63,88,0,95,170,67,248,143
],[
25,56,147,145,221,213,69,25,164,157,219,211,65,165,96,175,176,143,61,125
],[
84,188,165,185,132,190,48,168,70,12,198,164,90,250,191,179,123,232,72,95
],[
225,185,9,194,10,135,5,225,186,148,193,59,65,132,168,161,252,202,174,71
],[
30,97,52,28,176,188,43,87,215,255,125,82,86,111,168,156,83,39,172,74
],[
94,14,40,141,175,5,192,138,175,101,193,101,187,168,8,159,36,102,32,163
],[
122,132,170,155,10,168,2,136,165,239,31,146,163,227,187,156,40,167,180,28
],[
166,117,179,42,163,75,11,215,189,224,228,191,235,221,152,226,5,74,93,175
]
]