aLevelData = [
[
4,2,184,21,32,140,207,226,197,186,48,57,146,32,218,239,149,227,102,6
],[
5,2,91,177,224,47,97,95,213,141,203,209,173,188,88,27,59,18,150,229
],[
2,5,147,36,82,20,28,140,83,167,230,234,72,222,61,41,254,162,126,4
],[
3,3,214,33,41,200,119,185,56,91,192,23,175,125,0,160,117,78,106,15
],[
2,3,98,16,195,96,153,47,94,238,24,126,74,216,141,196,202,168,107,119
],[
3,3,5,55,62,199,255,203,60,223,200,131,28,103,244,245,43,77,74,21
],[
3,5,156,197,193,89,31,142,168,26,182,119,36,62,196,35,223,20,103,9
],[
3,5,255,127,8,190,85,87,49,119,215,12,158,202,81,140,150,180,87,103
],[
3,5,124,224,126,49,161,38,204,41,92,83,108,23,93,40,166,123,62,165
],[
3,5,15,227,91,135,253,157,228,15,62,142,48,5,10,98,84,253,53,230
],[
3,5,245,217,169,177,90,143,20,10,197,44,222,6,4,25,94,241,67,157
],[
5,5,77,239,36,164,123,227,18,191,192,144,210,107,54,255,90,150,165,32
],[
5,5,231,95,63,179,74,30,142,105,130,164,170,71,144,196,175,76,135,18
],[
5,3,110,83,227,234,99,59,27,180,232,68,122,103,167,188,42,76,85,220
],[
5,3,146,5,158,237,226,205,91,174,235,1,11,250,53,224,129,166,75,143
],[
218,169,90,95,178,127,250,83,152,207,76,221,190,75,69,233,245,215,73,28
],[
217,238,252,94,73,66,85,150,27,163,244,180,13,34,181,245,254,118,133,98
],[
94,159,116,155,227,201,12,210,125,114,225,26,141,207,106,226,82,108,15,188
],[
163,20,131,100,228,240,84,253,51,242,193,157,226,117,203,12,42,29,143,201
],[
29,5,210,78,221,25,222,149,12,192,141,219,131,191,163,164,71,90,96,255
]
]