aLevelData = [
[
6,87,64,88,69,209,100,119,134,117,134,39,122,206,22,229,55,240,232,4
],[
2,86,92,138,174,236,36,213,38,188,80,194,79,170,127,127,114,115,210,194
],[
2,60,156,5,94,6,168,223,20,90,142,205,171,178,106,202,66,130,115,129
],[
3,230,121,45,182,96,4,224,226,80,21,72,29,128,34,142,65,114,112,119
],[
2,77,59,145,220,7,148,44,90,230,47,252,74,46,71,27,243,93,123,129
],[
2,255,198,220,199,44,124,69,49,68,113,235,236,79,223,52,148,7,231,205
],[
2,250,140,121,247,35,89,115,33,148,119,13,188,204,240,116,75,19,135,181
],[
2,185,114,166,221,240,3,152,94,167,107,248,181,123,164,106,74,66,0,137
],[
2,152,156,106,32,141,202,239,156,52,196,126,193,145,133,236,157,205,170,59
],[
2,186,147,59,28,152,185,201,178,90,35,185,153,192,228,223,39,85,167,79
],[
3,242,234,78,111,146,66,216,81,168,15,136,64,31,29,67,153,177,206,59
],[
2,221,173,198,202,3,248,231,160,19,82,128,33,240,219,193,9,117,214,115
],[
82,196,172,230,87,219,52,42,57,105,49,129,130,223,29,21,8,201,37,231
],[
21,95,116,8,196,87,180,11,174,254,210,186,198,135,2,8,130,163,4,71
],[
60,82,165,155,215,248,136,175,165,179,38,166,136,236,20,85,88,44,133,175
],[
133,49,15,128,254,66,178,95,81,191,22,221,19,252,20,3,130,79,120,252
],[
105,104,5,14,68,225,186,207,165,22,84,149,214,55,20,46,192,156,194,209
],[
11,88,242,85,135,16,134,161,203,14,116,100,28,145,202,6,144,103,239,222
],[
114,190,43,165,233,56,105,42,213,61,60,72,250,149,33,21,96,54,4,93
],[
249,90,5,79,133,213,123,117,179,166,57,234,137,204,17,199,5,91,151,222
]
]