aLevelData = [
[
5,5,3,5,5,5,5,5,139,160,225,212,74,165,76,102,94,82,206,126
],[
4,2,3,5,5,5,5,5,117,42,52,200,98,66,137,52,33,60,54,146
],[
2,2,3,2,3,3,3,3,21,121,110,94,149,139,201,221,167,233,47,105
],[
5,2,2,2,3,2,2,2,11,231,248,8,124,229,81,68,50,198,226,55
],[
2,2,2,3,2,2,2,2,171,164,174,230,171,193,58,208,130,193,241,198
],[
2,2,2,3,2,2,5,3,141,23,199,252,255,190,29,97,225,41,228,44
],[
2,2,2,2,2,2,5,5,88,124,6,183,39,252,1,145,116,196,213,207
],[
5,2,2,2,2,2,5,5,207,187,33,162,112,194,137,47,192,50,90,154
],[
2,2,5,5,3,2,5,5,28,133,113,100,213,83,89,248,123,129,179,128
],[
2,2,5,5,3,2,5,5,91,181,219,253,70,12,200,151,148,16,52,49
],[
2,2,3,3,3,2,5,5,105,228,253,65,55,194,204,223,132,168,244,28
],[
2,2,3,2,2,2,5,5,238,77,157,148,108,90,33,71,214,215,182,164
],[
2,2,3,2,2,2,5,5,168,227,78,231,3,169,187,165,244,143,23,165
],[
2,2,3,2,5,2,3,3,249,176,99,242,193,141,110,46,52,255,248,41
],[
179,113,24,179,161,75,219,174,34,177,46,103,34,110,254,38,154,43,157,3
],[
14,229,104,252,91,158,167,69,175,82,180,223,217,44,96,108,195,250,146,66
],[
60,223,49,190,251,71,68,218,225,32,88,2,127,72,34,36,216,65,102,7
],[
104,44,24,221,101,245,192,27,68,203,35,136,127,211,31,148,150,29,215,236
],[
84,215,16,75,83,192,219,147,194,224,117,28,102,119,107,76,223,51,1,104
],[
45,165,213,169,114,246,192,147,249,214,253,130,120,182,141,134,146,55,217,112
]
]