aLevelData = [
[
2,2,2,2,2,191,93,146,52,65,48,80,152,117,173,204,140,163,79,164
],[
2,2,2,2,2,5,114,108,234,160,163,22,118,158,255,64,128,44,142,33
],[
2,2,2,2,2,110,232,10,222,234,162,147,99,56,95,164,145,198,164,70
],[
2,2,2,13,2,159,5,241,132,186,120,139,30,239,11,126,130,75,165,227
],[
2,2,2,2,2,247,65,0,95,28,75,185,236,145,212,163,220,244,86,97
],[
2,2,2,2,2,27,15,192,52,180,79,26,17,150,120,107,247,153,152,219
],[
2,2,2,2,2,127,188,58,21,181,176,219,239,38,155,162,77,58,22,75
],[
2,2,2,2,2,66,196,119,101,121,216,86,189,212,221,74,26,82,226,244
],[
2,2,11,2,2,42,54,54,63,189,102,50,229,49,17,90,54,45,148,165
],[
2,2,2,2,2,21,147,159,24,67,175,147,153,224,181,47,3,46,106,108
],[
2,2,2,2,2,118,153,33,165,241,244,233,251,34,6,5,248,124,69,156
],[
115,139,225,178,179,132,4,87,215,33,89,30,116,171,203,209,129,88,143,99
],[
112,216,100,38,158,43,25,62,237,181,80,86,175,148,131,146,199,49,68,196
],[
10,21,201,226,236,255,167,184,88,51,222,218,223,20,22,221,21,245,40,198
],[
56,45,224,195,19,105,2,25,34,71,138,94,247,32,56,232,220,36,76,133
],[
186,173,143,108,58,205,146,116,41,41,58,132,33,11,124,75,102,178,102,49
],[
14,237,95,141,101,232,175,24,143,69,66,162,111,110,168,3,200,42,97,85
],[
162,111,88,96,240,120,173,86,111,22,183,193,209,75,74,185,27,21,53,90
],[
76,136,15,117,63,31,52,134,210,84,10,230,72,110,137,66,236,155,250,76
],[
247,62,254,176,180,138,211,74,226,80,211,150,90,21,61,104,242,104,56,221
]
]