aLevelData = [
[
2,2,3,3,3,3,3,3,3,3,3,3,254,81,97,136,184,42,253,125
],[
2,2,2,2,2,2,2,2,2,2,2,2,199,121,231,125,201,170,230,8
],[
3,2,3,3,3,3,3,3,3,3,3,2,208,225,159,253,203,156,172,97
],[
2,2,2,2,2,2,2,2,2,2,2,2,66,148,239,92,71,228,38,132
],[
3,2,3,3,3,3,3,3,3,3,3,3,169,108,191,95,106,120,237,34
],[
2,2,3,2,2,2,2,2,2,2,2,2,115,157,251,191,135,228,225,31
],[
3,2,3,2,2,3,3,3,3,3,3,3,118,43,21,172,147,199,163,19
],[
2,2,3,2,2,3,2,2,2,2,2,3,103,110,128,72,167,85,27,202
],[
2,3,3,2,2,3,3,3,3,2,2,2,100,149,54,40,130,211,244,196
],[
2,2,2,2,2,2,2,2,2,3,2,3,107,32,51,215,4,30,27,181
],[
3,3,3,3,2,2,2,2,2,3,2,3,225,100,247,83,181,36,68,6
],[
8,2,6,3,2,3,3,3,3,3,2,3,12,11,8,141,60,105,102,82
],[
2,2,2,3,2,3,2,2,2,3,2,3,152,146,110,237,232,132,58,234
],[
22,202,54,204,42,160,191,81,120,87,240,248,24,251,184,193,151,52,48,52
],[
236,106,44,164,174,44,17,181,132,211,230,28,220,98,173,166,224,177,243,124
],[
165,203,166,165,166,148,39,204,114,175,160,68,161,158,152,73,12,43,196,137
],[
62,7,32,227,37,178,63,110,13,154,223,189,208,135,193,97,70,54,184,176
],[
3,68,255,197,66,79,207,200,28,87,49,112,254,106,18,197,89,128,149,43
],[
155,164,173,156,95,84,234,53,224,43,147,244,180,189,246,192,183,195,252,169
],[
69,120,0,114,172,66,225,76,224,149,86,229,113,20,130,161,187,250,201,39
]
]