aLevelData = [
[
4,2,2,2,2,2,2,2,2,2,2,2,2,2,2,199,107,69,155,92
],[
5,2,5,3,2,2,2,2,2,2,2,2,2,2,2,123,229,129,149,85
],[
2,5,5,3,3,3,3,3,3,3,3,3,3,3,3,11,51,78,242,26
],[
3,3,5,5,5,5,5,5,5,5,3,2,2,2,2,152,173,117,248,14
],[
2,3,5,5,5,5,5,5,5,5,3,6,2,2,2,96,96,110,69,37
],[
3,3,5,5,5,5,3,3,3,3,3,3,3,3,3,6,210,84,144,68
],[
3,5,5,5,5,5,3,2,2,2,2,2,2,2,2,227,6,9,108,244
],[
3,5,5,3,3,3,3,8,2,2,2,5,5,5,5,117,20,130,77,219
],[
3,5,5,3,2,2,3,3,3,3,2,5,3,3,3,213,171,206,164,211
],[
3,5,5,3,2,2,2,2,2,3,2,5,3,5,5,226,213,200,252,237
],[
3,5,5,3,2,2,3,2,2,3,2,5,3,5,5,98,87,233,143,121
],[
5,5,5,3,2,2,3,2,2,3,2,5,3,5,5,86,100,0,200,201
],[
5,5,5,3,2,2,3,2,2,3,2,5,3,3,3,39,154,138,17,231
],[
5,3,3,3,2,2,3,2,2,3,2,5,2,2,3,213,171,120,145,117
],[
5,3,2,2,2,2,3,2,2,3,2,5,2,2,2,45,11,212,2,202
],[
5,3,3,2,2,2,3,2,5,5,5,5,2,2,2,168,223,121,219,87
],[
5,5,3,3,2,2,3,2,5,3,5,5,3,3,3,108,65,120,221,253
],[
5,5,5,5,3,3,3,2,5,3,5,5,2,2,2,96,225,143,101,239
],[
28,101,139,203,224,79,107,142,178,204,93,190,78,184,154,68,72,101,252,31
],[
243,238,5,89,130,200,35,58,109,154,50,189,23,79,67,64,173,105,156,127
]
]