aLevelData = [
[
2,2,2,2,2,2,2,2,2,80,43,196,104,98,54,39,249,194,29,152
],[
2,2,2,2,2,2,2,2,2,114,54,97,39,240,120,165,124,205,138,179
],[
2,2,2,2,2,2,2,2,2,201,197,74,192,253,87,70,241,59,110,209
],[
2,2,2,13,2,2,2,2,2,30,138,65,87,213,206,120,237,162,247,144
],[
2,2,2,2,2,2,2,2,2,44,141,120,128,64,229,250,157,60,60,82
],[
2,2,2,2,2,2,2,2,2,187,176,179,177,149,126,120,27,111,233,140
],[
2,2,2,2,2,2,2,2,2,27,249,239,202,180,119,217,37,154,31,16
],[
2,2,2,2,2,2,2,2,2,49,163,194,50,229,120,175,101,159,144,213
],[
2,2,11,2,2,2,2,2,2,236,104,95,39,248,121,202,69,192,255,223
],[
2,2,2,2,2,2,2,2,2,88,211,28,195,61,173,46,235,231,137,83
],[
2,2,2,2,2,2,2,2,2,143,254,119,45,92,204,174,226,106,90,35
],[
2,2,2,2,2,2,2,2,2,103,109,214,91,255,47,56,125,254,62,38
],[
2,2,2,2,2,2,2,2,2,171,211,225,20,146,69,81,175,64,253,38
],[
2,2,2,2,2,2,2,2,2,124,54,69,16,188,191,15,199,148,128,57
],[
2,9,2,2,2,2,2,2,2,69,106,79,15,50,146,73,18,160,42,30
],[
2,2,2,2,2,2,2,2,2,248,248,66,176,243,52,65,221,54,79,131
],[
2,2,2,2,2,2,2,2,2,152,182,250,71,63,45,145,201,40,101,77
],[
2,2,2,6,2,2,2,2,2,171,126,179,187,153,75,193,109,45,213,145
],[
239,16,46,191,252,99,7,7,242,93,197,6,132,53,215,69,175,66,70,115
],[
239,97,141,242,178,151,172,150,13,247,120,169,174,198,53,50,18,222,102,118
]
]