aLevelData = [
[
2,2,3,3,3,113,240,33,240,11,18,39,224,122,73,57,193,204,183,1
],[
2,2,2,2,2,107,6,158,207,191,24,126,45,233,15,126,185,225,141,13
],[
3,2,3,3,3,52,56,118,201,214,17,237,160,228,110,127,53,133,173,157
],[
2,2,2,2,2,133,210,82,80,202,44,6,40,160,210,224,118,102,178,228
],[
3,2,3,3,3,186,231,128,201,95,57,6,0,166,230,187,241,225,74,150
],[
2,2,3,2,2,136,225,60,36,240,177,241,217,158,133,28,164,146,237,90
],[
3,2,3,2,2,197,217,78,206,227,87,147,8,89,195,32,44,210,243,7
],[
2,2,3,2,2,80,21,90,127,37,34,207,146,218,125,143,21,61,202,134
],[
2,3,3,2,2,221,36,154,202,48,11,133,105,122,254,121,100,65,186,81
],[
2,2,2,2,2,251,91,15,169,43,95,136,241,118,89,78,193,226,194,74
],[
3,3,3,3,2,108,68,175,138,216,190,72,230,141,135,124,227,11,234,243
],[
8,2,6,3,2,215,97,146,68,78,251,4,105,173,188,109,112,21,77,158
],[
2,2,2,3,2,114,138,180,85,201,85,40,190,126,166,35,57,1,126,186
],[
94,29,204,42,62,42,215,179,236,133,219,169,61,61,247,200,203,15,70,200
],[
64,149,77,49,209,186,149,113,8,113,152,43,199,167,226,211,138,117,112,120
],[
236,155,92,224,109,42,188,218,114,128,199,208,141,121,57,156,255,228,249,156
],[
123,52,249,9,45,120,94,132,251,142,226,242,11,147,118,138,133,157,43,44
],[
154,173,82,245,197,223,226,16,80,228,27,207,27,178,105,250,153,122,139,103
],[
27,219,244,202,81,85,114,207,13,0,13,102,75,126,50,94,111,46,17,54
],[
205,162,67,48,110,84,176,166,17,148,176,161,113,197,112,168,198,201,152,214
]
]