aLevelData = [
[
4,2,2,2,2,2,2,2,2,2,2,2,2,2,2,2,2,2,132,155
],[
5,2,5,3,2,2,2,2,2,2,2,2,2,2,2,2,2,2,210,165
],[
2,5,5,3,3,3,3,3,3,3,3,3,3,3,3,3,3,3,248,11
],[
3,3,5,5,5,5,5,5,5,5,3,2,2,2,2,2,2,2,92,189
],[
2,3,5,5,5,5,5,5,5,5,3,6,2,2,2,2,2,2,199,148
],[
3,3,5,5,5,5,3,3,3,3,3,3,3,3,3,2,3,3,29,165
],[
3,5,5,5,5,5,3,2,2,2,2,2,2,2,2,2,2,2,213,89
],[
3,5,5,3,3,3,3,8,2,2,2,5,5,5,5,5,5,5,64,38
],[
3,5,5,3,2,2,3,3,3,3,2,5,3,3,3,5,3,3,212,22
],[
3,5,5,3,2,2,2,2,2,3,2,5,3,5,5,5,5,5,32,129
],[
3,5,5,3,2,2,3,2,2,3,2,5,3,5,5,5,5,5,20,167
],[
5,5,5,3,2,2,3,2,2,3,2,5,3,5,5,5,5,5,186,13
],[
5,5,5,3,2,2,3,2,2,3,2,5,3,3,3,5,5,5,156,202
],[
99,33,121,37,182,52,86,139,209,67,77,123,193,116,253,233,58,248,221,65
],[
139,53,207,170,210,37,249,136,108,249,208,68,176,3,117,79,221,210,69,100
],[
80,159,172,14,251,232,57,107,18,90,248,47,7,244,252,235,185,106,59,144
],[
233,199,159,47,237,87,89,2,168,196,121,176,185,127,187,205,243,97,164,160
],[
13,147,206,42,155,171,129,99,61,23,130,199,23,191,48,17,129,230,204,71
],[
255,81,25,246,115,172,37,191,145,41,102,18,148,106,8,58,47,161,134,154
],[
199,246,120,54,223,41,172,117,212,120,119,37,202,195,77,191,230,238,144,236
]
]