aLevelData = [
[
2,2,2,5,2,2,2,5,2,2,2,5,2,2,134,222,77,10,102,135
],[
2,2,2,2,2,5,2,2,2,5,2,2,2,5,188,195,107,49,212,122
],[
2,2,3,3,3,3,3,3,3,3,3,3,3,3,133,90,41,66,21,55
],[
50,138,90,84,87,228,43,124,75,12,236,216,156,37,187,90,137,69,234,93
],[
19,52,178,133,87,113,37,237,26,118,101,129,166,61,20,168,213,3,11,39
],[
107,76,79,66,168,39,64,35,30,179,20,128,193,226,132,121,61,125,197,191
],[
140,105,186,251,199,40,104,110,60,162,170,212,194,38,38,143,73,172,127,1
],[
181,93,205,58,237,85,74,211,46,167,77,25,166,161,125,111,62,82,62,237
],[
183,74,112,77,248,161,89,8,166,59,223,188,246,73,251,209,191,19,106,92
],[
212,246,166,67,144,168,20,163,178,196,127,110,107,130,197,89,182,197,208,245
],[
232,92,200,27,136,129,135,142,96,166,78,220,212,114,182,133,115,6,233,95
],[
204,132,17,57,131,210,17,191,164,155,116,158,54,151,162,232,20,13,90,185
],[
248,150,92,27,217,35,102,39,119,65,98,109,52,156,222,150,37,194,188,72
],[
105,42,43,74,185,117,214,233,65,243,91,154,174,105,254,224,137,18,159,112
],[
195,227,233,148,145,19,205,205,122,219,46,188,173,123,222,66,153,125,202,231
],[
184,61,113,120,171,169,155,244,140,70,71,170,128,116,229,155,139,242,197,37
],[
169,164,208,227,26,148,118,207,253,56,231,169,32,243,134,157,23,221,154,32
],[
139,199,71,27,213,122,190,75,203,64,176,231,218,166,8,132,86,127,217,55
],[
13,44,149,249,34,27,129,79,25,142,101,42,46,158,136,11,235,127,219,108
],[
249,5,117,92,55,103,63,105,9,68,241,194,243,227,61,157,102,191,73,215
]
]