aLevelData = [
[
2,2,2,2,5,5,2,2,2,2,2,2,2,2,2,2,2,2,26,192
],[
2,2,2,4,2,2,2,2,2,2,2,5,2,2,2,5,2,5,160,186
],[
5,3,3,3,5,5,3,3,3,3,3,3,3,3,3,3,3,3,173,194
],[
2,3,2,2,2,2,2,2,2,3,2,2,2,2,3,2,2,2,164,203
],[
2,3,2,2,2,2,2,2,2,3,2,2,2,2,3,2,2,2,99,33
],[
70,238,31,196,26,120,173,212,249,239,75,43,164,32,104,9,169,108,171,9
],[
139,99,55,84,29,148,46,21,47,162,115,45,108,155,181,39,131,134,169,110
],[
133,59,150,189,142,120,23,216,168,48,29,122,236,38,51,142,235,187,6,161
],[
76,4,36,152,182,32,4,158,240,201,71,97,70,40,61,126,47,238,171,57
],[
46,160,203,114,246,50,149,213,209,216,61,80,66,25,253,202,233,37,20,18
],[
168,104,15,21,4,95,71,85,206,171,171,150,2,100,191,218,239,175,229,144
],[
152,147,220,9,91,8,134,43,208,81,238,105,244,140,137,243,135,136,188,41
],[
178,214,159,86,237,35,1,155,32,197,172,41,8,147,233,179,221,250,71,36
],[
50,77,153,141,28,93,62,97,150,74,165,228,36,152,15,225,183,133,151,155
],[
209,154,112,7,233,129,111,56,17,22,201,27,214,192,29,100,104,2,181,200
],[
251,77,9,109,108,25,132,159,40,52,139,196,74,89,188,146,3,4,115,127
],[
63,133,147,121,133,83,131,216,31,164,118,145,124,58,240,172,210,128,134,248
],[
7,213,229,253,210,40,21,50,30,197,255,112,175,110,45,167,7,174,210,208
],[
139,106,10,34,226,185,98,137,158,246,155,84,30,19,171,45,178,47,5,79
],[
1,107,26,243,168,250,32,11,36,120,18,51,242,125,248,229,244,113,104,236
]
]