aLevelData = [
[
6,2,8,2,9,2,10,2,11,3,2,2,5,221,181,244,88,118,42,22
],[
2,2,2,2,2,2,2,2,12,3,5,2,2,166,173,101,7,50,47,175
],[
2,2,3,3,3,3,3,3,3,3,2,2,3,245,62,195,6,252,75,125
],[
2,2,3,2,2,2,2,2,2,2,5,2,3,122,246,148,52,215,149,220
],[
2,2,3,2,2,2,2,2,2,2,2,2,3,55,132,175,105,60,171,216
],[
2,2,3,2,3,3,3,3,3,3,2,5,3,81,153,154,54,244,183,106
],[
2,2,3,2,2,2,2,5,5,3,2,2,3,145,202,195,222,170,95,166
],[
2,2,3,5,5,5,2,3,3,3,5,2,3,141,206,155,56,68,170,71
],[
2,2,2,2,2,2,2,2,2,2,2,2,5,176,166,97,205,96,21,220
],[
2,3,2,2,3,1,3,2,2,2,2,2,5,63,159,214,98,155,6,111
],[
2,3,2,2,3,2,3,2,2,2,2,5,5,104,78,223,84,170,246,218
],[
2,3,2,3,2,2,2,3,2,2,2,2,5,195,122,108,2,237,88,2
],[
2,3,2,3,2,2,2,3,3,3,2,2,3,240,86,196,9,62,126,80
],[
2,3,2,3,2,2,2,3,2,2,5,2,5,151,63,193,249,135,237,124
],[
2,3,2,3,2,2,3,3,2,2,2,2,5,183,192,35,113,83,187,13
],[
2,3,2,3,2,2,3,3,2,2,2,5,5,109,121,63,220,40,14,111
],[
2,3,2,3,2,2,3,3,2,2,2,2,5,190,108,195,7,13,121,235
],[
5,3,3,3,2,2,3,3,3,3,2,2,3,227,198,169,138,193,62,80
],[
174,71,16,230,2,72,90,104,160,67,41,251,39,44,49,211,13,111,194,83
],[
55,51,247,117,199,219,49,109,54,211,195,137,162,137,239,92,105,185,18,27
]
]