aLevelData = [
[
2,2,2,2,2,2,2,2,2,63,110,54,17,91,155,111,101,156,93,220
],[
2,3,5,3,5,5,5,3,5,77,158,113,145,154,183,101,54,96,125,9
],[
2,3,2,3,2,2,2,3,5,176,8,136,33,254,161,121,92,96,119,58
],[
2,2,2,2,2,2,2,2,2,138,191,231,136,9,73,113,175,128,92,15
],[
2,3,5,3,5,5,5,3,2,149,208,165,197,250,72,137,122,254,25,195
],[
2,3,5,3,5,5,5,3,2,6,228,9,79,140,21,107,135,10,104,78
],[
2,5,5,5,5,5,5,5,5,141,46,160,245,232,108,55,135,114,77,90
],[
2,3,5,3,5,5,5,3,5,8,113,10,52,136,4,89,111,154,193,135
],[
2,3,5,3,5,5,5,3,5,248,8,156,199,3,197,10,202,80,35,103
],[
2,5,5,5,5,5,5,5,5,143,172,70,149,125,186,217,231,175,243,255
],[
2,3,5,3,2,2,2,3,2,61,143,236,141,112,166,215,118,240,178,77
],[
5,3,5,3,2,2,2,3,2,135,171,249,75,84,49,222,122,114,22,178
],[
5,5,5,5,5,5,5,5,5,179,230,152,204,194,222,130,220,106,159,81
],[
5,3,5,3,5,5,5,3,5,124,170,191,148,8,63,148,153,176,106,236
],[
69,203,243,254,68,110,110,161,99,62,189,188,57,130,214,254,13,125,199,207
],[
244,250,247,134,58,40,174,220,3,168,215,160,50,229,5,173,138,164,181,26
],[
19,220,211,176,192,199,127,161,78,57,16,118,111,49,89,74,40,173,44,54
],[
120,195,29,12,58,238,136,72,76,166,214,67,241,51,251,170,116,194,67,47
],[
15,185,79,126,10,72,90,115,39,64,194,138,62,41,195,151,37,143,133,183
],[
210,156,89,134,196,236,63,146,159,156,173,16,22,164,139,206,13,103,130,105
]
]