aLevelData = [
[
6,2,2,204,47,227,218,170,80,147,220,183,47,31,252,75,216,52,196,25
],[
2,2,2,64,200,231,86,214,89,118,30,92,118,87,19,245,129,244,71,127
],[
2,2,2,179,48,92,34,96,159,233,41,125,246,32,17,95,192,174,224,197
],[
3,3,3,83,227,185,25,3,19,172,243,149,60,210,223,247,232,154,96,46
],[
2,2,2,85,94,53,143,212,58,218,50,111,29,82,164,206,32,36,220,92
],[
2,2,2,23,164,112,165,102,115,9,2,23,73,21,121,41,242,187,223,42
],[
2,2,2,151,20,63,8,63,152,128,36,149,214,65,168,236,105,8,27,128
],[
2,2,3,39,156,50,255,155,175,233,72,182,192,211,114,193,64,174,16,150
],[
2,2,2,244,59,179,16,154,77,177,192,207,31,37,225,48,234,55,142,192
],[
2,2,2,183,158,51,138,114,99,66,135,65,231,39,193,20,39,125,185,124
],[
3,3,3,63,130,6,192,45,200,64,46,216,46,28,175,81,15,216,158,88
],[
2,2,2,185,218,218,34,33,148,26,89,213,170,129,101,49,87,115,234,214
],[
2,2,2,13,166,145,88,91,124,12,55,20,144,84,17,174,142,53,21,232
],[
2,2,3,73,13,187,175,7,209,178,67,31,80,26,150,199,188,244,245,39
],[
102,215,233,178,201,228,96,181,202,252,8,48,62,48,252,230,173,120,162,176
],[
85,168,211,22,114,161,61,32,189,196,6,106,51,173,178,119,23,29,71,71
],[
58,55,175,44,122,240,93,217,137,193,52,188,240,158,164,142,83,44,22,40
],[
246,47,138,152,128,65,126,116,255,202,18,110,45,44,107,41,242,62,85,75
],[
41,252,44,212,167,125,252,174,121,37,231,132,110,27,199,216,214,253,21,80
],[
136,211,10,81,42,66,3,207,172,3,42,100,22,147,83,159,132,43,36,158
]
]