aLevelData = [
[
2,2,3,3,3,3,3,3,3,3,3,3,3,3,108,92,23,116,32,135
],[
2,2,2,2,2,2,2,2,2,2,2,2,2,2,252,207,51,27,26,42
],[
3,2,3,3,3,3,3,3,3,3,3,2,3,3,67,207,153,33,71,73
],[
2,2,2,2,2,2,2,2,2,2,2,2,2,2,211,177,23,148,254,77
],[
3,2,3,3,3,3,3,3,3,3,3,3,3,2,47,207,12,45,175,34
],[
2,2,3,2,2,2,2,2,2,2,2,2,3,2,207,234,167,247,97,72
],[
3,2,3,2,2,3,3,3,3,3,3,3,3,2,146,102,195,82,32,240
],[
2,2,3,2,2,3,2,2,2,2,2,3,3,2,196,173,57,113,36,38
],[
2,3,3,2,2,3,3,3,3,2,2,2,2,2,62,80,250,141,146,249
],[
2,2,2,2,2,2,2,2,2,3,2,3,2,2,83,198,89,141,28,29
],[
3,3,3,3,2,2,2,2,2,3,2,3,2,2,127,215,66,218,252,131
],[
8,2,6,3,2,3,3,3,3,3,2,3,2,2,23,21,87,138,248,204
],[
2,2,2,3,2,3,2,2,2,3,2,3,2,2,105,241,45,51,100,179
],[
2,2,2,2,2,3,2,2,2,3,2,3,3,3,16,75,20,252,113,182
],[
2,2,2,2,2,3,2,2,2,3,2,2,2,2,100,151,58,202,35,170
],[
79,228,8,161,184,255,244,104,2,133,120,221,226,100,151,133,28,101,205,125
],[
163,186,80,180,2,213,149,88,250,129,22,142,109,43,83,102,123,128,22,14
],[
234,62,252,70,203,67,49,19,90,235,123,184,39,152,122,226,115,146,46,35
],[
221,18,185,161,62,153,102,16,209,134,235,221,151,232,235,172,249,145,191,5
],[
176,108,118,74,226,16,26,237,141,148,53,223,41,165,148,76,137,215,75,133
]
]