aLevelData = [
[
4,2,2,2,2,2,2,2,154,4,198,180,189,216,209,57,125,235,226,102
],[
5,2,5,3,2,2,2,2,14,46,115,228,68,184,147,146,86,114,208,212
],[
2,5,5,3,3,3,3,3,227,20,89,46,50,80,100,17,190,76,206,244
],[
3,3,5,5,5,5,5,5,242,86,1,167,49,212,27,228,25,121,77,40
],[
9,191,128,192,224,145,63,39,8,71,209,143,180,216,165,190,101,75,244,27
],[
179,111,161,9,74,204,100,115,51,217,39,168,85,112,176,106,59,126,129,65
],[
23,255,252,22,7,42,203,252,152,232,127,81,137,139,119,6,209,189,4,59
],[
226,182,202,15,48,179,106,182,237,163,94,204,23,35,36,232,181,172,158,117
],[
94,11,185,189,250,18,77,71,205,142,68,99,177,121,255,3,162,112,245,204
],[
128,103,157,109,17,155,143,48,70,200,230,206,191,156,232,136,144,108,233,115
],[
70,39,108,20,37,136,140,44,180,143,154,213,124,49,8,206,12,79,133,20
],[
64,229,106,178,195,132,85,217,211,2,19,51,68,112,196,117,200,76,57,52
],[
109,248,161,249,103,107,101,151,16,39,80,188,45,106,243,199,115,169,72,217
],[
74,58,149,47,208,81,147,175,33,45,208,192,214,147,82,95,203,124,125,112
],[
38,11,55,81,148,193,73,181,214,244,8,176,125,125,54,14,241,178,35,233
],[
184,148,23,123,245,73,244,48,47,204,24,255,84,227,129,251,254,81,52,37
],[
244,77,223,133,244,52,189,121,176,123,186,76,22,231,216,10,212,0,209,147
],[
28,195,254,239,164,151,119,225,242,130,124,191,214,157,19,128,56,197,243,23
],[
19,148,161,0,194,143,217,24,123,161,47,177,25,201,246,230,30,15,97,44
],[
248,188,232,42,131,202,237,203,208,154,160,145,37,229,32,44,68,245,227,75
]
]