aLevelData = [
[
6,2,8,2,9,2,10,2,11,3,2,2,5,2,2,2,5,2,2,65
],[
2,2,2,2,2,2,2,2,12,3,5,2,2,2,5,2,2,2,5,32
],[
2,2,3,3,3,3,3,3,3,3,2,2,3,3,3,3,3,3,2,209
],[
2,2,3,2,2,2,2,2,2,2,5,2,3,2,2,2,2,3,2,191
],[
2,2,3,2,2,2,2,2,2,2,2,2,3,2,2,2,2,3,2,38
],[
2,2,3,2,3,3,3,3,3,3,2,5,3,2,2,2,2,2,2,210
],[
220,129,119,85,38,104,182,252,75,237,137,157,84,72,85,222,230,217,14,175
],[
185,199,78,24,76,231,164,53,215,223,46,127,130,139,106,76,212,159,73,154
],[
110,142,133,8,249,171,53,37,93,142,159,237,51,186,77,145,126,125,99,119
],[
149,23,47,130,100,30,2,147,212,32,62,80,136,139,177,36,202,202,33,134
],[
197,177,40,127,244,27,67,102,218,209,37,239,244,174,81,100,236,1,231,49
],[
15,51,190,166,1,170,180,249,175,236,66,138,134,8,84,107,227,50,87,32
],[
202,173,147,163,218,238,187,172,128,254,194,46,108,32,241,37,65,180,55,143
],[
145,91,192,184,8,92,200,187,231,70,178,70,180,215,84,157,48,29,150,226
],[
138,219,59,147,210,46,254,84,176,112,225,239,86,93,194,153,179,116,47,119
],[
234,160,123,96,2,24,17,229,223,132,9,142,113,97,249,103,43,166,14,187
],[
183,168,91,32,232,59,112,179,240,26,47,165,211,137,219,247,27,56,114,129
],[
206,107,61,57,157,88,165,178,94,208,72,227,188,34,76,42,45,61,243,145
],[
37,20,112,79,138,71,250,146,103,255,30,123,228,25,89,106,118,136,230,125
],[
83,244,213,83,41,167,93,22,15,170,115,184,188,43,155,124,246,34,255,185
]
]