aLevelData = [
[
2,2,3,3,3,3,3,3,3,3,3,3,3,3,3,3,2,3,7,197
],[
2,2,2,2,2,2,2,2,2,2,2,2,2,2,2,2,2,2,189,47
],[
3,2,3,3,3,3,3,3,3,3,3,2,3,3,3,2,2,2,244,197
],[
2,2,2,2,2,2,2,2,2,2,2,2,2,2,3,2,2,2,166,248
],[
84,181,229,76,95,190,143,67,224,76,236,80,140,21,113,104,146,87,238,102
],[
115,96,9,174,20,84,235,16,18,43,57,240,85,249,70,164,232,114,135,30
],[
7,173,71,203,122,40,155,186,34,13,153,1,210,179,197,93,96,104,204,24
],[
251,110,117,48,190,67,212,181,134,37,193,115,1,214,136,209,8,157,226,249
],[
47,141,36,57,154,9,183,169,18,136,200,15,87,150,64,255,184,28,247,71
],[
226,224,36,138,246,79,25,42,222,123,45,107,224,96,249,214,115,107,199,220
],[
82,61,71,188,208,172,132,167,107,10,23,33,163,170,154,170,13,161,96,158
],[
163,202,99,90,94,13,126,160,7,224,221,61,74,13,177,232,12,182,40,110
],[
254,151,156,12,114,140,11,28,110,83,199,245,255,146,110,12,208,28,29,95
],[
251,112,225,19,31,131,110,91,179,191,20,157,154,75,238,208,247,141,93,41
],[
66,237,180,246,156,220,53,202,95,21,61,218,250,35,187,167,252,36,230,221
],[
110,204,48,123,102,173,117,53,217,181,121,23,177,248,145,106,31,175,160,219
],[
51,129,69,218,170,2,83,65,7,122,130,54,229,231,100,82,139,69,154,3
],[
193,12,71,46,226,251,197,25,51,20,151,137,115,232,159,39,179,20,145,40
],[
104,12,168,45,191,23,152,104,48,155,195,1,86,155,175,184,254,126,184,203
],[
126,18,2,26,72,208,178,137,190,98,94,166,72,98,193,140,164,101,180,7
]
]