aLevelData = [
[
6,2,2,2,2,2,2,2,2,2,2,123,115,166,106,244,8,37,114,141
],[
2,2,2,2,2,2,2,2,2,2,2,108,177,233,25,50,96,28,2,45
],[
2,2,2,2,2,2,2,2,2,2,2,135,154,235,133,128,233,149,11,170
],[
3,3,3,3,3,3,3,3,3,3,3,119,255,202,178,211,210,222,17,29
],[
2,2,2,2,2,2,2,2,2,2,2,251,138,214,188,154,132,166,78,27
],[
2,2,2,2,2,2,2,2,2,2,2,147,1,229,162,92,198,112,173,121
],[
250,119,245,204,197,12,149,19,189,254,109,188,104,79,201,250,251,232,62,24
],[
104,140,213,14,152,11,108,82,245,184,88,240,44,28,79,221,49,236,134,136
],[
131,57,22,179,177,231,164,129,29,96,65,208,0,137,143,200,174,246,37,180
],[
28,90,53,17,159,65,108,229,246,1,26,83,139,237,147,107,246,205,213,71
],[
195,139,107,83,117,47,145,236,202,13,152,45,65,61,140,5,218,76,21,141
],[
29,49,155,153,93,131,173,142,62,233,164,115,117,209,131,74,207,101,34,160
],[
117,186,140,99,110,75,165,244,101,167,16,125,173,102,79,133,130,97,44,193
],[
146,35,88,45,188,154,83,92,23,18,139,12,54,101,200,254,170,107,199,5
],[
201,184,37,92,174,135,128,60,129,241,216,174,249,99,59,159,30,78,161,50
],[
84,32,21,90,149,116,21,167,254,133,60,96,141,233,30,211,41,124,116,233
],[
226,154,121,253,123,145,147,238,37,85,54,115,142,118,5,175,26,80,59,6
],[
112,130,74,46,57,161,194,137,36,45,115,178,46,195,214,86,32,149,169,69
],[
89,24,218,200,205,252,166,54,78,97,2,194,11,72,58,151,86,71,216,39
],[
170,130,199,191,236,214,184,95,241,87,197,202,65,253,84,217,26,154,63,20
]
]