aLevelData = [
[
4,2,2,2,2,2,2,2,2,2,2,64,218,28,146,44,91,13,172,94
],[
5,2,5,3,2,2,2,2,2,2,2,139,106,7,47,174,126,155,76,15
],[
2,5,5,3,3,3,3,3,3,3,3,115,177,103,231,176,234,44,129,101
],[
3,3,5,5,5,5,5,5,5,5,3,132,119,156,99,217,196,17,50,40
],[
2,3,5,5,5,5,5,5,5,5,3,231,181,93,152,253,129,17,122,162
],[
3,3,5,5,5,5,3,3,3,3,3,240,230,207,100,169,253,10,120,94
],[
3,5,5,5,5,5,3,2,2,2,2,75,23,172,244,52,155,157,228,92
],[
3,5,5,3,3,3,3,8,2,2,2,126,42,225,186,167,40,187,238,6
],[
3,5,5,3,2,2,3,3,3,3,2,87,131,212,216,149,240,89,38,82
],[
3,5,5,3,2,2,2,2,2,3,2,1,141,143,68,228,250,72,92,23
],[
3,5,5,3,2,2,3,2,2,3,2,53,97,248,205,178,74,90,147,220
],[
5,5,5,3,2,2,3,2,2,3,2,149,89,51,101,253,86,216,219,168
],[
5,5,5,3,2,2,3,2,2,3,2,114,116,125,169,254,95,76,201,52
],[
5,3,3,3,2,2,3,2,2,3,2,65,101,135,36,49,141,93,240,30
],[
5,3,2,2,2,2,3,2,2,3,2,14,69,60,110,194,124,225,230,109
],[
5,3,3,2,2,2,3,2,5,5,5,134,225,202,79,114,160,69,250,95
],[
5,5,3,3,2,2,3,2,5,3,5,81,10,98,63,174,60,51,219,236
],[
5,5,5,5,3,3,3,2,5,3,5,140,103,24,238,161,23,120,185,188
],[
5,5,5,5,5,5,3,2,5,3,5,145,227,40,156,172,168,224,159,88
],[
191,135,43,121,81,49,76,246,121,27,158,12,77,156,110,233,24,88,28,118
]
]