aLevelData = [
[
6,2,2,2,2,2,2,2,2,2,107,217,80,90,226,135,77,136,33,170
],[
2,2,2,2,2,2,2,2,2,2,135,53,69,250,161,9,168,121,101,51
],[
2,2,2,2,2,2,2,2,2,2,6,7,8,165,222,49,175,129,27,75
],[
3,3,3,3,3,3,3,3,3,3,49,206,244,190,31,112,17,162,2,87
],[
2,2,2,2,2,2,2,2,2,2,239,144,227,246,133,177,17,247,40,27
],[
2,2,2,2,2,2,2,2,2,2,30,45,172,94,43,202,204,89,101,210
],[
2,2,2,2,2,3,2,2,3,2,203,83,208,207,92,71,68,199,192,126
],[
2,2,3,3,3,3,3,3,3,3,181,107,46,99,183,145,119,148,64,228
],[
234,53,176,218,117,137,16,231,14,195,151,241,81,25,115,3,107,27,198,69
],[
54,67,238,44,165,205,9,238,99,200,184,57,183,110,36,36,171,177,63,102
],[
109,22,77,197,245,198,162,210,232,227,173,212,189,24,53,2,30,116,227,245
],[
145,120,1,92,87,110,129,242,148,253,65,173,177,251,141,56,255,130,230,164
],[
157,70,1,91,155,37,19,85,95,0,76,142,72,202,161,183,146,222,207,43
],[
122,150,157,38,162,25,97,49,182,116,197,225,80,237,203,193,25,147,15,141
],[
50,26,77,161,210,230,34,176,48,102,23,185,163,163,219,55,7,25,208,153
],[
100,197,201,241,202,127,19,240,127,138,178,18,93,106,236,22,117,245,12,177
],[
248,173,96,131,88,77,132,74,170,162,226,86,79,156,122,61,211,165,223,207
],[
21,49,130,76,168,151,51,213,122,31,229,33,179,92,178,113,224,188,31,198
],[
81,93,160,81,191,34,95,43,51,7,57,70,34,177,9,164,221,74,42,198
],[
41,139,55,104,41,26,21,107,133,23,52,19,197,241,17,114,254,127,0,36
]
]