aLevelData = [
[
2,2,2,2,2,2,2,2,2,6,59,244,108,138,82,136,106,168,245,231
],[
2,3,5,3,5,5,5,3,5,3,177,225,89,197,59,28,97,200,33,218
],[
2,3,2,3,2,2,2,3,5,3,18,49,177,4,71,191,194,230,165,208
],[
2,2,2,2,2,2,2,2,2,2,68,123,210,202,27,235,226,185,46,82
],[
2,3,5,3,5,5,5,3,2,3,18,58,186,195,185,151,237,141,123,51
],[
2,3,5,3,5,5,5,3,2,3,176,188,192,41,196,227,100,48,16,25
],[
2,5,5,5,5,5,5,5,5,5,177,194,57,66,138,125,116,144,232,201
],[
2,3,5,3,5,5,5,3,5,3,152,73,139,187,120,202,233,57,111,204
],[
2,3,5,3,5,5,5,3,5,3,107,95,60,230,216,34,16,83,17,51
],[
2,5,5,5,5,5,5,5,5,5,230,246,0,38,19,155,203,212,30,128
],[
2,3,5,3,2,2,2,3,2,3,77,254,209,20,198,51,144,254,209,243
],[
234,97,151,20,110,94,67,101,192,219,182,146,236,131,123,71,249,14,253,152
],[
194,195,247,161,1,59,45,105,173,103,90,13,134,213,105,26,238,46,231,58
],[
250,4,185,19,201,202,10,108,20,36,136,145,7,98,208,249,79,70,38,39
],[
117,14,106,206,106,174,71,56,99,94,174,232,230,84,131,127,37,211,150,220
],[
140,100,212,135,150,100,191,80,228,190,27,51,144,250,234,127,191,119,155,56
],[
117,244,127,185,174,85,124,157,170,164,5,224,136,87,73,66,22,209,171,236
],[
232,43,115,86,167,51,195,104,172,181,204,224,205,250,65,243,119,143,12,55
],[
254,71,65,192,48,131,80,137,48,177,126,22,130,19,150,88,98,194,219,209
],[
90,242,66,249,19,119,222,223,108,137,156,19,201,196,48,196,173,114,79,38
]
]