aLevelData = [
[
6,2,8,2,9,2,10,2,11,3,2,82,11,51,181,109,253,212,167,89
],[
2,2,2,2,2,2,2,2,12,3,5,51,130,243,180,166,219,15,42,34
],[
2,2,3,3,3,3,3,3,3,3,2,14,188,139,5,147,231,33,68,26
],[
2,2,3,2,2,2,2,2,2,2,5,205,64,174,193,99,30,117,137,245
],[
229,234,11,13,7,136,103,150,210,52,126,65,68,195,97,40,32,189,8,178
],[
65,96,72,182,47,232,255,227,240,14,146,95,33,207,153,174,69,110,216,214
],[
92,188,114,192,184,151,89,226,12,177,9,27,198,147,118,222,158,225,66,147
],[
111,223,52,58,70,52,230,82,185,238,189,249,123,199,30,84,45,166,223,49
],[
118,105,252,235,85,226,140,142,182,31,243,60,68,239,88,208,127,161,90,192
],[
14,15,254,72,86,220,236,197,75,249,220,95,134,110,75,234,153,87,114,14
],[
159,44,120,166,23,70,231,103,242,159,93,194,234,218,132,11,22,131,67,218
],[
187,151,54,178,102,71,92,224,55,249,16,166,128,144,59,153,143,237,199,72
],[
199,181,87,30,246,85,53,138,226,68,139,92,37,136,215,115,59,124,153,149
],[
218,208,78,158,129,209,162,221,84,235,226,187,39,108,176,157,217,138,250,12
],[
227,168,45,20,48,213,165,233,48,150,105,209,40,229,21,61,204,121,23,57
],[
15,72,30,7,58,75,208,7,59,129,188,219,64,54,143,199,133,133,138,94
],[
106,28,51,91,201,63,75,205,134,16,1,119,104,13,101,118,39,218,31,36
],[
198,65,97,61,34,119,26,64,204,160,109,24,20,150,97,252,102,230,218,148
],[
218,28,200,93,6,65,158,78,23,161,6,188,32,210,210,123,177,241,54,70
],[
172,47,53,96,84,140,90,124,167,227,168,219,238,39,211,180,146,236,177,216
]
]