aLevelData = [
[
2,2,2,2,2,2,2,193,152,210,150,223,121,190,98,14,115,121,118,69
],[
2,2,2,2,2,2,2,178,79,124,217,73,213,71,158,200,43,9,79,17
],[
2,2,2,2,2,2,2,127,198,47,103,210,8,241,200,255,213,213,125,249
],[
2,2,2,3,3,3,3,222,21,239,84,249,127,188,7,209,99,10,112,220
],[
2,2,2,2,2,2,2,175,28,152,142,89,35,185,205,253,86,253,164,200
],[
2,2,2,2,2,2,2,68,137,59,148,105,186,7,84,0,174,62,179,25
],[
2,2,2,2,2,3,2,7,142,248,235,235,14,45,107,79,117,128,30,118
],[
2,2,2,3,3,3,3,138,233,43,180,219,13,180,120,178,99,102,138,69
],[
2,2,2,2,2,2,2,149,79,144,45,41,240,215,25,96,148,80,196,94
],[
2,2,2,2,2,2,2,224,217,36,140,170,190,229,59,15,128,21,138,191
],[
2,2,3,3,3,3,3,213,33,137,156,239,0,158,132,1,174,40,106,0
],[
2,2,2,2,2,2,2,220,99,172,167,230,140,160,189,5,69,112,154,198
],[
2,2,2,2,2,2,2,58,41,232,186,5,14,167,111,79,50,115,160,56
],[
2,2,3,3,3,3,3,70,10,169,249,175,9,61,200,220,246,91,253,214
],[
2,2,3,2,2,2,2,131,126,114,24,17,21,47,162,116,50,71,73,246
],[
2,2,3,2,2,2,2,134,253,81,158,141,43,61,178,6,229,230,122,166
],[
89,203,71,13,249,168,180,249,221,74,44,186,98,161,172,230,24,23,202,77
],[
219,32,247,47,63,18,1,173,50,56,220,126,220,33,161,227,202,62,215,221
],[
76,173,242,157,27,79,25,60,63,32,44,172,48,200,6,239,60,109,255,134
],[
40,204,181,45,26,136,13,197,183,193,116,146,136,233,107,166,162,211,66,157
]
]