aLevelData = [
[
2,2,2,5,2,2,2,5,2,2,2,196,3,0,79,64,190,129,239,49
],[
2,2,2,2,2,5,2,2,2,5,2,186,94,38,96,238,194,68,112,193
],[
2,2,3,3,3,3,3,3,3,3,3,130,148,17,114,247,222,118,183,12
],[
2,3,2,2,2,2,2,2,2,2,2,48,8,164,150,222,92,207,228,200
],[
2,3,2,2,2,2,2,2,2,2,8,98,178,151,219,224,80,180,219,31
],[
2,2,2,2,2,5,5,5,5,2,2,28,248,95,229,22,108,29,162,55
],[
2,2,3,3,3,3,2,3,2,3,2,57,103,238,15,188,246,51,173,221
],[
231,167,191,157,3,126,250,239,67,93,188,201,147,17,240,122,215,129,51,62
],[
44,225,52,16,112,41,97,191,4,198,192,68,208,143,26,83,136,250,95,48
],[
46,144,70,196,217,158,52,240,180,46,95,33,73,53,51,37,0,14,245,61
],[
226,39,166,115,163,251,42,45,224,64,169,3,165,97,54,206,50,46,174,1
],[
255,211,227,61,253,6,250,31,31,133,18,93,25,192,39,17,104,210,53,84
],[
146,182,160,15,175,184,211,14,40,41,39,86,191,87,7,185,207,189,83,167
],[
213,118,1,71,48,248,10,198,37,254,132,240,38,198,11,253,84,125,102,173
],[
66,248,104,151,252,164,19,189,72,192,4,101,43,201,11,36,175,54,25,60
],[
228,102,95,40,37,215,180,116,156,152,55,210,9,1,54,107,190,161,79,115
],[
238,120,213,0,40,102,118,28,31,228,26,24,172,242,13,36,22,80,97,29
],[
144,241,142,166,3,173,92,122,14,54,3,1,76,77,144,33,213,54,138,86
],[
7,105,214,5,134,138,216,13,129,155,219,160,55,113,179,81,186,100,160,109
],[
243,75,118,143,231,168,251,111,56,31,145,251,239,45,21,169,120,22,6,11
]
]