aLevelData = [
[
6,2,2,118,231,67,19,43,188,39,126,228,224,20,238,45,124,29,123,203
],[
2,2,2,17,79,80,79,189,228,12,235,186,185,104,133,39,3,25,10,11
],[
2,2,2,61,248,5,151,101,96,112,171,103,215,201,156,218,241,105,53,234
],[
3,3,3,114,18,251,149,179,199,181,27,71,224,44,175,221,93,48,115,104
],[
2,2,2,123,219,163,126,133,26,16,254,237,104,209,246,155,221,53,196,133
],[
2,2,2,104,252,123,128,89,198,136,85,34,203,149,24,94,205,173,181,18
],[
2,2,2,75,161,204,51,248,171,191,105,107,82,9,19,24,141,209,139,127
],[
2,2,3,43,190,171,163,114,14,144,190,7,226,157,51,14,220,195,196,145
],[
2,2,2,236,0,5,38,103,38,16,204,90,222,123,23,29,236,135,141,43
],[
2,2,2,181,154,79,48,254,240,252,100,246,141,210,24,119,118,22,142,137
],[
3,3,3,32,182,14,40,41,46,54,71,70,168,146,20,125,103,109,126,148
],[
2,2,2,101,230,244,201,59,70,112,195,66,144,181,201,248,90,213,50,165
],[
2,2,2,220,245,28,62,71,84,97,137,88,138,199,130,44,14,119,254,86
],[
2,2,3,251,177,142,47,20,189,166,109,5,37,254,247,236,33,57,248,23
],[
2,2,3,83,197,50,15,180,2,150,214,207,166,17,110,45,96,168,154,16
],[
2,2,3,187,199,233,100,70,214,239,242,242,14,214,215,187,139,22,52,138
],[
2,2,3,162,128,40,90,116,129,251,154,195,165,156,211,5,90,78,139,183
],[
2,2,2,247,158,105,244,252,152,154,70,155,58,114,188,120,41,87,61,174
],[
3,3,3,163,219,27,18,181,40,235,187,174,161,149,194,211,198,167,70,84
],[
88,239,179,127,190,72,68,52,168,180,199,153,242,171,161,14,203,179,17,100
]
]