aLevelData = [
[
6,2,8,2,9,2,10,2,11,3,2,2,5,24,100,41,203,67,48,25
],[
2,2,2,2,2,2,2,2,12,3,5,2,2,59,114,105,88,0,221,58
],[
2,2,3,3,3,3,3,3,3,3,2,2,3,246,57,58,75,135,124,214
],[
2,2,3,2,2,2,2,2,2,2,5,2,3,138,211,189,228,43,206,113
],[
2,2,3,2,2,2,2,2,2,2,2,2,3,21,237,202,244,105,160,235
],[
2,2,3,2,3,3,3,3,3,3,2,5,3,40,68,228,219,96,196,51
],[
2,2,3,2,2,2,2,5,5,3,2,2,3,192,124,82,34,107,85,119
],[
2,2,3,5,5,5,2,3,3,3,5,2,3,227,210,91,241,15,193,124
],[
2,2,2,2,2,2,2,2,2,2,2,2,5,7,162,204,72,25,72,136
],[
2,3,2,2,3,1,3,2,2,2,2,2,5,83,123,215,251,219,132,28
],[
2,3,2,2,3,2,3,2,2,2,2,5,5,80,171,225,218,207,63,47
],[
16,13,41,202,123,96,180,223,92,150,198,201,123,231,11,154,108,39,79,247
],[
17,65,44,42,96,224,230,114,102,111,147,157,140,68,127,217,26,24,206,200
],[
249,187,99,210,189,5,1,191,227,16,176,133,86,164,99,94,56,243,215,30
],[
224,135,190,196,31,120,29,79,200,226,243,211,111,150,27,203,112,16,115,177
],[
52,170,62,204,175,15,199,74,45,241,72,142,79,255,9,203,80,17,204,210
],[
141,166,105,40,69,145,182,92,157,239,169,151,231,92,193,117,35,103,161,19
],[
198,67,255,106,187,191,188,219,168,119,84,10,114,76,121,240,3,19,251,44
],[
75,138,235,154,132,144,0,39,187,149,57,228,140,79,196,89,45,174,31,27
],[
174,19,125,161,126,189,107,83,50,131,179,228,130,201,129,226,148,173,196,139
]
]