aLevelData = [
[
2,2,2,2,2,2,2,2,2,2,2,2,2,2,2,2,2,189,156,104
],[
56,219,173,57,0,28,101,225,216,93,124,71,226,210,170,88,34,249,196,158
],[
201,204,41,21,186,59,92,59,71,217,242,103,59,214,175,91,30,45,236,28
],[
180,30,59,2,199,223,78,11,38,143,21,116,238,107,39,139,8,68,99,191
],[
243,49,215,249,196,129,225,47,107,243,147,54,55,42,92,215,157,91,229,38
],[
53,73,58,15,5,115,42,50,2,139,240,241,212,43,19,198,218,196,138,218
],[
110,215,36,212,106,103,39,239,234,174,55,80,84,15,122,150,150,76,250,178
],[
175,249,75,249,113,48,109,119,133,135,243,135,175,63,101,161,83,190,228,114
],[
57,63,12,50,141,201,31,50,42,93,95,180,24,116,187,0,82,169,174,180
],[
205,178,101,92,183,148,32,66,252,23,218,136,15,120,44,115,231,95,111,10
],[
72,16,33,224,67,229,137,46,0,252,158,36,187,45,38,129,13,63,27,98
],[
109,91,82,87,246,192,95,188,107,185,179,71,120,204,7,221,58,53,254,170
],[
2,147,5,112,86,224,126,31,57,166,31,167,173,112,148,10,117,127,108,181
],[
31,191,50,16,66,250,218,84,5,74,96,157,224,212,171,64,167,179,183,94
],[
196,51,243,185,195,64,232,199,21,30,28,5,13,90,54,142,47,0,98,236
],[
170,14,247,46,35,41,88,58,180,143,24,101,53,77,97,65,186,178,150,182
],[
92,3,55,85,61,112,5,232,198,71,103,78,51,104,13,134,82,249,211,9
],[
135,90,232,93,20,91,47,231,151,173,229,1,212,151,133,76,181,234,232,71
],[
143,55,177,33,167,63,232,204,245,171,229,83,40,254,112,109,234,199,38,82
],[
100,27,31,205,5,66,205,147,127,177,39,211,19,56,7,14,15,125,209,41
]
]