aLevelData = [
[
10,2,2,8,2,2,2,2,2,2,62,0,140,224,176,203,5,36,18,88
],[
2,2,2,2,2,2,2,2,2,2,134,108,31,198,193,108,71,16,211,160
],[
2,2,2,2,2,2,3,3,3,3,168,53,213,145,58,150,173,84,73,159
],[
9,2,2,2,2,2,2,2,2,3,42,83,41,169,81,80,37,31,241,166
],[
3,3,3,3,3,3,3,2,2,3,184,224,126,210,0,229,27,51,111,36
],[
2,2,2,2,2,2,2,2,2,3,249,14,196,180,224,213,57,49,11,169
],[
2,2,2,2,2,2,2,2,2,3,254,98,57,29,231,25,1,61,98,91
],[
2,2,2,2,2,2,2,2,2,2,102,207,171,193,171,216,67,30,105,98
],[
158,98,222,125,27,191,136,132,58,10,242,161,10,99,207,147,224,24,69,175
],[
78,199,139,37,83,195,182,133,208,185,208,130,59,148,43,245,151,157,244,37
],[
164,231,11,69,83,234,18,62,124,110,197,175,211,171,137,50,25,174,71,226
],[
143,254,122,26,176,128,135,127,31,152,78,64,223,145,254,156,194,63,45,165
],[
36,226,40,68,216,78,135,126,99,73,5,245,104,53,143,178,100,239,155,33
],[
156,246,187,93,83,208,114,174,63,169,70,81,62,62,22,119,70,249,174,143
],[
154,93,153,200,68,165,54,210,191,168,15,229,244,0,101,5,104,107,16,132
],[
179,113,134,200,52,72,57,79,3,244,38,239,39,178,170,99,9,151,152,3
],[
41,117,138,211,16,254,116,191,134,44,127,37,4,224,20,148,108,201,54,212
],[
248,135,22,38,112,16,225,204,161,83,221,204,10,28,180,242,216,56,16,20
],[
21,217,103,153,28,60,25,60,80,136,184,14,13,250,166,186,223,63,230,13
],[
242,33,44,182,202,102,54,74,52,245,95,139,125,59,114,233,225,205,188,73
]
]