aLevelData = [
[
5,5,5,5,5,102,53,164,52,155,19,211,139,44,222,56,72,113,223,10
],[
5,2,2,2,2,151,115,70,196,216,164,20,120,163,206,56,102,9,74,248
],[
5,2,5,3,3,205,29,114,147,1,180,88,37,190,104,185,202,188,227,44
],[
2,2,5,2,3,6,131,90,159,101,129,87,4,94,90,188,72,125,127,5
],[
2,2,3,2,3,133,194,2,205,120,68,169,147,53,25,65,191,25,122,52
],[
2,2,3,2,3,224,1,35,94,56,185,249,29,122,184,239,167,210,10,42
],[
4,2,3,2,2,161,38,141,100,237,156,96,142,195,92,153,185,3,151,54
],[
2,2,3,2,2,54,201,200,87,252,66,57,170,75,191,201,38,143,8,238
],[
2,2,2,2,2,252,135,243,246,202,166,53,146,18,186,119,148,236,203,173
],[
2,3,2,2,2,248,247,70,163,33,149,91,216,102,88,163,144,205,183,6
],[
2,3,2,2,2,37,22,6,220,158,252,165,82,130,183,119,15,239,197,149
],[
2,3,2,3,3,24,230,234,68,241,233,118,37,6,200,198,172,73,184,13
],[
2,3,2,3,6,211,27,165,85,16,112,201,192,132,46,126,20,117,215,80
],[
2,3,2,3,8,118,254,104,87,118,5,129,196,76,110,197,185,97,142,132
],[
2,3,2,3,9,94,18,227,152,49,176,2,140,157,203,208,4,207,176,245
],[
2,3,2,3,10,88,197,48,142,131,167,163,34,60,91,45,216,98,84,64
],[
2,3,2,3,11,231,157,170,98,77,67,112,49,196,120,66,164,242,154,29
],[
2,3,3,3,12,147,224,220,115,122,173,48,127,122,132,107,215,160,203,163
],[
2,2,2,2,5,64,106,157,220,197,135,123,228,11,223,62,124,223,211,80
],[
184,17,198,28,169,133,220,195,57,135,1,17,85,95,46,175,82,37,231,154
]
]