aLevelData = [
[
6,2,2,2,2,2,2,81,85,86,217,170,88,96,190,52,85,213,86,195
],[
2,2,2,2,2,2,2,226,199,253,151,73,32,135,132,38,226,118,80,49
],[
2,2,2,2,2,2,2,179,112,93,88,152,241,135,17,1,62,80,238,6
],[
3,3,3,3,3,3,3,154,59,113,240,187,117,35,251,127,186,224,90,220
],[
2,2,2,2,2,2,2,119,117,124,21,44,109,142,52,21,39,65,180,9
],[
2,2,2,2,2,2,2,44,205,126,162,192,54,23,158,183,205,23,133,138
],[
2,2,2,2,2,3,2,251,221,140,170,58,129,186,20,100,10,73,38,48
],[
2,2,3,3,3,3,3,225,79,177,249,134,158,79,194,130,232,247,120,157
],[
2,2,2,2,2,2,2,39,206,118,80,59,64,79,125,213,80,199,94,149
],[
2,2,2,2,2,2,2,44,34,188,111,5,162,97,83,29,75,207,13,34
],[
3,3,3,3,3,3,3,233,50,106,186,84,148,156,95,243,80,223,109,127
],[
2,2,2,2,2,2,2,201,93,121,9,91,79,229,63,146,102,177,235,154
],[
2,2,2,2,2,2,2,105,148,188,247,31,76,73,118,111,50,83,100,198
],[
2,2,3,3,3,3,3,17,74,253,185,56,19,39,236,206,9,97,50,102
],[
2,2,3,2,2,2,2,66,246,245,211,19,118,217,62,214,102,156,118,234
],[
2,2,3,2,2,2,2,55,65,134,252,117,109,141,133,65,17,202,148,1
],[
2,2,3,3,3,3,3,73,247,206,86,132,216,179,79,230,19,35,220,234
],[
2,2,2,2,2,2,3,66,32,133,76,71,213,91,38,223,215,47,89,123
],[
3,3,3,3,2,2,3,172,3,46,75,138,190,61,155,96,36,142,98,27
],[
2,2,1,2,2,2,3,4,255,24,34,179,229,201,34,186,246,104,17,204
]
]