aLevelData = [
[
4,2,2,2,15,14,61,31,90,118,105,174,178,160,148,115,211,40,120,141
],[
2,2,3,2,117,183,175,125,33,130,39,207,66,19,208,253,127,76,151,144
],[
2,3,2,2,72,169,152,136,175,197,143,254,122,32,144,8,118,31,249,221
],[
2,3,2,2,14,84,164,57,27,0,97,3,254,214,163,46,237,2,121,221
],[
2,3,2,2,138,106,192,202,186,52,152,232,180,136,20,71,88,151,54,56
],[
2,3,2,3,195,220,26,179,32,161,113,245,192,198,49,109,110,190,139,217
],[
2,2,3,2,252,218,30,173,34,202,106,180,137,97,135,249,34,152,22,232
],[
2,2,2,2,188,214,121,177,214,110,63,237,177,105,226,132,170,135,181,206
],[
2,2,2,3,199,128,24,248,144,143,238,170,32,49,81,230,123,43,132,52
],[
2,2,3,2,34,202,40,252,229,110,179,51,249,74,31,57,74,101,223,2
],[
2,2,5,2,18,228,23,117,171,140,12,17,162,131,218,214,12,86,101,99
],[
2,2,2,3,29,64,145,92,246,170,182,14,191,238,78,86,246,96,241,190
],[
2,2,3,2,6,143,132,234,28,200,173,51,54,220,137,145,125,35,162,190
],[
2,3,2,2,212,193,27,152,177,40,46,200,43,223,217,161,85,129,211,74
],[
2,2,2,3,203,8,197,32,138,75,183,86,5,198,200,222,117,154,35,141
],[
2,2,3,2,112,212,46,122,189,242,5,167,103,164,38,227,16,207,110,238
],[
2,3,2,2,136,215,68,223,158,30,20,195,54,200,255,135,156,194,208,24
],[
2,2,2,3,24,2,50,200,195,16,33,244,152,197,159,227,206,82,168,242
],[
2,2,3,2,102,133,103,238,0,72,170,194,242,107,148,82,155,163,145,166
],[
2,2,2,2,245,210,143,75,106,136,108,246,233,202,170,107,56,19,106,157
]
]