aLevelData = [
[
6,2,2,2,2,2,2,2,2,2,45,36,138,236,181,122,250,131,130,164
],[
2,2,2,2,2,2,2,2,2,2,11,220,11,137,26,183,164,129,45,206
],[
2,2,2,2,2,2,2,2,2,2,173,186,204,92,9,217,18,220,210,228
],[
3,3,3,3,3,3,3,3,3,3,3,19,74,95,32,80,21,181,57,243
],[
2,2,2,2,2,2,2,2,2,2,166,218,131,44,248,47,234,5,126,166
],[
2,2,2,2,2,2,2,2,2,2,168,163,92,38,23,200,215,49,195,157
],[
2,2,2,2,2,3,2,2,3,2,10,196,196,175,219,126,75,55,46,5
],[
2,2,3,3,3,3,3,3,3,3,122,158,89,166,121,64,215,59,198,113
],[
2,2,2,2,2,2,2,2,2,2,64,82,204,189,120,139,184,116,39,66
],[
2,2,2,2,2,2,2,2,2,4,136,103,106,110,100,236,201,201,50,40
],[
3,3,3,3,3,3,3,3,3,3,104,50,101,141,129,79,21,161,17,118
],[
85,1,210,206,193,166,106,177,86,104,226,85,135,192,89,172,140,210,250,136
],[
254,171,43,3,161,199,7,30,129,214,15,168,64,191,28,98,174,230,153,96
],[
154,171,238,178,232,51,63,68,228,106,87,3,214,72,223,65,215,84,212,91
],[
226,103,56,153,46,179,7,85,187,3,108,96,43,68,53,161,212,69,133,255
],[
19,187,200,130,227,136,236,180,174,61,207,78,99,221,243,16,200,228,121,241
],[
18,135,77,120,179,62,158,106,115,128,145,165,194,205,54,76,76,242,187,36
],[
207,137,223,62,41,191,170,215,182,90,91,124,216,250,163,114,215,158,16,84
],[
236,107,204,254,152,169,135,170,58,15,178,89,225,64,238,117,95,149,196,180
],[
159,29,150,63,56,226,213,20,65,110,117,168,104,142,158,209,62,86,165,228
]
]