aLevelData = [
[
2,2,2,2,2,2,2,2,2,6,212,18,88,246,129,160,51,22,73,10
],[
2,3,5,3,5,5,5,3,5,3,229,106,74,79,135,123,124,208,255,94
],[
2,3,2,3,2,2,2,3,5,3,43,249,28,125,171,35,227,154,71,185
],[
2,2,2,2,2,2,2,2,2,2,35,16,122,154,80,92,98,191,141,221
],[
2,3,5,3,5,5,5,3,2,3,113,30,11,216,102,206,146,191,123,107
],[
2,3,5,3,5,5,5,3,2,3,93,179,224,188,43,71,105,147,147,135
],[
2,5,5,5,5,5,5,5,5,5,132,245,152,57,109,123,125,98,165,248
],[
2,3,5,3,5,5,5,3,5,3,219,12,160,92,240,71,189,217,58,110
],[
2,3,5,3,5,5,5,3,5,3,124,68,68,171,236,189,193,189,98,146
],[
2,5,5,5,5,5,5,5,5,5,215,249,112,97,189,143,21,125,136,15
],[
2,3,5,3,2,2,2,3,2,3,50,147,66,44,61,142,61,191,57,183
],[
5,3,5,3,2,2,2,3,2,3,166,15,230,33,93,79,53,68,4,104
],[
5,5,5,5,5,5,5,5,5,5,254,232,87,249,245,69,187,156,219,104
],[
5,3,5,3,5,5,5,3,5,3,25,108,241,216,236,196,178,122,153,73
],[
5,3,5,3,5,5,5,3,5,3,193,178,0,42,33,203,80,166,164,153
],[
1,5,5,5,5,5,5,5,5,5,31,207,166,92,186,142,250,232,185,232
],[
5,3,2,3,2,2,2,3,2,3,37,3,215,127,202,15,1,92,102,233
],[
2,3,2,3,2,2,2,3,2,3,173,235,62,16,109,71,149,10,196,184
],[
2,3,2,3,3,2,3,3,2,3,33,3,56,123,192,184,168,193,104,147
],[
224,249,92,23,107,82,166,127,168,124,193,162,33,175,150,26,23,239,170,165
]
]