aLevelData = [
[
2,2,2,2,5,5,2,61,24,15,197,65,159,2,152,8,212,11,197,230
],[
69,207,110,74,60,197,64,252,239,151,73,162,247,203,10,137,3,162,206,162
],[
206,64,58,203,78,14,36,80,47,93,169,178,127,76,121,167,171,235,118,97
],[
170,160,126,19,120,202,132,178,198,165,230,249,240,110,250,175,47,199,234,44
],[
16,92,195,26,36,199,200,121,249,177,12,229,74,58,64,28,115,155,201,187
],[
39,10,22,72,101,223,48,117,168,244,146,163,95,81,60,166,156,9,3,200
],[
16,95,43,16,55,45,55,196,208,135,0,44,144,155,5,153,23,219,2,166
],[
35,95,196,190,4,132,59,222,80,218,209,156,215,61,250,105,217,65,12,19
],[
119,212,82,142,104,30,91,243,237,172,152,201,7,206,39,132,231,61,233,75
],[
166,1,218,254,54,146,162,120,153,62,103,17,80,202,230,103,23,92,194,95
],[
207,153,27,102,188,10,99,253,240,196,109,116,7,72,199,245,21,168,74,197
],[
221,235,239,199,68,179,229,66,5,29,224,227,165,233,179,6,170,219,33,49
],[
8,96,240,225,220,117,64,138,92,197,27,217,14,17,77,60,57,213,118,164
],[
154,41,93,138,87,229,135,48,57,8,9,41,21,91,154,27,139,81,236,196
],[
243,50,61,59,149,120,41,120,24,122,194,23,62,71,226,89,206,213,192,108
],[
209,91,194,236,0,251,146,169,126,164,116,171,195,55,215,115,216,232,41,132
],[
202,232,240,34,89,65,23,90,240,1,133,66,218,154,245,130,178,137,1,19
],[
27,54,127,71,178,27,17,10,65,41,248,103,54,103,41,78,83,221,163,148
],[
166,176,255,59,188,142,73,244,18,76,14,226,204,206,182,161,169,40,20,135
],[
55,2,60,41,67,65,149,33,148,228,47,15,217,43,86,222,223,255,103,73
]
]