aLevelData = [
[
2,2,207,50,150,240,199,66,191,171,44,143,159,241,231,240,7,93,253,231
],[
2,2,190,167,16,24,37,189,41,0,27,21,180,227,31,65,204,6,180,196
],[
185,31,10,36,183,10,218,64,249,189,146,228,238,126,178,155,195,84,118,196
],[
41,187,181,232,88,155,9,75,84,123,48,193,111,242,178,195,15,95,196,194
],[
177,218,109,187,46,107,231,12,61,121,72,134,58,133,98,195,38,24,231,186
],[
238,249,209,144,240,164,0,178,187,248,37,32,22,48,224,12,69,20,37,163
],[
135,112,228,43,227,198,233,78,36,64,1,181,35,232,94,217,68,27,60,22
],[
67,59,197,2,49,165,50,252,185,227,52,8,168,34,146,218,173,230,19,48
],[
92,252,158,101,121,177,160,67,116,65,174,26,48,146,108,14,8,34,173,181
],[
20,62,219,226,168,118,154,187,30,77,168,18,214,53,7,242,122,186,95,119
],[
135,253,158,227,9,100,225,239,166,144,151,95,221,143,227,217,144,83,67,247
],[
192,99,112,155,153,209,133,131,174,108,98,29,133,54,83,156,86,25,237,75
],[
16,213,57,33,157,61,21,150,103,163,214,182,27,145,50,116,173,186,94,64
],[
156,47,115,220,119,214,22,107,160,25,88,203,80,219,219,36,219,176,55,193
],[
53,77,155,31,181,61,184,68,26,214,218,82,204,108,88,92,100,196,47,120
],[
109,203,234,22,108,136,197,144,31,80,17,2,3,57,218,91,24,209,200,180
],[
232,15,67,225,198,137,218,70,84,232,230,236,72,153,106,213,111,198,62,140
],[
242,133,109,255,216,79,219,145,204,179,43,108,32,75,223,20,19,240,193,66
],[
79,42,130,239,182,234,162,175,94,124,143,64,218,183,17,99,188,119,229,234
],[
87,77,169,19,202,116,248,20,58,7,213,247,94,114,77,168,65,39,88,77
]
]