aLevelData = [
[
2,2,2,2,2,2,2,2,2,2,2,2,111,239,227,94,212,242,139,146
],[
2,2,13,5,5,2,2,12,5,5,2,3,243,160,155,84,28,31,113,24
],[
2,2,2,5,5,2,2,2,5,5,2,3,61,177,23,83,76,137,196,234
],[
2,2,2,2,2,2,2,2,2,2,2,3,229,222,166,234,53,61,222,123
],[
2,2,2,2,2,2,2,2,2,2,2,3,22,35,205,15,123,203,142,223
],[
2,2,2,2,2,2,2,2,2,2,2,2,15,69,195,152,25,200,149,81
],[
2,2,2,2,2,2,2,2,2,2,2,2,163,73,246,193,219,76,41,175
],[
2,2,2,2,2,2,2,2,2,2,2,2,185,251,133,169,226,117,118,249
],[
2,2,2,2,2,2,2,2,2,2,3,2,205,104,196,213,36,226,24,214
],[
109,100,188,172,233,57,162,15,188,5,168,248,79,161,26,18,243,38,120,107
],[
199,72,122,112,219,230,82,24,149,222,49,95,84,38,12,246,84,25,160,57
],[
210,14,180,97,112,47,158,251,218,137,8,153,170,95,244,199,137,196,254,64
],[
151,105,225,98,14,179,61,224,34,16,152,183,43,140,162,99,5,159,189,82
],[
183,73,188,153,84,97,235,230,31,43,80,181,242,40,49,199,225,50,215,208
],[
26,200,145,113,15,166,251,101,216,152,127,255,210,145,29,212,141,247,104,181
],[
229,66,209,224,110,197,40,118,22,203,96,48,5,230,147,78,200,132,69,209
],[
175,195,237,234,115,135,178,178,28,201,114,27,34,50,8,39,211,232,207,88
],[
244,168,98,103,171,21,166,57,157,79,11,14,83,200,14,252,226,83,3,156
],[
203,126,17,3,32,34,126,243,232,56,44,83,197,238,100,221,212,251,211,23
],[
213,47,210,132,140,78,235,27,102,30,152,248,96,191,77,82,37,59,185,173
]
]