aLevelData = [
[
4,2,5,5,2,2,2,251,34,115,32,107,0,145,221,45,18,153,79,125
],[
2,2,2,2,2,2,5,113,206,248,229,81,37,80,14,134,177,102,215,72
],[
2,2,2,2,2,2,3,95,202,164,51,227,171,248,145,242,61,71,220,178
],[
3,3,3,3,3,3,3,93,5,127,111,120,3,221,143,169,251,148,200,33
],[
2,2,3,2,2,2,2,106,3,144,204,157,10,213,50,15,16,239,155,242
],[
13,2,3,2,2,2,2,75,211,118,12,59,137,251,196,120,224,16,125,174
],[
2,5,3,2,2,2,2,96,105,34,230,128,244,2,7,25,116,223,156,27
],[
2,12,3,2,2,2,2,107,65,215,127,62,16,214,124,148,98,38,254,255
],[
5,2,3,3,3,3,3,146,134,84,222,146,237,40,130,130,206,181,143,129
],[
11,2,3,2,2,2,2,154,52,165,195,135,151,64,227,144,122,221,123,188
],[
2,5,3,2,2,2,2,87,95,243,164,249,176,150,47,51,171,235,161,209
],[
2,10,3,2,2,2,2,58,66,212,207,187,141,196,201,169,113,82,179,120
],[
5,2,2,2,2,2,2,157,65,202,192,91,133,202,158,100,189,98,88,249
],[
2,2,2,2,2,2,2,254,229,63,47,210,66,218,139,128,54,64,206,142
],[
192,198,18,133,214,218,22,244,86,47,215,183,63,27,96,121,33,61,226,120
],[
210,98,7,136,99,169,132,91,82,230,238,255,1,69,206,168,103,48,247,176
],[
6,114,23,220,29,156,141,225,30,167,122,39,98,220,27,204,28,241,86,236
],[
140,117,146,32,117,110,204,68,208,64,231,126,194,208,68,123,204,234,147,252
],[
66,224,233,146,254,116,18,165,85,248,40,187,74,180,100,247,2,136,53,224
],[
120,211,143,101,114,147,134,29,180,205,27,211,115,47,86,65,12,244,149,28
]
]