aLevelData = [
[
2,2,2,2,229,250,164,22,222,223,191,168,191,179,30,58,59,234,179,9
],[
2,2,2,2,105,209,235,218,199,125,213,145,127,1,135,0,233,229,190,253
],[
2,2,2,2,80,211,196,183,249,146,151,74,97,57,71,144,199,156,160,58
],[
2,2,2,3,234,11,9,32,20,60,172,214,87,133,215,128,23,78,162,231
],[
2,2,2,2,201,199,211,204,249,214,254,124,146,84,241,164,90,120,79,103
],[
2,2,2,2,188,147,122,174,202,254,182,191,130,81,140,18,80,214,109,95
],[
213,62,152,252,231,146,62,102,217,108,227,30,252,102,7,182,101,211,6,43
],[
241,173,61,117,135,207,110,93,157,100,101,143,254,160,220,240,202,174,157,49
],[
190,233,230,165,181,78,17,79,111,49,116,64,146,48,135,32,238,102,68,10
],[
5,225,212,157,203,85,103,79,170,17,100,5,201,51,194,225,142,24,181,91
],[
98,23,142,148,180,111,220,230,64,125,216,192,145,51,0,177,196,197,1,194
],[
144,165,218,9,131,178,63,123,142,173,59,2,196,236,26,208,95,82,134,242
],[
4,126,240,40,72,67,50,244,114,88,114,241,130,81,73,102,115,206,36,27
],[
190,243,235,107,31,24,225,155,155,193,204,106,194,208,85,233,50,249,177,141
],[
92,119,129,131,139,253,247,67,34,240,59,104,36,211,13,191,250,3,171,158
],[
113,164,245,119,3,219,207,172,87,61,199,165,11,136,248,33,176,145,45,201
],[
22,126,74,11,202,53,232,37,222,21,64,128,232,227,74,64,77,7,38,25
],[
192,248,186,100,5,245,157,114,251,246,51,32,217,226,26,171,184,2,197,198
],[
82,182,103,234,9,102,19,238,43,188,33,215,116,16,211,241,212,36,57,31
],[
115,18,81,111,243,130,115,241,245,32,236,202,222,78,234,132,219,21,152,168
]
]