aLevelData = [
[
2,32,67,57,233,16,41,166,132,216,67,64,63,84,15,93,161,56,126,251
],[
2,75,247,74,185,230,228,138,38,90,151,132,62,64,147,194,50,155,38,104
],[
2,104,194,144,196,195,161,103,39,36,33,57,243,49,229,116,246,85,55,131
],[
2,246,7,66,58,141,80,129,116,56,135,119,250,170,96,161,167,102,37,169
],[
2,202,140,66,220,204,243,7,222,19,121,170,156,37,151,139,131,17,57,188
],[
2,240,11,204,193,231,86,152,148,7,103,80,237,189,71,231,191,185,57,166
],[
2,6,158,157,124,192,254,20,149,57,133,229,45,140,116,159,167,103,81,0
],[
2,217,14,221,22,171,163,71,164,224,164,159,199,51,181,141,217,166,160,67
],[
150,23,154,176,125,20,200,247,121,240,1,31,193,22,214,12,253,158,207,174
],[
170,30,248,120,191,195,156,20,145,160,81,85,244,69,52,109,163,148,118,96
],[
226,208,24,184,97,247,242,123,100,82,250,90,33,74,195,43,105,125,68,153
],[
139,17,219,26,118,72,146,34,29,85,160,151,32,111,51,132,168,35,108,17
],[
146,238,171,179,209,11,14,160,13,138,52,134,144,162,71,124,99,72,57,57
],[
180,0,77,131,123,244,218,235,94,67,76,184,209,155,107,33,129,10,224,191
],[
243,17,244,65,104,251,156,98,5,108,179,24,48,61,134,14,61,135,149,85
],[
74,254,152,87,103,129,193,12,251,239,65,112,99,59,13,52,219,195,226,179
],[
162,221,134,41,89,179,82,31,172,82,237,42,53,253,90,213,157,199,53,220
],[
5,97,57,155,164,48,6,197,177,162,33,89,131,195,61,210,247,11,185,159
],[
18,122,105,210,231,232,153,28,187,150,79,249,104,8,209,40,255,23,103,94
],[
177,66,98,59,240,69,93,125,209,237,195,116,181,42,146,182,40,102,94,19
]
]