aLevelData = [
[
6,2,8,2,3,60,85,173,235,212,219,110,239,51,196,230,42,212,42,26
],[
2,2,2,2,160,124,80,142,210,122,216,173,144,45,54,107,15,200,100,41
],[
2,2,3,3,59,82,215,217,78,241,179,98,162,103,59,70,195,221,139,130
],[
2,2,3,2,201,224,137,182,229,169,25,133,57,161,144,63,237,36,108,189
],[
2,2,3,2,127,133,66,141,90,83,247,80,171,219,51,95,112,238,19,181
],[
2,2,3,2,209,229,30,9,180,225,123,58,140,88,97,240,113,205,206,129
],[
2,2,3,2,118,222,124,17,55,132,17,254,177,151,149,123,87,144,42,122
],[
2,2,3,5,98,147,247,208,104,173,102,147,48,90,143,199,197,74,244,58
],[
2,2,2,2,201,100,110,173,12,12,103,52,93,161,74,224,160,74,56,154
],[
2,3,2,2,33,243,253,82,40,146,66,90,206,175,3,12,14,35,68,179
],[
2,3,2,2,31,32,0,169,1,113,99,188,87,3,57,214,116,165,165,222
],[
184,12,22,217,29,26,119,85,13,96,166,7,119,225,40,179,33,24,27,76
],[
64,61,107,93,70,197,73,167,251,40,217,11,207,230,43,171,110,204,109,77
],[
150,115,95,0,37,11,7,1,119,86,165,223,238,247,233,222,210,237,100,153
],[
92,91,61,236,13,138,37,17,68,48,140,9,16,243,21,62,67,41,72,102
],[
200,226,136,170,54,40,68,8,164,133,113,246,192,198,55,72,27,255,234,83
],[
199,207,61,83,36,229,178,10,247,195,85,170,188,194,170,245,62,87,228,163
],[
100,148,87,4,78,242,48,230,160,77,100,185,30,48,230,241,122,83,29,172
],[
105,98,149,149,252,0,245,8,46,12,49,119,186,35,0,12,47,102,145,143
],[
69,125,121,139,114,220,241,172,185,68,62,108,195,141,112,238,48,164,79,42
]
]