aLevelData = [
[
12,32,145,178,99,194,68,18,26,91,129,127,163,144,172,225,20,180,27,67
],[
2,32,59,192,226,222,114,8,131,204,110,2,10,20,66,196,73,14,118,11
],[
2,22,5,180,33,160,62,195,4,3,54,186,196,25,44,109,45,147,223,44
],[
11,166,73,153,173,89,207,108,70,148,73,188,95,111,128,254,40,176,53,190
],[
2,135,235,181,231,85,238,173,63,201,92,64,49,52,151,87,207,239,227,56
],[
2,23,146,201,91,117,103,186,120,138,31,245,229,44,195,171,31,174,237,96
],[
10,167,97,55,148,15,90,244,163,84,118,30,234,110,156,144,43,38,66,117
],[
2,50,40,51,1,185,89,143,95,138,106,19,234,227,174,154,159,30,40,228
],[
2,210,145,233,151,33,180,153,131,167,129,83,42,114,33,182,128,54,196,56
],[
9,239,66,209,190,158,180,63,106,243,233,66,180,87,56,43,189,57,224,137
],[
2,223,85,62,149,137,54,68,205,74,249,38,222,43,85,86,199,66,216,179
],[
2,60,132,115,254,72,219,57,141,55,121,100,67,179,107,153,191,45,113,109
],[
8,212,127,13,39,57,207,218,199,130,182,31,72,79,161,164,35,196,120,196
],[
2,20,57,126,196,32,50,121,99,215,145,18,178,215,10,126,38,145,216,94
],[
2,236,80,174,228,124,119,241,56,113,9,36,26,152,111,164,200,71,118,149
],[
6,34,240,152,28,12,245,124,206,20,190,192,105,85,10,245,194,154,130,235
],[
2,255,199,148,47,6,117,126,211,54,221,169,109,84,247,57,98,200,227,226
],[
2,101,9,135,253,58,86,122,219,192,167,32,89,46,227,23,180,157,83,210
],[
2,159,199,87,132,147,14,87,64,103,192,253,94,32,153,161,32,10,137,5
],[
2,150,8,184,67,190,40,200,3,240,122,90,241,121,35,211,111,135,173,96
]
]