aLevelData = [
[
10,2,2,8,2,2,2,2,2,2,2,2,2,2,2,151,171,180,252,111
],[
2,2,2,2,2,2,2,2,2,2,2,2,2,2,2,227,12,52,70,36
],[
2,2,2,2,2,2,3,3,3,3,2,2,2,2,2,57,27,134,190,158
],[
9,2,2,2,2,2,2,2,2,3,2,2,2,2,2,150,86,204,53,199
],[
3,3,3,3,3,3,3,2,2,3,2,2,2,2,2,28,175,50,38,64
],[
2,2,2,2,2,2,2,2,2,3,2,2,2,2,2,187,227,212,52,47
],[
2,2,2,2,2,2,2,2,2,3,3,2,2,2,2,219,44,177,107,79
],[
2,2,2,2,2,2,2,2,2,2,3,2,2,2,2,154,67,93,192,176
],[
2,2,2,2,2,2,2,2,2,2,3,2,2,2,2,7,61,218,118,179
],[
122,157,2,216,244,186,73,100,107,64,53,107,55,119,248,39,58,12,159,61
],[
20,111,234,65,149,122,91,125,120,83,141,238,78,147,199,144,184,168,209,220
],[
217,120,6,142,11,70,171,171,209,218,127,195,14,220,147,115,116,130,92,47
],[
62,107,7,62,34,202,12,6,129,198,6,138,226,33,194,49,158,24,150,201
],[
220,139,244,203,192,94,62,225,224,31,220,165,248,233,141,172,222,136,250,195
],[
184,221,145,120,108,132,144,221,88,181,96,136,68,104,37,222,148,189,147,146
],[
194,154,3,104,12,150,198,63,106,22,185,78,195,181,25,174,96,234,153,24
],[
161,229,178,241,239,185,59,131,241,192,57,142,3,59,248,255,228,58,91,255
],[
174,188,112,47,12,22,71,50,167,153,5,109,225,111,52,10,198,198,93,67
],[
63,49,217,221,137,74,228,242,230,157,243,244,147,193,72,239,249,200,195,14
],[
39,218,251,97,128,28,141,221,177,214,180,165,231,214,26,136,62,15,238,202
]
]