aLevelData = [
[
2,2,2,2,2,2,2,57,242,26,214,120,196,55,8,138,211,127,19,251
],[
2,2,2,2,2,2,2,7,136,74,161,116,102,126,218,140,21,207,21,147
],[
2,2,2,2,2,2,2,23,193,148,84,93,147,112,19,107,204,221,194,184
],[
2,2,2,13,2,2,2,22,175,120,83,79,29,30,204,222,197,108,82,67
],[
2,2,2,2,2,2,2,241,20,25,242,25,60,255,98,169,50,110,97,3
],[
2,2,2,2,2,2,2,91,132,170,200,109,113,185,84,222,33,222,135,157
],[
2,2,2,2,2,2,2,28,145,203,255,170,5,82,252,58,0,160,155,4
],[
2,2,2,2,2,2,2,233,74,171,238,35,253,180,172,153,193,45,44,154
],[
2,2,11,2,2,2,2,127,239,49,232,193,234,62,11,186,23,181,235,134
],[
2,2,2,2,2,2,2,173,64,158,179,152,112,127,255,39,164,128,99,5
],[
2,2,2,2,2,2,2,45,193,81,106,175,97,59,146,202,148,84,111,250
],[
245,154,155,188,30,20,144,243,118,88,27,137,75,81,14,89,33,63,54,77
],[
73,255,140,195,181,141,175,54,10,199,146,26,247,116,114,7,198,132,12,26
],[
48,153,12,153,118,199,200,213,173,152,46,85,89,84,251,48,62,127,47,187
],[
115,162,189,100,184,79,134,222,9,95,136,127,116,126,83,230,39,234,189,224
],[
205,119,215,141,27,215,32,190,165,24,248,162,247,110,87,162,225,51,190,137
],[
18,44,110,232,232,14,217,185,135,64,86,66,41,227,24,60,181,16,97,53
],[
146,96,243,51,189,178,200,154,25,40,2,79,7,115,37,30,55,81,132,89
],[
190,83,249,194,104,228,217,171,79,135,39,92,172,96,8,181,238,246,119,21
],[
9,55,58,122,17,189,21,233,7,79,61,16,243,171,15,42,50,130,2,35
]
]