aLevelData = [
[
2,2,2,64,150,245,37,95,66,20,159,166,135,52,178,90,231,225,132,151
],[
2,2,13,95,51,162,65,142,90,71,60,26,123,220,224,80,187,187,167,10
],[
2,2,2,153,56,41,214,128,226,75,84,156,6,179,224,238,117,127,113,155
],[
2,2,2,135,54,193,138,96,254,175,45,114,16,225,159,67,106,173,240,113
],[
2,2,2,195,58,189,243,196,226,3,161,117,219,52,247,246,23,139,22,111
],[
2,2,2,104,157,11,73,232,50,84,159,152,82,160,239,71,163,215,22,182
],[
2,2,2,242,90,123,249,15,140,138,32,222,145,100,23,171,86,212,203,190
],[
2,2,2,209,134,142,47,138,115,189,252,90,160,160,89,114,8,145,71,160
],[
2,2,2,214,97,104,206,216,247,18,204,49,58,162,79,78,50,19,57,27
],[
2,2,2,105,207,26,118,152,196,247,228,127,187,75,130,21,229,76,63,225
],[
2,2,2,183,111,73,168,248,46,197,72,25,9,195,228,196,203,113,65,183
],[
2,2,2,14,142,112,211,1,34,174,112,105,109,136,244,230,29,67,164,120
],[
4,2,2,196,122,186,65,136,9,183,141,29,42,250,15,240,222,146,109,165
],[
2,2,2,143,81,0,196,243,33,213,175,51,155,247,216,77,214,240,48,183
],[
2,2,2,125,141,227,69,37,226,66,76,221,142,0,8,6,64,162,59,101
],[
122,49,23,118,149,50,94,3,6,216,200,246,223,119,165,108,153,60,195,10
],[
16,28,146,148,207,10,134,187,142,109,189,55,249,209,226,22,179,220,81,84
],[
155,132,123,171,78,128,140,172,237,252,76,15,32,145,67,72,90,116,33,91
],[
95,238,93,240,4,12,27,170,54,151,83,181,62,70,48,158,67,51,182,104
],[
17,140,168,220,25,139,169,32,184,168,161,139,188,13,98,184,36,74,140,217
]
]