aLevelData = [
[
6,2,2,2,2,2,2,2,2,2,2,12,221,128,64,55,32,166,62,46
],[
2,2,2,2,2,2,2,2,2,2,2,170,254,150,67,81,148,120,246,104
],[
2,2,2,2,2,2,2,2,2,2,2,254,106,199,64,218,236,72,238,120
],[
87,118,79,211,11,73,74,198,201,138,85,124,94,229,59,41,130,63,28,247
],[
255,74,181,68,22,86,225,10,30,106,96,158,110,147,216,158,125,124,25,36
],[
72,63,165,64,244,123,112,166,181,167,228,163,238,165,40,86,154,154,162,28
],[
234,254,187,76,47,239,226,37,251,203,211,4,131,253,25,218,72,23,209,222
],[
247,34,178,127,141,49,74,157,190,61,138,248,152,44,133,233,100,51,117,80
],[
205,94,255,205,68,109,184,51,162,226,231,57,15,88,141,115,35,22,162,129
],[
76,228,162,135,112,30,72,221,211,6,153,7,58,94,37,231,81,55,138,49
],[
74,4,57,32,199,242,125,103,250,124,185,107,10,57,241,175,185,249,139,143
],[
69,17,87,50,139,243,206,186,114,2,151,189,135,164,80,249,229,152,138,67
],[
88,138,21,193,194,228,127,89,189,232,215,105,129,252,182,185,9,68,129,174
],[
113,118,232,192,163,234,178,45,50,241,189,239,134,104,64,236,58,141,84,110
],[
194,17,179,210,81,110,191,132,249,122,198,43,21,60,132,32,228,255,233,37
],[
118,166,29,84,204,63,194,85,59,219,121,212,17,156,167,50,123,15,121,123
],[
166,188,37,153,37,252,115,199,147,11,125,72,121,94,178,88,113,55,33,99
],[
140,118,245,117,242,178,59,242,200,136,236,135,87,51,39,96,106,93,190,155
],[
247,53,244,253,2,194,133,228,191,119,231,125,247,7,208,55,172,123,248,120
],[
0,129,32,142,83,7,83,232,172,8,108,134,90,166,216,174,219,122,157,225
]
]