aLevelData = [
[
12,2,2,2,2,2,2,2,2,2,2,2,196,44,10,157,17,29,245,233
],[
2,2,2,2,2,2,2,2,2,2,2,2,70,116,71,40,39,60,246,75
],[
2,2,3,3,3,3,3,3,3,3,2,3,111,142,194,223,9,250,13,144
],[
11,2,3,2,2,2,2,2,2,3,2,3,130,41,236,236,191,193,126,106
],[
2,2,3,2,2,2,2,2,2,3,2,3,235,137,125,171,180,206,18,255
],[
2,2,3,2,2,2,2,2,2,3,2,3,183,5,238,43,56,177,150,106
],[
10,2,3,2,2,2,2,2,2,2,2,2,23,135,254,177,255,208,90,55
],[
2,2,3,2,2,2,2,2,3,3,3,3,225,16,49,53,161,229,179,234
],[
2,2,3,2,2,2,2,3,2,2,2,2,15,49,76,227,24,123,121,121
],[
9,2,3,2,2,2,2,3,2,2,2,2,62,147,219,155,69,117,138,206
],[
2,2,3,2,2,2,3,2,2,2,2,2,47,112,171,113,107,136,69,70
],[
2,2,3,2,2,3,2,2,2,2,2,2,74,24,80,46,178,188,15,52
],[
8,2,3,2,2,3,2,2,2,2,2,2,22,109,160,205,165,238,210,94
],[
2,2,3,2,3,3,2,2,2,2,2,2,194,104,54,255,181,81,121,127
],[
2,2,3,2,3,2,2,2,2,2,2,2,160,145,240,168,180,232,117,196
],[
6,2,3,2,3,2,2,2,2,2,2,2,164,138,114,96,90,13,59,79
],[
234,133,161,242,196,238,196,183,45,202,40,224,240,10,11,134,80,50,246,221
],[
66,185,147,185,217,174,190,81,2,162,222,67,113,193,118,217,219,66,247,139
],[
102,2,217,197,94,107,233,234,41,155,229,152,125,194,70,46,208,204,93,139
],[
16,65,161,25,149,105,72,11,84,179,20,226,85,87,112,54,103,59,187,179
]
]