aLevelData = [
[
2,2,2,2,2,159,207,168,214,81,63,7,230,209,236,181,255,99,222,42
],[
2,2,2,2,2,2,118,150,111,35,120,151,145,147,239,37,80,92,198,77
],[
2,2,2,2,2,23,140,228,37,49,149,4,85,57,244,192,214,210,17,238
],[
2,2,2,13,2,250,153,102,48,173,88,228,199,250,125,146,168,209,202,120
],[
2,2,2,2,2,210,7,77,187,222,158,147,9,216,71,25,55,77,37,3
],[
2,2,2,2,2,41,165,212,16,243,179,170,206,61,139,60,10,236,148,36
],[
2,2,2,2,2,139,255,222,2,0,182,181,193,54,250,118,28,142,249,161
],[
2,2,2,2,2,96,175,17,48,115,120,239,39,21,56,248,109,102,34,231
],[
2,2,11,2,2,218,168,251,184,145,71,22,198,144,22,130,48,133,220,130
],[
2,2,2,2,2,128,227,15,61,143,54,223,183,163,180,119,0,219,20,127
],[
2,2,2,2,2,172,205,163,229,130,109,148,221,121,49,151,38,224,114,174
],[
2,2,2,2,2,143,220,22,60,187,23,108,95,33,183,87,128,86,141,175
],[
2,2,2,2,2,41,143,143,228,22,98,137,228,142,204,15,63,244,120,182
],[
2,2,2,2,2,137,153,62,132,1,212,235,164,111,85,64,94,83,182,61
],[
71,59,83,159,181,117,92,167,118,230,40,29,194,58,204,149,109,62,237,241
],[
97,137,210,39,76,98,189,68,150,222,124,177,150,73,59,181,5,199,156,60
],[
179,59,10,215,120,104,74,3,110,87,82,174,93,248,95,247,119,11,66,54
],[
70,65,250,60,226,159,136,220,103,36,255,170,166,171,219,2,27,19,147,76
],[
32,156,114,127,95,148,162,228,141,52,138,29,86,197,90,101,147,6,227,25
],[
195,210,173,120,185,254,67,167,146,129,210,247,234,215,242,107,80,167,196,117
]
]