aLevelData = [
[
5,5,3,5,5,5,5,5,1,119,179,83,236,99,38,153,125,195,12,16
],[
4,2,3,5,5,5,5,5,215,191,63,64,46,70,67,169,209,1,111,90
],[
2,2,3,2,3,3,3,3,103,133,77,191,120,204,67,187,48,230,114,246
],[
5,2,2,2,3,2,2,2,96,236,222,121,198,54,207,120,142,205,120,110
],[
2,2,2,3,2,2,2,2,24,35,215,112,252,2,220,186,76,195,205,143
],[
2,2,2,3,2,2,5,3,25,192,233,64,56,12,76,138,69,97,18,36
],[
2,2,2,2,2,2,5,5,233,89,191,153,89,225,223,84,31,235,233,249
],[
29,100,105,252,207,102,94,108,208,174,225,15,160,80,8,180,164,169,10,197
],[
110,150,164,28,63,227,187,23,202,7,66,239,59,14,94,69,120,214,200,254
],[
167,126,116,81,240,28,112,30,132,174,14,130,222,84,69,168,73,188,85,226
],[
162,221,170,248,95,232,3,192,208,123,211,238,165,24,231,46,177,215,74,112
],[
237,87,102,131,192,250,107,230,125,82,245,219,46,214,233,188,144,218,159,146
],[
94,190,71,228,210,101,133,205,106,232,95,81,232,140,89,241,156,242,222,125
],[
229,142,226,42,246,90,198,229,214,204,124,230,170,5,235,135,55,75,149,87
],[
163,185,119,106,123,53,48,244,251,163,102,22,137,88,102,248,130,210,10,24
],[
57,166,224,226,61,185,136,128,219,179,94,243,228,177,90,99,177,59,52,179
],[
99,117,203,89,111,153,199,109,91,164,125,255,194,80,20,174,158,67,230,118
],[
199,134,41,202,182,56,207,227,143,132,170,87,95,208,212,237,161,55,78,176
],[
8,58,231,66,120,178,96,115,85,9,205,18,1,170,62,4,160,182,159,146
],[
31,249,221,7,116,28,75,123,39,28,67,234,17,251,16,137,100,181,11,89
]
]