aLevelData = [
[
2,2,2,2,2,2,2,2,2,6,5,2,2,2,17,116,24,117,111,129
],[
2,3,5,3,5,5,5,3,5,3,5,2,5,3,185,119,254,90,226,36
],[
2,3,2,3,2,2,2,3,5,3,5,2,5,3,185,25,16,154,159,215
],[
2,2,2,2,2,2,2,2,2,2,2,2,5,5,201,209,17,125,37,21
],[
2,3,5,3,5,5,5,3,2,3,5,5,5,3,123,215,141,186,54,234
],[
2,3,5,3,5,5,5,3,2,3,5,5,5,3,195,11,173,136,34,131
],[
2,5,5,5,5,5,5,5,5,5,5,5,5,2,191,33,40,64,101,220
],[
2,3,5,3,5,5,5,3,5,3,5,5,5,3,49,180,149,230,133,158
],[
2,3,5,3,5,5,5,3,5,3,5,5,5,3,102,10,149,56,116,131
],[
2,5,5,5,5,5,5,5,5,5,5,5,5,5,130,178,134,14,223,224
],[
2,3,5,3,2,2,2,3,2,3,2,2,2,3,110,67,184,48,49,36
],[
5,3,5,3,2,2,2,3,2,3,2,2,2,3,211,222,104,247,53,107
],[
5,5,5,5,5,5,5,5,5,5,5,5,5,5,230,81,232,75,155,116
],[
5,3,5,3,5,5,5,3,5,3,5,5,2,3,252,222,184,218,204,161
],[
5,3,5,3,5,5,5,3,5,3,5,5,2,3,20,18,131,166,207,203
],[
1,5,5,5,5,5,5,5,5,5,5,5,5,5,222,65,53,47,51,5
],[
229,114,178,238,50,170,235,224,201,225,144,80,148,104,124,65,223,111,245,115
],[
186,211,46,215,158,55,16,69,83,86,58,113,16,151,71,28,229,227,79,135
],[
86,179,176,45,73,109,14,177,34,240,152,22,44,109,141,46,59,122,255,85
],[
143,97,216,95,252,190,26,206,72,73,107,72,213,240,208,73,127,41,185,22
]
]