aLevelData = [
[
2,2,2,2,5,5,2,2,248,29,208,197,108,212,174,93,75,127,32,241
],[
2,2,2,4,2,2,2,2,14,249,160,230,18,134,117,52,1,113,205,36
],[
5,3,3,3,5,5,3,3,141,243,11,88,101,87,98,11,97,92,163,154
],[
2,3,2,2,2,2,2,2,0,219,83,67,21,169,1,45,189,191,214,169
],[
2,3,2,2,2,2,2,2,148,152,110,184,41,219,230,205,175,58,55,212
],[
2,3,2,2,3,2,2,2,245,154,194,114,152,116,44,143,119,123,107,18
],[
2,3,2,2,3,2,2,2,103,127,33,235,40,145,41,87,152,104,112,95
],[
2,3,2,2,3,5,5,3,39,3,7,162,139,144,118,85,181,141,82,136
],[
2,3,3,2,3,2,2,3,3,45,18,171,183,253,30,80,168,199,41,51
],[
2,2,3,2,3,2,2,3,55,182,193,119,133,188,36,50,227,49,86,44
],[
2,2,3,2,3,2,2,3,138,189,112,228,141,119,59,212,11,78,253,246
],[
2,2,3,2,3,2,2,3,169,169,147,135,63,74,192,11,210,120,197,145
],[
2,2,2,2,3,2,2,3,195,93,50,56,69,173,251,242,20,136,206,136
],[
2,2,2,2,3,2,2,3,101,162,164,223,24,161,151,121,53,198,243,62
],[
2,2,2,2,3,2,2,3,150,208,143,125,225,29,94,46,186,19,65,122
],[
6,2,2,2,3,2,2,3,54,190,31,125,146,186,56,74,37,84,182,47
],[
147,236,133,59,68,158,101,254,20,33,62,144,76,238,179,213,210,165,249,254
],[
156,173,234,83,106,27,85,48,181,214,153,78,226,248,114,68,188,119,18,78
],[
33,4,116,76,251,51,237,14,115,221,4,206,97,195,131,254,6,115,206,69
],[
253,112,116,196,111,141,4,157,135,154,34,182,37,66,217,186,215,52,51,97
]
]