aLevelData = [
[
12,2,2,2,2,2,176,249,100,1,123,74,148,66,135,247,91,193,203,43
],[
9,33,174,187,233,18,111,0,195,199,196,229,165,169,193,63,227,77,252,93
],[
93,163,239,224,0,113,157,205,144,0,121,225,164,22,131,37,242,35,180,194
],[
204,191,156,21,235,84,74,6,108,24,108,150,24,63,183,184,232,110,137,98
],[
200,114,205,227,156,50,32,119,129,226,49,25,85,122,110,152,121,103,221,237
],[
213,128,71,204,29,59,156,121,83,33,147,221,142,127,145,217,249,95,204,218
],[
30,182,176,174,101,223,130,150,215,72,67,156,40,108,215,38,245,1,102,204
],[
74,114,3,103,103,143,139,106,196,132,208,118,82,7,247,40,4,214,31,54
],[
142,97,68,186,109,195,98,205,39,247,221,88,212,73,32,39,221,10,132,63
],[
4,136,116,114,164,62,208,48,58,71,142,160,37,25,167,239,170,111,49,233
],[
59,135,200,198,249,142,51,70,119,89,69,0,193,85,0,246,157,193,1,110
],[
16,26,24,253,36,215,54,229,233,87,140,161,186,24,241,189,193,41,132,235
],[
190,226,147,84,3,210,188,44,195,249,82,137,141,55,3,117,20,5,183,65
],[
49,99,186,29,43,17,30,230,53,2,91,63,56,14,57,227,211,231,240,58
],[
161,78,141,42,186,135,151,47,124,10,243,174,139,123,5,134,22,220,24,233
],[
92,2,0,106,111,69,253,86,56,124,227,72,188,41,120,248,157,240,30,84
],[
228,78,178,210,253,135,179,4,3,224,167,109,63,15,186,147,235,240,169,85
],[
59,121,222,127,158,240,221,156,65,91,222,11,212,57,187,85,146,111,13,190
],[
123,133,146,26,228,18,211,226,50,117,3,135,227,198,41,6,206,13,130,189
],[
171,177,32,125,213,51,216,224,79,27,91,221,5,51,163,153,85,244,145,128
]
]