aLevelData = [
[
2,2,2,2,2,11,2,2,2,2,2,2,205,56,3,175,242,6,29,17
],[
2,2,2,2,2,2,2,2,2,2,2,2,0,128,8,139,30,192,192,59
],[
5,2,5,2,5,5,5,2,5,5,5,2,196,232,46,117,198,23,78,91
],[
142,149,141,173,168,81,117,226,133,142,139,119,120,217,120,135,5,62,104,156
],[
91,187,176,197,31,245,179,232,107,42,6,90,23,103,210,173,55,251,122,201
],[
228,43,126,62,64,39,160,217,180,61,69,118,124,77,29,20,102,125,6,47
],[
214,45,46,74,14,46,120,203,172,46,34,11,116,119,164,174,80,218,219,48
],[
149,229,102,193,136,93,81,83,33,232,240,241,15,9,14,82,251,81,72,174
],[
17,212,179,208,189,219,197,109,178,216,114,180,49,159,149,38,136,210,146,168
],[
217,157,57,214,28,164,238,155,103,58,7,254,109,212,118,63,70,189,168,35
],[
110,11,173,140,15,209,152,76,131,150,41,59,20,6,169,136,7,232,22,76
],[
218,80,128,101,201,22,179,129,151,134,22,121,138,89,211,225,184,229,56,221
],[
129,144,94,53,93,138,8,172,216,188,205,142,218,251,122,137,44,130,178,189
],[
56,159,215,22,16,172,46,218,178,65,61,126,139,168,120,190,57,145,29,237
],[
149,7,93,137,241,163,188,18,158,0,186,28,178,110,179,164,7,235,4,160
],[
135,79,111,217,167,198,193,253,50,131,177,240,72,179,12,100,166,176,15,169
],[
40,120,20,198,139,93,114,200,120,254,158,90,190,117,150,150,224,210,127,27
],[
207,201,140,96,248,167,35,72,129,138,59,246,208,210,9,226,78,211,219,44
],[
106,204,68,49,224,29,121,93,59,180,251,64,152,201,118,227,174,203,233,92
],[
11,154,8,160,160,246,223,153,128,56,183,120,229,63,61,77,116,174,225,212
]
]