aLevelData = [
[
4,61,119,182,231,122,131,143,159,192,157,185,254,85,8,56,128,19,72,82
],[
5,228,11,51,82,223,110,75,134,17,174,75,138,56,224,0,200,164,101,90
],[
2,64,235,201,195,133,221,235,175,8,186,94,117,153,163,16,93,43,79,41
],[
3,250,216,255,54,186,37,180,135,187,134,159,213,224,37,217,41,37,223,84
],[
2,248,47,143,18,147,40,144,148,191,201,125,150,159,184,59,249,219,21,58
],[
3,1,251,79,247,192,20,61,198,210,167,106,206,75,198,176,85,238,120,8
],[
62,160,95,160,207,28,152,46,184,231,227,133,81,135,4,101,36,240,105,152
],[
171,63,12,58,91,170,155,89,225,183,215,190,171,173,58,9,170,72,220,4
],[
86,177,151,49,243,173,105,165,19,21,27,25,93,134,32,63,140,89,192,82
],[
187,214,118,241,223,164,150,45,149,132,50,225,30,64,63,66,167,221,244,182
],[
206,24,115,234,99,17,171,30,107,65,125,196,107,177,29,74,227,110,188,52
],[
24,56,100,109,22,122,35,223,246,127,107,65,93,226,185,48,69,70,117,130
],[
0,72,25,215,121,178,150,112,190,241,244,69,187,202,56,81,72,72,138,49
],[
103,249,151,237,198,90,53,22,140,143,69,17,82,87,222,178,110,64,168,13
],[
120,23,133,136,7,163,119,53,188,147,190,95,130,180,64,99,19,103,46,193
],[
191,83,229,115,105,87,18,126,210,194,26,198,26,199,185,38,131,43,233,192
],[
121,65,5,146,207,24,46,75,76,243,238,92,102,249,27,81,77,46,254,98
],[
43,162,181,69,170,233,214,71,184,202,85,155,135,59,168,242,215,142,40,76
],[
119,229,187,13,9,235,176,83,7,198,234,135,3,71,65,50,51,100,37,18
],[
44,233,132,110,238,106,238,166,33,124,248,14,158,37,222,252,49,144,108,32
]
]