aLevelData = [
[
6,2,184,77,145,171,218,76,167,114,176,136,252,153,3,117,192,229,147,162
],[
2,2,220,237,175,247,37,123,4,59,214,53,179,216,61,125,166,227,180,149
],[
2,2,35,87,211,7,161,161,228,68,219,98,151,139,36,112,248,12,250,30
],[
2,2,157,78,221,189,36,206,98,98,221,233,131,234,195,251,57,60,177,201
],[
2,2,77,206,210,28,106,107,90,175,120,51,115,75,37,227,122,49,196,86
],[
2,2,108,184,91,76,155,55,247,107,166,37,67,131,167,127,89,22,174,106
],[
2,2,216,24,111,26,55,243,55,242,89,206,37,237,97,15,150,60,199,30
],[
2,2,225,49,172,108,69,91,106,181,31,243,112,130,96,118,77,241,63,148
],[
2,2,10,184,43,73,189,104,4,74,91,239,138,162,206,97,22,157,71,248
],[
2,3,136,229,214,89,128,235,56,24,209,136,240,127,50,229,153,139,55,152
],[
2,3,122,56,128,15,91,254,49,50,151,156,161,68,115,20,87,10,174,247
],[
2,3,50,48,89,226,231,232,233,73,177,212,139,115,67,38,183,198,2,6
],[
8,69,113,52,75,87,236,238,214,202,154,20,27,23,157,138,124,232,139,222
],[
97,215,34,42,136,121,55,60,157,155,240,245,11,203,51,239,17,27,94,98
],[
24,33,57,73,68,66,41,192,73,49,166,177,128,178,238,175,58,164,251,34
],[
84,62,179,165,11,153,96,172,18,110,95,106,226,34,28,242,82,255,62,156
],[
103,197,30,170,109,97,126,43,70,252,120,32,3,55,180,222,177,181,222,179
],[
117,219,87,204,220,211,43,86,108,215,68,228,127,172,221,17,81,108,57,102
],[
87,137,148,126,210,15,90,103,165,41,151,76,99,231,174,81,173,62,79,191
],[
187,81,163,97,56,238,201,46,83,92,134,39,19,84,56,131,234,77,12,10
]
]