aLevelData = [
[
4,2,2,2,148,41,60,60,131,11,200,67,168,42,6,250,112,75,116,118
],[
5,2,5,3,234,82,60,202,44,17,182,126,243,94,45,60,137,104,230,203
],[
2,5,5,3,236,75,94,66,44,225,212,117,21,219,7,180,14,17,65,181
],[
3,3,5,5,65,23,148,206,252,17,100,103,87,200,38,176,24,253,102,143
],[
2,3,5,5,211,253,15,221,86,117,231,209,68,136,89,188,255,31,119,247
],[
203,128,63,26,49,35,29,111,162,192,178,167,93,173,212,203,147,103,214,117
],[
200,111,9,63,124,87,130,124,11,28,30,38,210,182,196,24,147,238,234,125
],[
26,112,91,137,33,33,55,103,114,178,59,114,75,118,66,167,6,112,12,90
],[
249,177,63,41,156,225,171,47,233,27,210,122,9,254,168,190,44,0,151,74
],[
185,6,198,60,167,50,155,241,42,252,127,192,147,133,225,232,113,39,125,198
],[
253,81,222,76,181,146,33,174,70,243,253,94,175,138,0,59,164,76,27,6
],[
48,35,97,21,159,65,12,75,155,179,193,71,149,57,21,220,103,85,79,193
],[
55,162,111,138,158,103,112,215,9,108,203,204,96,12,60,193,230,140,200,58
],[
97,171,255,25,122,122,127,18,102,110,185,96,198,180,248,182,204,196,159,121
],[
160,57,177,44,2,224,151,44,48,15,30,157,10,56,192,164,116,189,36,214
],[
252,6,232,241,189,210,157,202,130,202,19,135,47,92,215,14,93,198,251,190
],[
69,113,21,92,223,129,138,80,75,170,13,17,111,69,98,222,226,163,104,175
],[
8,161,86,107,127,124,69,91,186,231,239,223,236,91,182,95,40,175,232,133
],[
198,232,65,169,8,82,177,141,254,208,96,75,166,112,240,139,88,66,2,249
],[
97,107,251,247,239,117,8,142,45,233,95,171,174,32,200,136,15,86,92,104
]
]