aLevelData = [
[
2,2,2,2,5,5,2,2,2,2,2,2,2,2,2,226,29,97,231,208
],[
2,2,2,4,2,2,2,2,2,2,2,5,2,2,2,85,251,153,121,94
],[
5,3,3,3,5,5,3,3,3,3,3,3,3,3,3,15,12,89,89,145
],[
114,166,50,9,64,213,24,60,61,96,48,8,217,199,138,144,193,213,84,153
],[
176,36,77,52,136,227,125,158,161,215,36,100,97,160,240,202,13,62,114,110
],[
222,211,211,41,88,170,195,54,215,121,179,150,107,227,68,178,229,65,255,67
],[
50,162,70,111,232,16,138,52,31,22,191,10,130,127,13,196,166,95,201,184
],[
154,88,163,31,191,22,33,191,217,28,76,199,103,195,169,250,48,127,106,15
],[
31,101,230,88,80,234,71,163,107,238,130,94,49,249,141,254,84,196,204,161
],[
140,251,204,241,231,65,51,76,97,117,247,35,180,51,207,160,113,158,231,140
],[
80,93,216,111,196,228,215,249,211,245,44,160,37,102,231,139,91,36,206,175
],[
162,120,153,56,135,137,98,42,13,35,87,72,252,182,178,53,125,162,235,217
],[
228,177,43,6,205,229,5,91,106,117,97,105,27,18,184,21,63,110,135,61
],[
75,255,253,159,25,1,247,246,130,186,47,101,46,1,176,25,171,1,142,43
],[
189,59,211,195,245,202,188,131,133,235,38,35,83,188,67,88,76,68,145,251
],[
251,180,13,103,90,236,164,35,232,65,234,193,251,126,14,5,88,40,14,74
],[
1,7,39,34,78,225,144,61,63,137,103,140,17,25,236,165,15,123,237,106
],[
171,46,129,229,205,70,249,119,107,181,20,50,90,202,114,131,100,247,75,20
],[
154,215,97,240,235,111,51,233,246,181,116,55,29,78,187,97,219,156,124,97
],[
87,248,55,3,57,60,239,142,188,133,222,166,4,55,103,113,179,65,76,249
]
]