aLevelData = [
[
12,2,2,2,2,2,32,28,49,74,166,140,24,44,114,14,39,131,39,2
],[
2,2,2,2,2,2,77,77,87,9,182,214,174,106,158,57,109,180,104,36
],[
2,2,3,3,3,3,26,165,234,219,118,75,12,128,176,105,145,145,216,28
],[
11,2,3,2,2,2,52,178,150,190,247,173,28,11,184,183,89,130,5,245
],[
2,2,3,2,2,2,112,14,49,62,104,230,167,35,37,178,127,44,151,239
],[
2,2,3,2,2,2,79,101,49,148,68,25,157,246,113,222,174,233,102,209
],[
10,2,3,2,2,2,150,40,5,35,89,247,145,213,129,6,8,191,20,153
],[
2,2,3,2,2,2,179,215,195,230,251,176,100,190,126,65,162,112,98,232
],[
2,2,3,2,2,2,243,235,233,175,203,34,70,205,16,181,176,112,205,205
],[
9,2,3,2,2,2,180,185,42,71,207,8,156,22,60,123,89,226,11,177
],[
15,245,115,212,213,88,105,214,98,57,113,250,124,144,181,151,180,3,84,25
],[
81,6,252,72,138,70,187,205,248,72,18,241,74,77,76,169,59,122,13,208
],[
193,53,46,179,135,210,200,210,158,111,143,229,112,28,98,30,245,64,32,174
],[
41,56,188,138,189,64,148,111,12,151,254,35,82,222,36,255,24,193,19,170
],[
243,218,14,39,110,210,40,18,69,202,18,38,212,249,49,3,206,150,243,46
],[
50,248,100,90,123,252,252,230,24,167,187,166,27,12,121,230,53,112,119,172
],[
226,173,57,62,225,212,152,228,231,22,19,239,148,229,102,250,166,86,94,112
],[
109,202,235,79,127,205,119,43,172,62,118,117,52,177,62,253,56,17,25,182
],[
111,138,153,185,26,165,44,141,58,181,240,166,0,115,201,43,133,229,176,253
],[
187,132,78,244,164,157,201,108,193,248,222,0,206,184,48,149,172,130,223,155
]
]