aLevelData = [
[
2,2,2,2,2,2,2,212,97,235,108,124,197,232,53,28,48,12,225,22
],[
2,3,5,3,5,5,5,135,115,167,20,225,170,112,167,152,114,142,47,161
],[
2,3,2,3,2,2,2,193,171,250,24,10,255,176,31,190,199,238,233,19
],[
2,2,2,2,2,2,2,242,49,18,4,29,246,50,153,193,31,177,104,171
],[
2,3,5,3,5,5,5,153,221,92,173,60,57,181,148,242,24,80,89,28
],[
2,3,5,3,5,5,5,107,41,156,49,216,30,77,168,12,246,173,25,81
],[
161,117,159,99,193,84,128,127,106,159,16,190,38,69,210,161,61,1,225,237
],[
51,211,142,185,145,176,75,197,233,121,200,13,20,42,91,158,190,84,165,169
],[
37,205,115,214,29,165,226,218,88,93,199,76,228,84,77,180,245,130,224,230
],[
229,104,74,142,121,71,28,11,102,145,80,129,19,157,44,41,161,158,106,236
],[
41,214,149,49,68,7,182,243,209,43,48,22,242,100,233,251,88,54,170,82
],[
193,244,201,47,190,120,5,96,186,23,177,255,56,213,21,67,92,212,17,155
],[
173,19,3,254,25,85,235,124,58,94,205,26,215,101,87,220,174,199,196,35
],[
112,249,0,57,14,192,13,43,51,164,165,215,17,162,33,69,97,33,153,59
],[
165,39,77,11,177,205,67,176,105,240,50,25,204,42,159,197,50,0,70,144
],[
209,93,187,205,134,64,81,148,211,177,59,93,36,249,241,206,86,18,214,210
],[
121,93,23,235,213,147,214,201,44,254,136,27,63,233,155,165,147,85,92,147
],[
117,237,25,13,60,60,130,11,206,30,85,107,102,116,59,65,148,28,237,110
],[
133,33,154,116,132,46,141,136,193,73,11,233,81,189,122,113,119,88,201,105
],[
34,215,11,162,182,159,101,193,15,174,43,219,196,208,70,66,168,22,217,158
]
]