aLevelData = [
[
12,2,2,2,2,2,2,2,2,2,2,2,2,2,66,86,35,19,238,75
],[
2,2,2,2,2,2,2,2,2,2,2,2,13,2,152,243,208,94,116,104
],[
2,2,3,3,3,3,3,3,3,3,2,3,3,3,152,208,251,113,215,64
],[
11,2,3,2,2,2,2,2,2,3,2,3,2,3,105,51,180,134,62,246
],[
2,2,3,2,2,2,2,2,2,3,2,3,2,3,224,224,218,113,204,76
],[
2,2,3,2,2,2,2,2,2,3,2,3,2,3,73,71,25,52,96,209
],[
10,2,3,2,2,2,2,2,2,2,2,2,2,2,80,80,9,30,211,201
],[
2,2,3,2,2,2,2,2,3,3,3,3,3,2,219,56,19,154,238,169
],[
2,2,3,2,2,2,2,3,2,2,2,2,1,3,4,60,237,62,206,130
],[
9,2,3,2,2,2,2,3,2,2,2,2,2,2,108,11,198,194,124,175
],[
2,2,3,2,2,2,3,2,2,2,2,2,2,2,156,53,125,218,213,160
],[
2,2,3,2,2,3,2,2,2,2,2,2,2,2,52,12,124,52,30,159
],[
8,2,3,2,2,3,2,2,2,2,2,2,2,2,21,179,3,7,211,213
],[
2,2,3,2,3,3,2,2,2,2,2,2,2,2,205,89,11,234,155,10
],[
2,2,3,2,3,2,2,2,2,2,2,2,2,2,231,192,18,249,95,199
],[
6,2,3,2,3,2,2,2,2,2,2,2,2,2,243,176,101,115,243,231
],[
2,2,3,3,3,2,2,2,2,2,2,3,3,3,96,226,199,74,220,191
],[
2,2,2,2,2,2,2,3,3,3,3,2,2,2,126,125,128,102,19,92
],[
64,73,67,135,212,146,156,30,104,10,215,201,149,57,103,252,144,207,82,121
],[
161,66,64,22,215,185,209,192,251,41,52,192,194,189,246,61,70,124,23,2
]
]