aLevelData = [
[
2,2,2,2,2,2,2,47,19,84,119,72,90,4,24,148,40,201,127,128
],[
2,2,2,2,2,2,2,63,42,165,111,143,42,21,20,7,202,88,30,172
],[
2,2,2,2,2,2,2,208,176,27,232,199,9,150,36,71,44,131,153,118
],[
2,2,2,3,3,3,3,54,222,98,207,72,142,214,34,129,143,22,220,41
],[
2,2,2,2,2,2,2,80,226,137,47,90,177,151,214,51,0,93,171,130
],[
2,2,2,2,2,2,2,234,92,186,115,249,196,1,93,60,58,37,163,153
],[
2,2,2,2,2,3,2,216,100,216,101,117,203,38,50,39,169,240,232,7
],[
2,2,2,3,3,3,3,67,182,24,52,201,57,140,27,137,224,35,245,99
],[
2,2,2,2,2,2,2,91,220,144,125,134,48,83,56,144,165,125,98,92
],[
2,2,2,2,2,2,2,160,173,173,39,122,167,95,108,215,85,76,4,51
],[
2,2,3,3,3,3,3,12,1,146,190,17,67,30,106,92,184,0,66,155
],[
2,2,2,2,2,2,2,227,0,253,122,86,187,211,34,34,73,143,255,147
],[
2,2,2,2,2,2,2,28,230,199,26,43,7,184,139,80,115,33,136,239
],[
2,2,3,3,3,3,3,15,35,61,217,119,185,79,112,150,246,14,11,116
],[
142,242,156,78,152,69,144,236,146,29,246,47,166,141,228,234,43,28,22,242
],[
111,118,217,121,180,98,39,151,120,244,20,42,250,4,105,224,249,223,142,146
],[
191,59,173,212,94,113,20,202,58,230,219,61,199,202,199,237,148,6,111,41
],[
137,111,157,158,109,64,247,109,170,199,223,128,85,94,151,29,105,157,169,187
],[
83,206,134,21,180,161,109,126,98,34,142,116,176,231,112,119,239,142,144,28
],[
52,103,75,93,92,109,253,51,78,123,107,103,128,188,94,164,189,100,145,210
]
]