aLevelData = [
[
6,2,2,2,2,2,2,2,2,2,2,132,191,139,98,25,107,127,214,11
],[
2,2,2,2,2,2,2,2,2,2,2,238,41,126,98,66,106,70,169,209
],[
2,2,2,2,2,2,2,2,2,2,2,211,12,150,138,103,84,237,51,162
],[
3,3,3,3,3,3,3,3,3,3,3,62,161,1,186,182,60,102,36,235
],[
2,2,2,2,2,2,2,2,2,2,2,130,42,90,2,81,189,220,11,204
],[
2,2,2,2,2,2,2,2,2,2,2,204,116,52,185,18,191,60,38,113
],[
2,2,2,2,2,3,2,2,3,2,2,233,43,83,65,184,65,204,232,204
],[
2,2,3,3,3,3,3,3,3,3,3,44,214,170,37,126,12,195,229,93
],[
2,2,2,2,2,2,2,2,2,2,2,74,179,87,124,202,218,49,75,141
],[
2,2,2,2,2,2,2,2,2,4,2,68,22,107,253,198,95,101,208,74
],[
3,3,3,3,3,3,3,3,3,3,3,27,155,47,103,84,127,24,53,149
],[
2,2,2,2,2,2,2,2,2,2,2,2,1,95,168,80,190,121,164,186
],[
2,2,2,2,2,2,2,2,2,2,2,164,148,40,243,239,16,225,128,97
],[
2,2,3,3,3,3,3,3,3,3,2,178,82,106,44,246,212,54,18,167
],[
219,22,203,172,124,97,167,37,44,65,116,183,203,172,162,35,225,149,165,30
],[
39,99,155,93,73,162,47,239,234,248,189,207,232,91,183,186,226,130,71,62
],[
248,153,53,20,210,57,12,175,228,151,120,21,240,252,243,238,204,117,160,218
],[
101,203,119,8,4,181,163,5,208,77,40,209,149,193,201,56,195,75,41,95
],[
186,99,48,158,68,51,176,141,99,75,73,98,78,150,138,122,182,140,88,53
],[
77,170,148,7,137,31,248,204,165,201,66,92,234,95,149,96,44,240,28,100
]
]