aLevelData = [
[
2,2,2,2,187,75,191,230,27,237,214,237,99,63,161,135,221,51,219,217
],[
2,2,2,4,48,167,122,73,50,231,42,43,253,116,249,157,69,4,84,175
],[
5,3,3,3,233,201,50,200,199,246,143,69,213,128,28,98,110,33,53,94
],[
2,3,2,2,233,163,19,218,112,91,67,131,15,244,86,240,12,110,219,205
],[
2,3,2,2,119,101,138,58,1,151,194,110,18,161,54,160,21,9,227,39
],[
23,129,69,224,144,106,202,208,128,152,135,10,190,85,41,211,141,168,47,5
],[
113,215,87,177,65,42,86,8,124,242,204,124,224,202,119,34,57,29,167,91
],[
120,232,242,179,4,193,40,9,85,25,138,241,190,190,54,86,138,163,230,100
],[
75,228,218,164,111,5,19,105,20,123,194,108,30,109,0,179,134,187,191,183
],[
244,64,1,197,145,84,72,165,22,149,77,122,42,232,244,233,234,186,128,125
],[
201,140,3,74,154,174,25,209,235,74,214,36,149,165,253,75,145,162,115,229
],[
13,136,243,18,191,4,2,145,122,114,38,38,255,88,83,63,21,51,166,214
],[
220,119,86,153,94,209,231,73,103,175,160,96,151,2,64,246,181,66,237,229
],[
70,179,109,44,94,232,152,145,183,133,13,139,0,73,37,94,119,75,37,136
],[
186,131,184,92,218,141,156,237,178,170,155,45,119,8,189,86,144,67,188,137
],[
167,43,184,181,0,200,44,187,9,155,33,208,51,39,161,34,1,176,111,190
],[
94,67,245,177,52,246,126,109,58,113,165,111,14,173,13,31,131,252,83,248
],[
60,74,65,232,122,162,69,250,50,244,33,50,99,21,227,184,166,7,24,58
],[
7,123,61,139,19,148,118,144,50,238,131,92,55,223,239,154,54,252,138,43
],[
149,223,26,17,102,40,78,140,244,194,243,130,156,104,106,36,223,103,90,207
]
]