aLevelData = [
[
2,2,2,2,2,11,2,2,2,2,2,2,2,2,9,2,2,2,2,240
],[
2,2,2,2,2,2,2,2,2,2,2,2,2,2,2,2,2,2,2,51
],[
5,2,5,2,5,5,5,2,5,5,5,2,5,5,5,2,5,2,5,90
],[
133,211,108,70,57,137,14,83,117,238,210,104,80,75,49,43,174,134,201,206
],[
193,149,2,43,207,56,241,20,53,232,125,228,172,10,192,90,203,105,176,168
],[
205,227,254,198,149,99,62,12,239,15,73,0,25,194,223,109,130,188,145,181
],[
209,152,222,103,41,127,157,20,171,156,155,95,61,207,132,84,138,166,7,251
],[
74,137,53,44,196,52,42,164,145,107,240,89,162,232,160,11,133,153,202,28
],[
227,8,23,161,78,27,45,185,57,253,211,30,72,92,86,249,203,213,43,251
],[
133,172,213,169,177,193,10,247,71,191,17,25,123,151,110,150,134,45,193,158
],[
170,80,236,157,112,240,116,16,53,139,42,152,228,233,10,76,5,9,99,84
],[
247,91,56,180,121,48,230,101,112,110,8,170,228,136,152,161,75,173,87,24
],[
10,64,110,163,57,137,85,235,166,170,244,73,29,212,8,148,231,186,201,55
],[
145,70,202,134,239,139,32,82,95,252,198,186,82,219,64,69,9,244,127,46
],[
157,138,5,255,66,146,73,97,204,31,93,51,115,30,206,217,211,67,204,215
],[
55,67,138,158,22,68,232,165,222,145,80,188,241,147,221,158,237,253,195,197
],[
49,70,235,130,157,92,221,76,152,151,227,89,88,235,107,107,94,99,174,237
],[
63,202,143,62,170,171,198,77,167,125,61,102,29,23,186,75,151,106,191,135
],[
71,110,175,255,76,93,49,202,48,32,217,66,181,6,6,91,209,188,6,52
],[
247,122,129,236,152,122,20,183,234,174,60,49,232,178,118,242,154,0,164,98
]
]