aLevelData = [
[
6,2,8,2,165,27,41,155,161,236,159,186,253,233,185,129,176,251,72,199
],[
2,2,2,2,69,78,87,190,48,87,26,29,98,22,33,126,27,152,209,4
],[
2,2,3,3,0,193,21,66,109,72,81,88,12,3,152,95,167,101,30,8
],[
2,2,3,2,58,69,240,127,77,224,226,150,128,34,201,31,104,33,235,153
],[
2,2,3,2,153,235,180,16,4,129,171,62,132,35,164,246,179,206,54,195
],[
2,2,3,2,2,4,111,204,9,203,199,250,27,248,83,93,30,173,59,204
],[
2,2,3,2,153,33,110,204,15,159,148,180,140,210,69,14,125,63,120,63
],[
196,19,62,107,12,31,176,147,90,33,37,0,229,69,169,229,40,235,171,64
],[
53,171,246,1,76,150,227,110,172,191,204,198,169,251,195,36,255,228,132,167
],[
102,36,169,208,103,240,29,43,109,210,211,50,31,172,184,110,237,250,230,223
],[
233,87,26,158,217,67,104,193,138,35,45,127,103,137,70,149,73,182,127,231
],[
145,93,78,107,117,170,194,67,151,131,182,41,220,14,74,16,123,115,148,8
],[
84,227,146,99,132,217,99,22,54,159,183,98,187,21,133,179,222,174,252,200
],[
113,187,187,20,44,236,68,100,184,19,174,195,6,44,155,154,229,155,106,28
],[
212,180,174,225,20,128,222,209,2,190,78,68,164,41,93,104,130,249,240,226
],[
183,172,32,184,71,6,48,110,179,87,194,111,203,252,74,175,196,40,194,143
],[
138,229,160,1,87,85,5,236,133,62,55,210,161,197,81,176,192,122,57,37
],[
22,149,211,215,196,127,116,19,242,149,154,179,30,40,218,69,179,200,25,105
],[
222,194,255,123,157,231,169,114,25,143,158,8,53,222,5,28,103,70,21,84
],[
199,77,204,6,101,145,228,89,224,9,3,167,52,141,50,38,212,153,144,200
]
]