aLevelData = [
[
4,2,2,2,2,2,2,2,2,2,8,2,2,2,2,3,2,0,158,34
],[
109,57,61,173,214,30,109,184,33,59,98,58,183,96,118,181,102,60,110,104
],[
188,45,255,197,179,87,145,37,148,244,66,187,21,234,46,198,196,163,238,11
],[
169,25,94,131,39,48,163,81,36,73,109,246,106,20,122,200,76,165,92,161
],[
140,203,123,212,124,157,93,101,100,85,37,121,36,98,90,11,26,184,234,225
],[
70,107,111,190,172,124,176,218,250,243,107,143,107,45,82,85,235,120,83,240
],[
124,221,28,232,216,61,223,58,88,160,82,77,20,201,251,39,76,14,170,225
],[
7,102,71,88,249,196,205,38,170,163,151,209,213,226,219,65,14,211,116,120
],[
168,143,228,125,214,140,153,153,16,113,111,198,185,40,119,101,254,53,247,47
],[
1,71,177,110,55,13,104,109,14,75,161,45,212,45,167,89,212,219,209,124
],[
194,77,7,114,89,97,131,29,66,43,213,89,56,140,42,49,106,6,205,83
],[
32,206,238,193,162,35,163,202,86,223,44,57,40,76,123,204,46,56,244,231
],[
140,76,113,138,150,153,137,129,53,116,18,218,140,132,228,156,219,25,224,182
],[
163,191,49,54,11,20,210,187,130,214,80,45,166,64,210,171,100,151,86,197
],[
97,0,61,236,153,148,10,38,71,182,103,7,4,164,105,220,50,77,20,41
],[
155,99,34,86,86,176,0,165,235,173,26,103,182,81,88,112,145,39,232,200
],[
173,163,63,163,193,182,90,147,103,160,74,253,194,6,239,202,101,68,4,94
],[
112,4,91,206,252,16,106,77,186,100,7,232,214,136,112,116,34,28,142,196
],[
112,180,123,31,63,231,65,240,155,163,229,192,62,195,164,98,251,228,124,109
],[
93,116,238,240,139,11,3,96,110,255,141,213,22,51,175,118,90,47,159,50
]
]