aLevelData = [
[
2,2,2,2,2,2,2,2,2,2,2,2,2,2,2,2,2,2,2,239
],[
2,2,2,2,2,2,2,2,2,2,2,2,2,2,2,2,2,2,2,52
],[
2,2,2,2,2,2,2,2,2,2,2,2,2,2,2,2,2,2,2,141
],[
2,2,2,3,3,3,3,3,3,3,3,3,3,3,3,3,3,3,2,182
],[
2,2,2,2,2,2,2,2,2,2,2,2,2,2,2,2,2,2,2,138
],[
2,2,2,2,2,2,2,2,2,2,2,2,2,2,2,2,2,2,2,85
],[
2,2,2,2,2,3,2,2,3,2,2,3,2,2,2,3,2,2,3,147
],[
2,2,2,3,3,3,3,3,3,3,3,3,3,3,3,3,3,3,3,172
],[
2,2,2,2,2,2,2,2,2,2,2,2,2,2,2,2,2,2,2,211
],[
2,2,2,2,2,2,2,2,2,2,2,2,2,2,2,2,2,2,2,57
],[
2,2,3,3,3,3,3,3,3,3,3,3,3,3,3,3,3,3,2,231
],[
2,2,2,2,2,2,2,2,2,2,2,2,2,2,2,2,2,3,2,236
],[
2,2,2,2,2,2,2,2,2,2,2,2,2,2,2,2,2,3,2,159
],[
2,2,3,3,3,3,3,3,3,2,2,3,3,3,3,3,3,3,2,115
],[
2,2,3,2,2,2,2,2,2,2,2,2,2,2,2,2,2,2,2,164
],[
2,2,3,2,2,2,2,2,2,2,2,2,2,2,2,2,2,2,2,182
],[
127,92,141,82,231,170,78,74,143,68,5,214,26,85,0,152,246,159,200,137
],[
131,19,95,52,119,158,199,34,129,69,195,149,44,116,226,121,7,147,184,151
],[
3,219,111,12,28,104,127,249,59,143,185,125,91,113,138,224,235,208,126,17
],[
116,34,3,83,124,228,112,51,170,49,69,189,43,147,180,239,83,25,97,110
]
]