aLevelData = [
[
2,2,2,2,2,2,2,2,2,2,2,2,2,2,210,168,96,251,149,118
],[
2,2,2,2,2,2,2,2,2,2,2,2,2,2,245,128,121,176,212,129
],[
2,2,2,2,2,2,2,2,2,2,2,2,2,2,224,133,125,75,110,82
],[
2,2,2,13,2,2,2,2,2,2,2,2,2,2,234,196,5,199,32,172
],[
2,2,2,2,2,2,2,2,2,2,2,2,2,2,244,70,3,35,107,139
],[
2,2,2,2,2,2,2,2,2,2,2,2,2,2,110,107,51,146,131,240
],[
2,2,2,2,2,2,2,2,2,2,2,2,2,2,155,181,64,133,182,22
],[
2,2,2,2,2,2,2,2,2,1,2,2,2,2,83,241,195,60,48,170
],[
2,2,11,2,2,2,2,2,2,2,2,2,2,2,237,1,96,224,53,171
],[
2,2,2,2,2,2,2,2,2,2,2,2,2,2,28,189,172,89,26,236
],[
2,2,2,2,2,2,2,2,2,2,2,2,2,2,229,161,167,88,170,119
],[
2,2,2,2,2,2,2,2,2,2,2,2,2,2,246,54,238,80,184,69
],[
3,136,236,84,13,1,249,6,183,14,250,210,36,143,89,77,41,93,159,172
],[
185,232,138,132,160,30,97,213,116,143,132,71,201,207,71,179,165,28,0,229
],[
52,65,95,161,188,186,254,227,210,25,57,107,207,169,64,121,126,80,106,214
],[
23,186,205,19,113,179,11,21,115,213,110,210,204,100,56,85,227,118,52,8
],[
17,87,145,50,15,43,240,191,170,213,188,64,190,24,186,50,97,252,225,131
],[
95,116,107,82,231,61,44,247,131,9,35,67,77,221,79,8,97,184,195,220
],[
142,117,253,27,81,242,116,43,3,114,112,4,81,64,30,239,237,150,228,141
],[
131,188,242,28,239,116,26,246,173,150,225,90,144,248,214,111,183,144,34,134
]
]