aLevelData = [
[
2,2,2,2,2,11,2,2,2,2,2,106,233,21,198,136,112,30,21,159
],[
2,2,2,2,2,2,2,2,2,2,2,97,232,29,148,157,36,220,60,53
],[
5,2,5,2,5,5,5,2,5,5,5,236,21,31,34,166,163,124,54,44
],[
5,2,5,2,5,2,5,2,5,2,5,14,141,82,42,92,11,218,199,41
],[
5,5,5,2,5,5,5,2,5,5,5,245,102,135,250,142,186,111,207,165
],[
5,2,5,2,5,2,5,2,5,2,2,249,107,247,24,21,238,40,155,138
],[
5,2,5,2,5,2,5,2,5,2,2,216,207,182,76,156,165,13,253,162
],[
2,2,2,12,2,2,2,2,2,2,2,131,228,100,234,119,226,27,243,23
],[
2,2,7,2,2,2,2,2,8,2,2,21,135,219,21,55,13,199,20,48
],[
2,2,7,2,5,5,5,2,5,5,5,131,133,186,219,229,112,7,13,74
],[
148,229,212,22,19,0,252,112,200,215,216,247,41,20,63,176,114,24,212,67
],[
0,219,138,104,250,243,104,156,55,242,138,24,92,245,105,3,69,122,92,231
],[
167,114,94,98,243,152,17,30,125,0,3,2,221,243,48,170,149,250,201,21
],[
245,57,52,158,60,254,84,46,0,154,10,175,208,112,252,196,23,75,149,183
],[
67,245,77,179,39,5,42,51,158,248,134,186,114,131,20,197,124,40,30,253
],[
12,8,16,178,139,248,58,133,94,214,210,100,14,30,56,188,166,184,126,233
],[
93,20,40,242,117,121,48,115,99,154,78,218,48,107,118,214,31,50,161,13
],[
144,225,208,14,36,163,78,134,34,181,54,182,26,119,54,36,200,195,146,145
],[
58,125,108,44,53,107,66,5,214,71,184,196,117,19,152,155,206,173,23,121
],[
99,163,90,129,28,72,56,186,49,8,66,8,73,248,0,91,228,177,126,38
]
]