aLevelData = [
[
5,5,3,5,5,5,5,5,5,5,3,6,158,49,83,135,143,61,209,110
],[
4,2,3,5,5,5,5,5,5,5,3,250,226,114,24,145,152,34,211,66
],[
2,2,3,2,3,3,3,3,3,2,3,35,227,168,187,11,111,120,46,77
],[
5,2,2,2,3,2,2,2,2,2,5,31,75,81,80,11,228,170,26,115
],[
2,2,2,3,2,2,2,2,2,2,5,153,9,196,94,97,86,43,128,47
],[
140,233,97,126,6,132,188,45,250,228,37,142,67,11,239,186,99,0,77,39
],[
200,12,183,124,78,41,144,163,6,184,5,32,54,114,56,162,160,161,158,216
],[
7,144,165,134,240,64,155,216,166,92,203,246,128,111,233,216,102,85,176,92
],[
146,240,201,150,148,28,239,103,153,228,81,81,236,246,55,137,189,84,233,78
],[
34,77,205,122,91,172,207,87,90,47,5,179,131,58,147,55,176,205,205,244
],[
120,180,156,63,177,253,35,191,51,175,162,196,223,185,154,218,224,41,50,159
],[
49,158,217,209,95,0,45,171,145,110,27,114,197,120,72,75,92,143,176,79
],[
217,185,142,225,230,138,123,63,152,79,217,88,243,140,114,222,177,169,93,155
],[
63,232,34,8,9,154,29,28,247,147,40,98,55,219,116,78,62,166,184,209
],[
9,134,142,43,169,224,25,1,254,157,236,175,195,33,39,223,202,129,227,91
],[
137,240,209,31,214,123,29,179,239,247,153,183,189,55,23,191,90,130,22,98
],[
208,67,162,142,36,3,117,30,147,149,98,175,27,144,244,175,61,3,82,182
],[
2,99,101,26,60,200,61,190,14,89,177,42,174,5,70,225,106,117,83,238
],[
233,62,98,193,180,90,216,57,244,217,217,2,126,212,102,33,12,163,200,205
],[
205,79,50,129,33,74,162,79,157,94,8,119,86,228,170,56,92,54,199,230
]
]