aLevelData = [
[
2,2,2,2,2,2,2,27,139,64,126,94,228,20,172,32,254,224,55,235
],[
2,2,2,2,2,2,2,143,148,36,74,70,52,53,127,175,44,249,115,86
],[
2,2,2,2,2,2,2,229,5,243,47,149,128,24,53,91,229,7,82,139
],[
2,2,2,3,3,3,3,4,219,127,71,74,224,44,79,67,2,226,25,93
],[
2,2,2,2,2,2,2,133,39,37,239,246,162,139,121,97,127,214,46,196
],[
2,2,2,2,2,2,2,21,20,175,196,198,46,26,159,39,118,67,98,97
],[
2,2,2,2,2,3,2,127,65,92,216,49,45,210,10,28,38,244,185,13
],[
2,2,2,3,3,3,3,152,16,76,223,190,6,115,148,102,252,10,165,245
],[
2,2,2,2,2,2,2,82,64,149,170,216,248,204,39,63,111,163,45,206
],[
2,2,2,2,2,2,2,31,188,167,86,228,148,234,104,94,91,59,197,150
],[
2,2,3,3,3,3,3,3,145,22,228,151,157,222,16,206,8,172,183,224
],[
252,149,240,152,229,225,48,170,121,5,107,72,246,210,124,240,170,235,199,136
],[
185,124,29,172,27,41,224,71,228,69,103,96,200,69,163,55,222,116,3,145
],[
164,232,150,80,68,180,112,70,21,95,78,75,101,149,125,141,118,29,247,40
],[
198,11,208,247,147,55,208,169,159,237,98,23,49,230,172,212,92,119,0,6
],[
131,9,115,117,29,201,203,226,182,161,159,154,54,102,185,75,102,83,191,21
],[
176,182,19,228,39,233,247,254,199,132,245,216,253,209,126,46,106,128,209,82
],[
228,156,30,197,189,190,235,4,72,129,184,164,154,53,222,161,142,216,189,244
],[
12,66,22,99,138,159,182,157,210,34,85,134,6,248,189,208,226,123,47,203
],[
66,169,2,126,228,212,141,246,110,154,71,222,179,24,45,80,50,91,100,235
]
]