aLevelData = [
[
2,2,70,191,194,224,197,73,85,219,249,133,91,215,29,17,16,238,115,117
],[
2,2,233,146,58,76,40,207,219,165,173,208,99,168,15,165,53,125,235,67
],[
2,2,1,105,124,204,240,58,108,17,33,230,234,86,89,111,253,85,246,9
],[
2,2,24,133,37,127,238,155,85,211,135,81,236,37,148,103,56,213,0,232
],[
2,2,168,236,199,175,60,184,11,41,58,183,101,93,35,183,121,41,229,58
],[
2,2,205,206,82,31,219,175,209,127,100,85,83,214,8,183,137,99,20,184
],[
2,2,85,209,155,242,126,22,200,178,167,156,114,67,130,158,241,112,65,214
],[
2,2,48,68,77,85,4,20,59,178,188,192,252,102,250,53,83,119,193,54
],[
2,2,140,84,206,93,108,0,44,92,100,115,3,137,9,62,177,154,201,109
],[
2,2,27,172,214,177,69,139,103,191,33,45,32,243,165,127,206,57,32,101
],[
2,2,88,45,206,251,243,129,170,34,148,159,131,56,171,144,82,38,14,29
],[
2,2,203,160,51,52,50,168,163,141,112,84,171,140,102,210,85,106,129,169
],[
2,2,151,144,143,65,201,67,209,166,92,134,81,137,202,60,117,136,201,142
],[
2,2,213,175,196,140,74,62,139,23,71,172,74,254,109,237,184,103,89,241
],[
2,2,144,113,193,109,69,23,191,221,242,88,108,202,143,148,177,72,107,58
],[
2,2,90,196,214,160,108,252,30,50,185,79,190,207,177,55,209,112,123,20
],[
2,2,205,11,69,43,109,183,216,238,239,16,111,126,128,221,201,110,245,240
],[
125,202,187,78,142,87,17,144,63,29,116,137,40,35,91,41,138,122,37,161
],[
224,124,80,200,182,86,235,190,190,196,78,207,33,28,8,154,19,142,25,114
],[
170,170,98,4,240,34,89,58,55,210,1,96,172,253,26,134,47,218,148,37
]
]