aLevelData = [
[
5,5,5,5,5,2,132,248,191,113,252,104,42,70,121,59,23,144,175,164
],[
5,2,2,2,2,2,254,177,0,202,122,175,242,111,88,240,225,208,237,66
],[
5,2,5,3,3,3,241,205,173,31,71,74,250,46,121,213,58,12,66,137
],[
2,2,5,2,3,2,44,77,123,50,124,190,70,178,149,237,141,163,182,236
],[
171,61,72,81,104,122,111,129,43,121,223,47,107,32,241,31,103,6,245,48
],[
23,144,202,153,98,90,173,115,145,216,79,120,4,61,42,10,35,155,20,119
],[
152,76,21,123,188,146,118,6,78,122,26,64,107,6,18,202,186,138,107,71
],[
232,87,74,28,84,151,60,115,11,120,199,134,246,141,69,26,82,113,242,73
],[
97,173,67,133,95,219,121,218,184,12,119,115,120,104,208,96,3,20,37,151
],[
6,89,174,56,173,2,22,21,23,5,140,113,7,102,23,8,220,89,41,80
],[
195,167,120,255,43,82,9,205,121,124,141,123,253,133,241,20,37,116,49,115
],[
241,152,109,5,167,111,62,208,200,198,74,180,66,34,22,241,231,95,28,234
],[
30,151,30,41,217,69,185,162,199,170,61,60,202,112,188,141,171,142,97,229
],[
13,107,3,143,159,70,250,83,150,213,50,63,91,44,126,168,128,225,46,107
],[
249,110,227,120,137,214,162,146,122,140,40,80,145,144,125,104,65,219,204,44
],[
31,253,114,85,150,5,85,0,220,161,119,246,36,134,203,48,22,18,71,155
],[
124,48,58,24,62,125,224,199,144,169,51,133,106,31,5,179,56,232,76,58
],[
212,204,189,203,177,187,156,108,89,108,210,48,25,68,64,69,250,121,83,52
],[
244,119,216,101,95,131,18,226,170,158,10,92,79,172,39,115,6,213,254,50
],[
58,44,107,217,185,142,225,224,175,205,254,56,213,14,99,212,230,112,194,104
]
]