aLevelData = [
[
5,5,3,5,5,5,5,5,5,5,3,5,5,5,5,63,66,38,97,237
],[
4,2,3,5,5,5,5,5,5,5,3,5,5,5,5,194,74,74,111,195
],[
2,2,3,2,3,3,3,3,3,2,3,3,3,3,3,243,139,61,236,253
],[
5,2,2,2,3,2,2,2,2,2,5,5,5,5,5,28,185,40,121,94
],[
2,2,2,3,2,2,2,2,2,2,5,5,5,5,5,18,249,173,12,105
],[
2,2,2,3,2,2,5,3,3,2,3,3,3,3,3,15,91,111,51,25
],[
2,2,2,2,2,2,5,5,3,2,2,2,2,2,2,71,210,223,219,243
],[
5,2,2,2,2,2,5,5,3,2,2,2,2,2,2,54,184,128,173,71
],[
2,2,5,5,3,2,5,5,3,2,3,3,3,5,5,12,50,203,142,142
],[
2,2,5,5,3,2,5,5,3,6,3,3,5,5,5,233,54,231,249,128
],[
2,2,3,3,3,2,5,5,3,5,5,3,5,5,5,37,54,246,14,43
],[
2,2,3,2,2,2,5,5,3,5,5,5,3,5,5,86,64,115,116,82
],[
2,2,3,2,2,2,5,5,3,5,5,5,3,3,5,6,49,76,216,145
],[
2,2,3,2,5,2,3,3,3,5,5,5,3,3,5,126,224,234,38,151
],[
2,2,2,2,5,2,3,5,5,5,5,5,5,3,5,73,215,46,86,198
],[
2,2,2,2,5,2,5,5,5,5,5,5,5,5,5,106,148,7,73,97
],[
2,2,3,3,3,2,3,3,5,5,5,5,3,5,3,111,120,54,32,225
],[
2,2,3,5,5,2,3,5,5,5,5,3,5,5,5,79,103,167,62,160
],[
2,3,3,5,5,2,3,5,3,5,5,5,5,5,5,115,194,113,191,48
],[
2,3,2,5,5,2,5,5,3,5,5,5,5,5,5,127,156,83,118,229
]
]