aLevelData = [
[
4,2,2,2,2,2,2,2,2,111,136,84,90,251,47,189,71,250,27,126
],[
5,2,5,3,2,2,2,2,2,176,248,182,45,101,212,116,58,164,33,171
],[
2,5,5,3,3,3,3,3,3,118,143,205,166,209,220,0,245,104,207,71
],[
3,3,5,5,5,5,5,5,5,6,191,101,242,250,74,211,187,177,51,46
],[
2,3,5,5,5,5,5,5,5,168,39,87,108,50,4,146,139,166,110,60
],[
3,3,5,5,5,5,3,3,3,16,204,34,243,179,199,195,155,89,60,113
],[
3,5,5,5,5,5,3,2,2,164,66,182,158,139,132,73,29,164,184,118
],[
3,5,5,3,3,3,3,8,2,124,22,243,79,148,39,248,219,94,186,171
],[
3,5,5,3,2,2,3,3,3,188,9,21,201,15,73,232,215,148,241,139
],[
3,5,5,3,2,2,2,2,2,88,15,196,136,67,238,136,89,180,43,93
],[
3,5,5,3,2,2,3,2,2,115,226,116,77,131,81,138,36,247,73,231
],[
5,5,5,3,2,2,3,2,2,130,192,134,163,46,86,49,152,173,253,15
],[
5,5,5,3,2,2,3,2,2,197,20,72,249,240,26,219,140,143,113,116
],[
5,3,3,3,2,2,3,2,2,33,233,87,45,255,121,104,251,208,147,182
],[
5,3,2,2,2,2,3,2,2,123,82,74,27,238,79,144,206,129,207,159
],[
5,3,3,2,2,2,3,2,5,53,211,140,152,250,177,166,106,97,36,152
],[
5,5,3,3,2,2,3,2,5,246,217,173,107,113,209,207,42,9,204,206
],[
5,5,5,5,3,3,3,2,5,149,203,184,183,25,196,123,160,0,102,208
],[
5,5,5,5,5,5,3,2,5,49,230,46,81,99,108,132,212,136,48,227
],[
251,140,252,57,7,122,61,145,237,65,183,239,172,185,120,123,221,225,10,226
]
]