aLevelData = [
[
2,2,2,2,2,2,2,2,2,6,5,2,2,2,2,2,2,2,251,163
],[
2,3,5,3,5,5,5,3,5,3,5,2,5,3,5,3,5,5,212,50
],[
2,3,2,3,2,2,2,3,5,3,5,2,5,3,5,3,5,5,246,2
],[
2,2,2,2,2,2,2,2,2,2,2,2,5,5,5,5,5,5,4,248
],[
2,3,5,3,5,5,5,3,2,3,5,5,5,3,2,3,5,5,221,223
],[
2,3,5,3,5,5,5,3,2,3,5,5,5,3,2,3,5,5,247,192
],[
2,5,5,5,5,5,5,5,5,5,5,5,5,2,2,5,5,5,228,236
],[
168,103,3,148,230,78,167,222,170,94,167,147,168,73,121,163,36,18,166,197
],[
7,207,123,94,50,174,1,164,18,54,48,3,117,207,96,192,156,133,0,220
],[
145,9,138,59,187,248,182,5,175,96,239,77,73,129,3,240,252,208,30,192
],[
102,66,249,226,39,198,79,117,244,19,145,116,231,165,218,222,25,2,37,20
],[
115,66,190,130,193,206,246,129,8,104,27,124,26,108,167,82,103,85,184,252
],[
22,130,192,112,85,59,126,197,237,239,45,151,25,191,251,173,152,65,188,217
],[
1,125,224,32,87,60,162,27,221,131,131,157,43,90,247,151,130,209,94,56
],[
93,69,53,88,72,224,142,22,245,95,189,192,141,24,85,244,68,59,83,5
],[
48,88,152,160,91,33,157,176,23,114,98,126,145,142,167,29,169,172,95,5
],[
1,178,98,254,84,64,98,64,10,240,32,216,9,220,223,77,205,97,25,132
],[
187,35,114,225,178,81,234,175,228,43,86,194,228,193,17,90,255,253,239,75
],[
208,227,114,91,15,24,65,236,170,161,213,219,23,238,118,167,232,23,102,214
],[
160,101,92,148,197,20,51,158,54,87,228,94,191,157,178,87,235,19,164,196
]
]