aLevelData = [
[
10,2,2,8,2,2,2,2,2,2,2,2,2,2,20,121,28,113,163,168
],[
2,2,2,2,2,2,2,2,2,2,2,2,2,2,55,97,80,108,206,49
],[
2,2,2,2,2,2,3,3,3,3,2,2,2,2,93,11,223,121,84,250
],[
9,2,2,2,2,2,2,2,2,3,2,2,2,2,215,131,166,245,84,0
],[
3,3,3,3,3,3,3,2,2,3,2,2,2,2,146,78,47,249,72,134
],[
2,2,2,2,2,2,2,2,2,3,2,2,2,2,186,8,79,26,70,199
],[
2,2,2,2,2,2,2,2,2,3,3,2,2,2,36,159,233,137,36,17
],[
2,2,2,2,2,2,2,2,2,2,3,2,2,2,126,72,171,105,236,223
],[
2,2,2,2,2,2,2,2,2,2,3,2,2,2,126,109,172,121,102,204
],[
2,2,2,2,3,3,3,3,2,2,3,2,2,2,133,74,30,106,154,125
],[
2,2,2,2,3,2,2,3,2,2,3,2,2,2,111,249,167,109,154,201
],[
2,2,2,2,3,2,2,3,2,2,3,3,3,5,136,23,246,225,251,208
],[
2,2,2,2,3,2,2,3,2,2,2,2,3,2,218,78,166,51,189,187
],[
2,2,2,2,3,2,2,3,2,2,2,2,3,2,92,94,156,66,156,94
],[
2,2,2,2,3,2,2,3,2,2,2,2,3,2,157,130,90,231,241,242
],[
2,72,254,116,187,159,190,46,233,73,98,149,245,157,60,202,80,218,219,42
],[
181,93,120,33,175,24,145,62,92,63,211,141,112,68,61,33,124,6,131,240
],[
113,70,176,228,96,90,16,46,131,37,77,222,129,70,216,176,238,144,138,41
],[
17,186,140,227,235,88,116,38,116,10,176,183,40,244,40,245,194,110,31,33
],[
72,252,90,254,71,128,133,154,96,174,210,107,3,193,227,157,123,108,234,171
]
]