aLevelData = [
[
12,2,2,2,2,2,2,2,2,2,179,38,197,119,100,127,184,222,172,116
],[
2,2,2,2,2,2,2,2,2,2,182,143,218,103,168,156,72,154,212,3
],[
2,2,3,3,3,3,3,3,3,3,142,151,178,49,246,207,250,196,48,129
],[
11,2,3,2,2,2,2,2,2,3,2,149,71,221,71,246,212,106,73,56
],[
114,165,157,113,113,235,61,123,207,152,34,64,99,113,21,53,92,63,194,37
],[
234,189,14,48,59,180,170,19,169,101,232,170,50,39,206,179,40,81,106,212
],[
41,90,100,224,82,63,218,86,176,37,103,42,247,64,133,200,119,243,22,87
],[
75,57,61,58,212,67,114,221,102,99,214,174,64,40,195,105,194,203,168,153
],[
218,201,20,92,192,210,16,102,227,226,178,72,35,174,239,242,64,65,177,119
],[
146,231,41,17,251,74,103,101,27,219,40,8,194,115,239,65,171,58,87,17
],[
103,201,167,112,151,139,167,218,94,105,178,10,22,166,13,6,66,7,119,91
],[
196,56,1,170,81,107,32,99,33,66,1,209,235,239,28,87,16,154,12,249
],[
23,2,158,29,89,104,40,147,253,169,28,212,39,170,220,135,109,248,208,74
],[
139,176,183,174,87,157,58,131,247,161,199,87,81,86,156,57,195,244,34,195
],[
20,118,125,87,171,248,97,168,255,100,39,124,79,77,32,177,147,27,41,126
],[
178,105,127,252,245,171,213,229,188,20,164,155,112,183,195,108,184,236,55,20
],[
240,245,76,131,215,225,229,225,135,177,16,208,171,186,221,241,236,74,113,169
],[
172,142,86,37,247,179,21,155,182,76,7,211,38,244,104,231,137,52,173,71
],[
28,167,23,255,72,91,137,61,28,123,151,13,251,43,223,104,146,180,156,109
],[
13,225,120,238,139,169,162,46,207,13,33,233,56,68,104,149,243,22,42,232
]
]