aLevelData = [
[
2,2,2,2,5,5,2,2,2,2,94,109,237,146,170,250,46,89,243,136
],[
2,2,2,4,2,2,2,2,2,2,139,106,133,191,97,191,70,126,93,92
],[
5,3,3,3,5,5,3,3,3,3,246,20,228,40,181,180,178,251,198,35
],[
2,3,2,2,2,2,2,2,2,3,193,248,146,180,108,29,240,118,212,24
],[
2,3,2,2,2,2,2,2,2,3,163,172,131,92,36,125,79,117,163,237
],[
2,3,2,2,3,2,2,2,2,3,129,152,72,12,55,127,190,109,7,116
],[
2,3,2,2,3,2,2,2,2,3,242,218,229,171,24,70,71,212,240,3
],[
2,3,2,2,3,5,5,3,3,3,135,241,71,54,136,101,192,135,156,78
],[
2,3,3,2,3,2,2,3,2,2,212,29,165,21,24,201,123,68,190,129
],[
2,2,3,2,3,2,2,3,2,1,142,151,95,17,205,85,248,13,198,224
],[
2,2,3,2,3,2,2,3,2,2,50,10,14,139,230,13,227,173,224,68
],[
2,2,3,2,3,2,2,3,2,2,16,244,227,244,17,251,238,179,120,30
],[
2,2,2,2,3,2,2,3,2,2,190,215,143,141,148,46,63,159,56,240
],[
2,2,2,2,3,2,2,3,2,2,48,105,62,241,50,144,136,27,220,91
],[
2,2,2,2,3,2,2,3,2,2,12,28,114,12,215,92,12,113,82,50
],[
245,182,197,87,82,125,25,155,4,48,226,214,207,150,157,34,187,165,53,71
],[
186,152,205,119,140,65,185,60,224,159,205,174,188,179,219,233,30,144,119,190
],[
228,178,253,169,233,144,214,3,113,116,246,121,199,139,169,189,36,56,144,123
],[
211,174,230,143,147,190,8,117,61,237,53,1,166,202,146,80,199,127,113,254
],[
27,165,210,153,73,93,42,86,3,156,100,3,46,198,38,61,67,127,85,227
]
]