aLevelData = [
[
5,5,3,5,5,5,5,5,5,5,3,5,5,5,5,5,5,96,35,26
],[
4,2,3,5,5,5,5,5,5,5,3,5,5,5,5,5,5,160,61,139
],[
2,2,3,2,3,3,3,3,3,2,3,3,3,3,3,5,5,31,27,110
],[
5,2,2,2,3,2,2,2,2,2,5,5,5,5,5,5,5,78,19,196
],[
2,2,2,3,2,2,2,2,2,2,5,5,5,5,5,5,5,32,116,48
],[
2,2,2,3,2,2,5,3,3,2,3,3,3,3,3,5,5,1,239,183
],[
2,2,2,2,2,2,5,5,3,2,2,2,2,2,2,2,2,151,124,171
],[
55,56,121,92,111,241,103,131,104,250,180,163,44,128,230,0,126,144,232,167
],[
200,55,161,174,85,232,203,189,192,29,3,206,173,65,28,48,182,206,185,210
],[
169,179,27,190,240,248,55,228,80,164,12,25,215,223,51,95,15,84,184,103
],[
120,217,40,84,53,82,235,194,6,210,212,7,118,4,247,184,86,202,187,112
],[
105,35,48,204,97,82,162,186,10,61,110,244,198,19,20,199,57,49,142,25
],[
69,71,224,170,57,182,241,154,69,61,153,44,50,213,251,201,79,217,21,72
],[
175,106,149,108,145,18,238,174,32,167,172,61,93,115,4,68,89,145,176,107
],[
167,154,250,160,17,130,22,23,138,188,180,143,100,165,214,216,195,31,223,146
],[
82,124,237,55,52,159,105,92,62,93,221,51,99,41,5,85,111,241,40,190
],[
249,67,168,25,146,180,217,63,67,130,15,250,55,120,251,14,180,18,55,122
],[
80,226,31,251,97,50,227,210,181,235,218,199,131,182,25,110,162,96,69,169
],[
249,131,165,110,55,99,123,202,196,22,149,38,247,232,31,202,137,253,187,159
],[
73,56,212,57,18,92,46,20,250,113,194,30,205,106,202,118,186,4,24,116
]
]