aLevelData = [
[
2,2,2,5,2,2,2,5,2,2,2,5,2,2,2,5,2,2,2,151
],[
2,2,2,2,2,5,2,2,2,5,2,2,2,5,2,2,2,2,2,52
],[
2,2,3,3,3,3,3,3,3,3,3,3,3,3,3,3,2,2,2,182
],[
2,3,2,2,2,2,2,2,2,2,2,2,2,5,2,5,2,2,2,145
],[
2,3,2,2,2,2,2,2,2,2,8,2,2,2,2,2,2,2,2,135
],[
2,2,2,2,2,5,5,5,5,2,2,2,2,5,2,3,3,3,2,2
],[
2,2,3,3,3,3,2,3,2,3,2,2,2,3,2,3,2,2,3,172
],[
2,2,3,2,2,3,2,3,2,3,3,2,2,3,2,3,2,2,3,206
],[
2,2,3,2,2,3,2,3,2,3,2,3,2,3,2,3,2,2,2,182
],[
4,2,3,2,2,3,2,3,2,3,2,3,2,3,2,3,2,2,2,7
],[
2,2,3,3,3,2,2,3,2,3,2,3,2,3,2,3,2,3,3,42
],[
2,2,3,2,3,2,2,3,2,3,2,2,3,3,2,3,2,2,3,235
],[
2,2,3,2,3,2,2,3,2,3,2,2,3,3,2,3,2,2,3,217
],[
2,2,3,2,2,3,2,3,2,3,2,2,2,3,2,3,2,2,3,111
],[
2,2,3,2,2,3,2,3,2,3,2,2,2,3,2,3,1,2,3,188
],[
2,2,2,2,2,5,5,5,5,2,2,2,2,5,2,5,3,3,5,22
],[
2,3,2,2,2,2,2,2,2,2,9,2,2,2,2,2,2,2,2,245
],[
2,3,3,3,3,2,2,2,2,2,2,2,2,2,2,2,2,2,2,124
],[
2,2,2,2,2,3,3,3,3,3,3,3,3,3,3,3,3,3,2,172
],[
62,211,41,28,211,174,13,81,205,46,129,82,239,154,5,178,77,73,224,170
]
]