aLevelData = [
[
5,5,3,5,5,225,75,185,30,213,44,36,245,72,44,90,239,195,192,205
],[
4,2,3,5,5,72,225,42,137,108,176,74,185,103,91,183,109,157,6,14
],[
2,2,3,2,3,154,187,250,138,98,237,2,213,150,82,20,30,122,173,52
],[
5,2,2,2,3,108,200,93,150,50,247,143,3,35,188,178,125,71,210,43
],[
2,2,2,3,2,38,79,247,74,94,38,55,125,44,200,108,196,223,87,6
],[
2,2,2,3,2,101,245,108,8,225,59,171,83,38,54,154,39,6,194,179
],[
2,2,2,2,2,231,232,249,183,28,190,86,70,189,55,26,173,174,53,239
],[
5,2,2,2,2,255,134,129,204,103,149,190,24,188,38,155,18,86,1,77
],[
112,32,52,61,70,239,19,253,42,18,126,129,150,43,98,140,142,61,130,104
],[
130,5,120,218,117,142,246,85,95,0,82,110,208,184,66,144,215,158,228,241
],[
34,179,1,196,102,234,146,177,2,57,131,130,223,239,184,31,154,72,78,188
],[
229,63,35,81,42,163,152,74,114,109,149,128,134,81,206,105,83,147,69,139
],[
147,28,16,55,170,205,93,115,206,19,179,56,107,188,123,222,198,9,190,212
],[
224,4,48,148,157,19,110,214,37,206,132,4,139,14,178,239,173,70,112,192
],[
91,23,175,49,187,30,98,253,235,17,61,148,233,10,188,20,176,34,104,117
],[
164,66,86,3,48,54,240,18,174,3,247,237,135,123,201,15,155,14,224,150
],[
227,227,156,244,84,40,66,232,7,166,68,173,152,152,195,113,204,189,82,8
],[
118,172,253,226,155,104,138,58,212,52,254,145,244,168,99,91,235,5,201,248
],[
234,198,139,229,200,119,211,52,165,202,96,57,205,232,135,135,222,5,120,27
],[
46,55,195,214,103,136,27,49,116,74,89,44,161,170,196,135,253,136,143,53
]
]