aLevelData = [
[
2,2,2,5,2,2,2,5,2,2,2,5,2,2,2,5,2,2,2,212
],[
2,2,2,2,2,5,2,2,2,5,2,2,2,5,2,2,2,2,2,92
],[
2,2,3,3,3,3,3,3,3,3,3,3,3,3,3,3,2,2,2,156
],[
2,3,2,2,2,2,2,2,2,2,2,2,2,5,2,5,2,2,2,195
],[
2,3,2,2,2,2,2,2,2,2,8,2,2,2,2,2,2,2,2,76
],[
2,2,2,2,2,5,5,5,5,2,2,2,2,5,2,3,3,3,2,168
],[
2,2,3,3,3,3,2,3,2,3,2,2,2,3,2,3,2,2,3,221
],[
2,2,3,2,2,3,2,3,2,3,3,2,2,3,2,3,2,2,3,210
],[
2,2,3,2,2,3,2,3,2,3,2,3,2,3,2,3,2,2,2,230
],[
4,2,3,2,2,3,2,3,2,3,2,3,2,3,2,3,2,2,2,189
],[
2,2,3,3,3,2,2,3,2,3,2,3,2,3,2,3,2,3,3,47
],[
2,2,3,2,3,2,2,3,2,3,2,2,3,3,2,3,2,2,3,103
],[
2,2,3,2,3,2,2,3,2,3,2,2,3,3,2,3,2,2,3,199
],[
2,2,3,2,2,3,2,3,2,3,2,2,2,3,2,3,2,2,3,129
],[
2,2,3,2,2,3,2,3,2,3,2,2,2,3,2,3,1,2,3,243
],[
47,112,189,217,235,53,199,245,44,240,94,22,90,246,213,83,251,74,116,230
],[
50,17,27,62,134,70,40,79,229,175,155,45,233,16,120,217,90,158,109,90
],[
243,182,181,16,105,207,60,70,169,174,4,6,97,217,199,49,195,77,222,207
],[
134,115,97,163,45,81,144,2,139,253,113,230,135,88,187,63,29,248,243,137
],[
165,102,213,163,88,138,245,223,16,99,166,86,79,252,27,126,131,155,204,254
]
]