aLevelData = [
[
5,5,3,5,5,5,5,5,5,5,3,5,5,5,5,81,176,127,188,182
],[
4,2,3,5,5,5,5,5,5,5,3,5,5,5,5,171,84,46,209,68
],[
2,2,3,2,3,3,3,3,3,2,3,3,3,3,3,12,188,61,249,59
],[
5,2,2,2,3,2,2,2,2,2,5,5,5,5,5,130,56,101,37,126
],[
2,2,2,3,2,2,2,2,2,2,5,5,5,5,5,84,28,24,151,112
],[
2,2,2,3,2,2,5,3,3,2,3,3,3,3,3,215,0,222,231,209
],[
2,2,2,2,2,2,5,5,3,2,2,2,2,2,2,53,19,7,112,151
],[
5,2,2,2,2,2,5,5,3,2,2,2,2,2,2,107,197,40,221,144
],[
2,2,5,5,3,2,5,5,3,2,3,3,3,5,5,174,157,42,234,33
],[
2,2,5,5,3,2,5,5,3,6,3,3,5,5,5,7,225,29,188,219
],[
2,2,3,3,3,2,5,5,3,5,5,3,5,5,5,187,211,20,168,23
],[
187,169,62,145,210,25,22,213,225,147,238,182,70,143,180,122,248,188,165,120
],[
198,58,182,230,223,10,51,236,151,195,166,252,104,134,250,102,55,51,224,39
],[
217,221,114,2,214,124,22,211,109,226,166,31,216,241,206,239,209,10,181,223
],[
84,200,223,114,167,239,82,168,152,159,247,211,6,206,68,166,162,245,24,143
],[
247,8,230,71,168,172,22,167,249,165,168,189,145,141,27,31,127,204,141,127
],[
122,196,35,128,109,76,171,200,51,96,128,86,158,22,174,22,191,212,87,179
],[
97,193,86,173,215,121,33,171,248,5,244,18,103,10,44,214,24,64,241,145
],[
15,38,23,210,107,245,70,183,164,210,89,190,17,71,5,216,173,244,187,191
],[
26,130,207,138,230,217,217,127,14,147,92,40,192,176,165,169,101,139,246,80
]
]