aLevelData = [
[
6,2,2,2,2,2,93,47,200,130,184,24,92,19,88,129,139,139,34,197
],[
2,2,2,2,2,2,16,68,92,41,241,193,203,108,187,228,24,160,15,97
],[
2,2,2,2,2,2,121,56,93,115,141,97,240,206,135,150,43,212,142,110
],[
3,3,3,3,3,3,18,11,100,185,12,207,70,204,230,68,20,25,28,143
],[
2,2,2,2,2,2,178,3,84,70,174,240,44,36,35,159,53,2,221,188
],[
2,2,2,2,2,2,63,2,189,177,216,14,95,192,15,129,251,78,126,35
],[
2,2,2,2,2,3,137,130,135,91,41,15,221,160,193,78,70,49,232,144
],[
2,2,3,3,3,3,160,6,3,178,34,6,173,242,229,122,93,0,163,194
],[
2,2,2,2,2,2,66,89,190,70,114,208,132,176,68,109,177,89,250,123
],[
2,2,2,2,2,2,53,0,164,221,56,194,65,161,92,70,38,216,66,57
],[
164,164,79,250,229,146,176,150,23,42,155,246,204,197,216,87,161,159,129,251
],[
30,45,6,30,222,177,115,44,240,11,246,49,124,210,156,145,170,163,91,249
],[
191,185,85,149,138,190,91,132,254,225,176,137,32,41,16,3,36,9,241,31
],[
210,52,9,76,47,178,16,239,90,52,199,88,180,165,57,245,67,1,65,198
],[
89,106,76,17,112,121,96,87,89,210,94,134,150,251,132,112,4,110,53,124
],[
189,236,253,156,60,21,208,127,194,54,146,7,249,98,221,253,215,196,254,4
],[
198,51,64,203,2,7,110,135,66,43,147,161,154,116,4,171,160,49,160,153
],[
206,4,87,46,39,240,233,180,29,178,240,240,179,85,33,85,223,1,207,120
],[
50,20,176,196,186,115,228,111,40,35,51,172,46,19,151,35,43,60,250,158
],[
10,236,64,5,103,95,136,140,244,144,175,43,28,78,22,79,230,146,166,207
]
]