aLevelData = [
[
2,2,2,5,2,2,2,5,2,2,2,5,2,2,79,72,20,186,26,179
],[
2,2,2,2,2,5,2,2,2,5,2,2,2,5,167,191,14,12,69,50
],[
2,2,3,3,3,3,3,3,3,3,3,3,3,3,20,33,205,129,171,9
],[
2,3,2,2,2,2,2,2,2,2,2,2,2,5,77,152,232,21,34,105
],[
2,3,2,2,2,2,2,2,2,2,8,2,2,2,186,4,97,204,115,118
],[
2,2,2,2,2,5,5,5,5,2,2,2,2,5,118,138,132,164,11,180
],[
2,2,3,3,3,3,2,3,2,3,2,2,2,3,136,77,44,58,133,244
],[
2,2,3,2,2,3,2,3,2,3,3,2,2,3,168,184,110,72,186,147
],[
236,228,232,69,93,56,44,245,30,199,82,75,5,148,161,130,50,214,189,191
],[
8,243,204,161,118,172,216,25,123,149,116,124,233,201,163,214,105,219,245,130
],[
191,16,243,247,79,203,189,229,224,72,242,129,161,141,208,28,105,158,157,251
],[
67,241,69,99,42,33,68,243,17,230,198,55,39,69,13,121,88,4,20,218
],[
23,97,114,162,91,4,128,213,231,49,190,7,207,66,115,112,56,85,148,67
],[
95,66,231,60,221,208,104,120,41,40,236,138,94,137,4,203,62,62,36,241
],[
119,205,5,228,38,114,71,205,154,203,91,111,90,213,160,186,105,23,204,157
],[
200,29,142,29,61,40,114,164,83,36,4,155,162,218,56,58,80,103,9,159
],[
216,237,97,30,10,136,57,217,84,132,1,144,63,205,66,186,60,166,130,212
],[
161,158,104,249,239,192,32,179,86,11,1,17,123,34,109,249,120,68,249,192
],[
36,125,206,248,150,30,80,137,228,108,253,4,48,149,151,51,230,232,133,245
],[
63,68,119,72,10,209,73,168,171,239,42,152,100,108,253,126,211,250,255,179
]
]