aLevelData = [
[
12,2,2,2,2,2,2,43,106,250,206,120,249,41,239,78,14,100,21,152
],[
2,2,2,2,2,2,2,57,7,250,186,158,188,115,198,83,77,243,243,9
],[
2,2,3,3,3,3,3,182,81,75,239,127,203,163,211,72,74,208,138,166
],[
11,2,3,2,2,2,2,232,24,147,45,175,231,247,206,163,195,115,100,3
],[
130,217,137,205,187,180,174,128,122,43,107,37,56,40,19,144,10,185,140,228
],[
24,182,93,85,81,164,9,50,93,217,156,34,211,225,131,174,173,33,160,255
],[
249,186,158,233,209,176,130,41,140,76,131,235,54,190,28,144,62,7,95,173
],[
111,22,140,87,33,49,226,158,177,151,181,87,46,100,193,31,85,180,190,156
],[
192,11,53,6,90,245,145,230,22,233,121,30,225,115,93,42,213,147,79,165
],[
175,96,21,15,131,240,124,205,174,124,239,113,13,192,71,60,108,161,229,225
],[
65,18,254,140,155,56,55,35,85,204,114,204,143,194,231,175,94,40,118,253
],[
195,80,59,49,218,49,100,150,84,11,63,9,39,74,151,0,132,173,65,203
],[
10,167,242,26,57,6,84,192,41,210,88,182,124,120,205,99,145,39,50,26
],[
250,123,200,229,49,89,236,129,134,26,164,169,92,235,120,152,149,115,131,201
],[
75,183,201,1,193,59,203,143,153,106,89,210,71,56,168,253,197,6,164,23
],[
136,198,135,70,180,95,171,76,140,83,156,82,44,159,114,229,122,227,94,62
],[
90,194,130,198,33,140,6,217,77,26,104,202,115,250,19,40,120,205,52,64
],[
4,236,201,227,52,82,250,106,143,182,173,246,60,247,85,253,114,189,10,2
],[
47,94,223,163,45,254,112,217,18,251,186,124,230,136,48,5,203,151,11,152
],[
232,253,225,66,167,208,121,127,32,20,222,255,213,151,178,169,159,26,197,225
]
]