aLevelData = [
[
2,2,2,2,5,5,2,2,2,2,2,2,2,2,2,2,2,2,2,36
],[
2,2,2,4,2,2,2,2,2,2,2,5,2,2,2,5,2,5,2,22
],[
5,3,3,3,5,5,3,3,3,3,3,3,3,3,3,3,3,3,2,28
],[
2,3,2,2,2,2,2,2,2,3,2,2,2,2,3,2,2,2,2,36
],[
2,3,2,2,2,2,2,2,2,3,2,2,2,2,3,2,2,2,5,177
],[
2,3,2,2,3,2,2,2,2,3,2,2,2,2,3,2,2,2,5,76
],[
2,3,2,2,3,2,2,2,2,3,2,2,2,2,3,2,2,2,5,34
],[
2,3,2,2,3,5,5,3,3,3,3,3,2,2,3,2,2,2,5,93
],[
2,3,3,2,3,2,2,3,2,2,2,3,2,2,3,2,5,5,5,104
],[
2,2,3,2,3,2,2,3,2,1,2,3,2,2,3,2,5,2,2,67
],[
2,2,3,2,3,2,2,3,2,2,2,3,2,2,3,2,5,2,2,46
],[
2,2,3,2,3,2,2,3,2,2,2,3,2,2,3,2,5,2,2,167
],[
2,2,2,2,3,2,2,3,2,2,2,3,2,2,2,2,5,5,2,126
],[
106,195,12,33,68,37,79,94,191,97,218,66,194,141,248,63,5,81,68,210
],[
37,167,98,99,248,222,236,109,30,229,175,222,216,198,24,193,29,113,233,26
],[
235,187,48,17,220,166,122,83,249,227,68,182,210,149,178,28,207,88,132,153
],[
193,130,69,216,188,169,197,186,41,101,202,65,23,86,3,173,210,105,61,228
],[
183,88,217,23,70,112,126,163,121,151,11,53,84,141,208,50,190,114,253,86
],[
143,137,90,155,234,59,57,92,205,95,170,186,230,184,237,63,169,191,45,193
],[
159,163,107,137,1,143,184,181,133,43,167,219,120,101,2,239,13,113,188,103
]
]