aLevelData = [
[
2,2,2,2,2,2,2,2,2,2,2,2,2,2,2,2,2,2,197,162
],[
2,2,2,2,2,2,2,2,2,2,2,2,2,2,2,2,2,2,75,191
],[
2,2,2,2,2,2,2,2,2,2,2,2,2,2,2,2,2,4,139,97
],[
32,81,226,114,237,39,232,9,107,39,185,101,40,184,238,75,42,215,99,180
],[
213,104,62,195,15,201,44,249,161,173,238,172,224,40,21,181,142,6,9,106
],[
251,97,80,204,111,115,13,1,204,168,199,4,112,247,108,155,89,115,150,137
],[
140,29,12,5,183,253,140,108,21,113,200,51,146,196,174,31,48,2,236,184
],[
169,11,180,251,86,231,188,79,79,89,138,186,212,183,238,85,235,248,208,253
],[
75,15,43,76,121,120,90,199,49,16,147,89,7,41,177,1,78,222,54,199
],[
57,164,144,244,64,34,155,130,197,67,104,210,248,137,61,157,248,164,220,45
],[
59,67,8,205,47,42,70,126,33,132,225,235,95,123,48,159,153,7,27,118
],[
141,3,220,81,228,134,3,14,86,112,189,184,21,67,85,250,105,53,251,218
],[
151,131,197,164,8,7,243,35,167,13,119,23,139,99,181,228,214,175,135,136
],[
221,5,132,207,137,185,130,202,253,114,89,125,120,128,234,216,125,112,96,233
],[
50,221,182,79,7,137,122,242,151,172,208,241,211,139,185,220,93,77,149,36
],[
50,10,231,207,140,38,89,112,7,221,0,87,2,30,224,5,72,157,179,227
],[
240,36,230,51,129,41,229,70,90,166,152,239,81,37,45,57,155,26,25,85
],[
236,118,89,214,222,121,254,33,151,200,232,30,166,191,210,52,47,8,143,117
],[
72,109,146,21,162,234,180,33,108,7,50,109,116,101,245,207,144,150,23,138
],[
60,49,162,13,132,38,155,222,37,80,63,209,239,73,140,125,109,130,3,240
]
]