aLevelData = [
[
2,2,2,2,2,2,2,2,2,6,5,2,2,2,2,2,2,2,2,187
],[
2,3,5,3,5,5,5,3,5,3,5,2,5,3,5,3,5,5,2,216
],[
2,3,2,3,2,2,2,3,5,3,5,2,5,3,5,3,5,5,3,176
],[
2,2,2,2,2,2,2,2,2,2,2,2,5,5,5,5,5,5,3,144
],[
2,3,5,3,5,5,5,3,2,3,5,5,5,3,2,3,5,5,3,232
],[
2,3,5,3,5,5,5,3,2,3,5,5,5,3,2,3,5,5,3,99
],[
2,5,5,5,5,5,5,5,5,5,5,5,5,2,2,5,5,5,3,23
],[
2,3,5,3,5,5,5,3,5,3,5,5,5,3,5,3,5,5,3,128
],[
2,3,5,3,5,5,5,3,5,3,5,5,5,3,5,3,5,5,3,236
],[
2,5,5,5,5,5,5,5,5,5,5,5,5,5,5,5,5,5,3,37
],[
2,3,5,3,2,2,2,3,2,3,2,2,2,3,2,3,5,5,3,177
],[
5,3,5,3,2,2,2,3,2,3,2,2,2,3,2,3,5,5,3,86
],[
5,5,5,5,5,5,5,5,5,5,5,5,5,5,5,5,5,5,3,182
],[
27,17,175,135,86,153,174,3,182,53,227,137,246,73,114,192,232,231,113,114
],[
2,70,145,158,26,111,1,200,110,58,143,148,231,121,17,147,159,115,3,93
],[
160,148,113,224,239,98,24,247,201,179,200,63,44,29,12,38,153,175,13,68
],[
25,222,180,239,126,194,15,9,235,131,246,29,150,14,238,170,205,12,77,191
],[
55,20,159,200,93,31,73,168,104,61,108,8,44,135,12,238,102,85,114,145
],[
66,177,206,108,33,11,33,145,152,46,90,64,188,114,191,184,157,51,143,77
],[
16,131,230,187,178,28,224,186,41,152,1,210,173,229,213,113,200,243,211,59
]
]