aLevelData = [
[
6,2,2,2,2,2,2,160,12,17,151,245,251,182,142,158,143,140,153,21
],[
2,2,2,2,2,2,2,173,240,117,170,174,232,221,192,191,252,12,57,135
],[
2,2,2,2,2,2,2,71,125,47,11,205,245,229,207,15,195,253,62,221
],[
3,3,3,3,3,3,3,70,235,76,108,177,169,90,168,11,172,90,203,122
],[
2,2,2,2,2,2,2,24,51,47,192,48,103,96,6,16,243,118,217,158
],[
2,2,2,2,2,2,2,119,162,114,190,150,6,58,197,160,202,141,49,110
],[
2,2,2,2,2,3,2,108,190,151,142,87,92,220,161,184,180,168,0,141
],[
2,2,3,3,3,3,3,151,24,166,254,94,179,74,241,42,160,203,217,113
],[
2,2,2,2,2,2,2,22,209,206,182,19,178,227,151,81,146,180,13,118
],[
2,2,2,2,2,2,2,207,62,240,138,156,244,185,175,235,15,140,12,145
],[
3,3,3,3,3,3,3,37,118,11,164,253,243,196,40,162,179,185,235,182
],[
2,2,2,2,2,2,2,157,195,174,9,21,76,133,106,122,191,129,189,243
],[
2,2,2,2,2,2,2,61,139,78,108,146,147,101,219,103,235,27,200,184
],[
2,2,3,3,3,3,3,237,107,12,137,228,140,217,213,42,126,250,200,141
],[
2,2,3,2,2,2,2,228,92,46,247,17,206,42,79,101,5,43,154,218
],[
227,28,102,218,249,219,104,84,74,237,100,14,81,112,77,61,70,80,174,83
],[
158,190,72,24,209,222,252,252,95,192,236,171,21,146,222,227,140,20,225,130
],[
244,76,50,228,15,122,96,107,128,78,175,95,70,89,186,249,132,194,93,186
],[
131,58,210,1,249,49,26,221,140,74,159,32,146,13,23,181,27,221,171,51
],[
49,41,89,177,94,230,151,221,111,60,57,72,120,127,148,4,24,98,228,113
]
]