aLevelData = [
[
4,2,5,5,2,2,247,79,251,8,34,195,254,40,143,89,237,142,1,81
],[
2,2,2,2,2,2,82,173,242,214,6,17,143,233,79,239,3,155,76,1
],[
2,2,2,2,2,2,248,127,147,144,91,95,24,211,96,46,81,119,199,62
],[
3,3,3,3,3,3,151,127,93,179,208,78,197,56,75,2,120,240,235,4
],[
2,2,3,2,2,2,11,175,136,221,177,107,146,76,0,237,247,149,248,204
],[
13,2,3,2,2,2,71,27,65,156,23,49,180,99,163,46,29,76,183,191
],[
2,5,3,2,2,2,63,160,207,130,25,241,125,208,104,153,11,218,109,99
],[
97,247,240,135,42,60,133,220,51,78,14,73,19,116,129,124,17,240,236,223
],[
66,144,182,200,242,128,39,241,69,98,42,39,30,160,82,70,64,1,28,100
],[
180,123,116,77,106,73,122,48,35,61,133,151,141,86,104,156,176,149,245,90
],[
138,13,192,163,246,58,38,241,211,147,141,158,97,98,236,87,238,212,143,206
],[
179,76,20,175,249,253,186,214,128,184,219,191,32,2,182,61,177,106,114,111
],[
41,26,96,240,4,171,129,79,233,62,72,191,138,200,160,15,204,173,49,220
],[
40,145,223,5,80,106,148,95,22,218,64,170,138,189,30,196,99,254,56,29
],[
161,174,45,107,112,87,50,159,78,141,87,23,112,199,12,21,98,109,227,112
],[
239,50,151,137,64,164,78,129,72,1,27,169,95,77,199,58,44,161,209,71
],[
201,198,179,239,34,3,103,215,158,50,42,216,2,25,128,244,146,248,120,143
],[
121,95,49,219,106,66,157,149,136,79,133,239,131,127,205,205,4,236,250,51
],[
76,226,241,254,24,56,1,211,199,225,36,86,190,190,130,156,12,182,55,226
],[
74,9,86,127,197,225,46,23,224,43,204,18,179,164,193,76,248,55,37,14
]
]