aLevelData = [
[
2,2,2,2,2,2,2,2,2,2,185,242,73,172,249,164,32,159,250,81
],[
2,2,2,2,2,2,2,2,2,2,68,244,251,146,248,177,121,58,213,222
],[
2,2,2,2,2,2,2,2,2,2,235,57,25,139,176,193,66,21,70,167
],[
2,2,2,3,3,3,3,3,3,3,220,166,188,11,151,251,106,59,156,106
],[
2,2,2,2,2,2,2,2,2,2,223,213,33,35,27,44,59,182,255,237
],[
2,2,2,2,2,2,2,2,2,2,244,213,1,3,158,91,36,183,103,142
],[
2,2,2,2,2,3,2,2,3,2,40,28,45,161,253,170,147,126,126,41
],[
84,194,92,209,215,8,88,175,4,106,182,74,87,69,238,135,50,61,164,202
],[
120,129,218,94,87,80,101,23,101,189,157,53,239,175,89,140,141,43,27,226
],[
250,214,135,153,35,181,26,142,126,56,24,64,157,119,198,53,3,187,218,153
],[
54,64,48,41,22,57,190,79,108,21,202,142,198,1,90,33,131,174,237,223
],[
42,84,104,98,0,247,83,104,217,233,69,121,46,144,157,203,112,105,115,98
],[
156,77,207,123,16,243,24,43,157,183,207,68,221,153,125,120,198,137,233,193
],[
128,226,143,0,116,52,78,228,166,70,97,13,68,91,144,113,127,181,167,255
],[
153,88,40,131,63,16,61,202,26,181,240,6,161,174,158,115,49,180,169,59
],[
95,216,110,152,141,200,119,56,187,78,241,229,160,25,96,101,249,192,145,159
],[
34,4,208,0,227,86,92,29,140,153,24,154,68,40,131,74,158,27,234,151
],[
109,198,221,37,218,131,223,178,179,178,97,65,6,253,242,119,239,225,176,69
],[
174,105,2,199,252,61,137,108,160,220,83,88,61,38,82,6,110,29,13,50
],[
20,236,150,246,239,41,188,51,108,87,129,50,190,175,207,139,48,32,102,70
]
]