aLevelData = [
[
2,2,2,2,2,11,2,2,2,129,159,103,83,181,78,181,156,136,15,5
],[
2,2,2,2,2,2,2,2,2,48,120,116,114,84,11,0,68,190,110,57
],[
5,2,5,2,5,5,5,2,5,183,74,91,254,255,238,63,27,136,240,157
],[
5,2,5,2,5,2,5,2,5,27,130,86,173,94,157,159,74,107,17,176
],[
5,5,5,2,5,5,5,2,5,11,134,226,17,175,134,98,89,190,225,247
],[
5,2,5,2,5,2,5,2,5,231,109,9,30,211,194,251,176,36,250,20
],[
5,2,5,2,5,2,5,2,5,101,68,40,39,150,177,30,206,71,244,144
],[
2,2,2,12,2,2,2,2,2,253,100,215,119,221,75,211,180,215,139,200
],[
2,2,7,2,2,2,2,2,8,246,238,235,241,221,83,175,22,96,51,22
],[
2,2,7,2,5,5,5,2,5,3,108,212,39,58,205,224,173,229,82,1
],[
2,2,7,2,5,2,2,2,2,129,14,44,173,7,18,152,68,251,83,190
],[
2,2,7,2,5,5,5,2,2,88,110,46,216,75,11,45,150,32,159,125
],[
2,2,7,2,5,2,2,2,2,193,139,217,162,32,74,78,105,152,184,191
],[
2,2,7,2,5,5,5,2,5,30,150,160,159,0,178,79,208,242,140,237
],[
2,2,2,2,2,2,2,2,2,174,115,250,13,78,208,102,130,7,152,113
],[
13,2,2,2,3,3,3,3,3,116,50,81,220,180,47,105,169,77,169,112
],[
2,2,2,2,2,2,2,2,2,125,92,26,132,73,33,145,12,41,85,179
],[
2,2,2,2,2,2,2,2,2,169,141,190,255,105,150,2,87,62,195,185
],[
2,2,2,2,2,2,2,2,2,188,175,204,197,90,206,206,230,196,106,169
],[
137,128,133,166,225,198,8,94,57,133,182,215,137,167,95,239,71,150,86,254
]
]