aLevelData = [
[
4,2,2,2,2,2,2,2,2,2,2,2,2,2,2,2,2,2,2,2
],[
5,2,5,3,2,2,2,2,2,2,2,2,2,2,2,2,2,2,2,2
],[
2,5,5,3,3,3,3,3,3,3,3,3,3,3,3,3,3,3,2,2
],[
3,3,5,5,5,5,5,5,5,5,3,2,2,2,2,2,2,2,2,2
],[
2,3,5,5,5,5,5,5,5,5,3,6,2,2,2,2,2,2,2,2
],[
3,3,5,5,5,5,3,3,3,3,3,3,3,3,3,2,3,3,3,3
],[
3,5,5,5,5,5,3,2,2,2,2,2,2,2,2,2,2,2,2,2
],[
3,5,5,3,3,3,3,8,2,2,2,5,5,5,5,5,5,5,5,5
],[
3,5,5,3,2,2,3,3,3,3,2,5,3,3,3,5,3,3,3,3
],[
3,5,5,3,2,2,2,2,2,3,2,5,3,5,5,5,5,5,5,5
],[
3,5,5,3,2,2,3,2,2,3,2,5,3,5,5,5,5,5,5,1
],[
5,5,5,3,2,2,3,2,2,3,2,5,3,5,5,5,5,5,5,5
],[
88,169,59,36,250,114,12,107,58,185,101,24,80,98,233,77,165,194,232,50
],[
150,87,60,69,116,182,112,241,207,196,40,99,244,41,188,153,180,2,39,187
],[
103,214,32,175,49,204,134,232,132,27,1,126,230,193,231,132,245,120,92,150
],[
168,230,190,177,215,20,64,71,254,33,212,147,62,56,79,43,164,191,199,212
],[
174,209,64,153,11,239,136,31,163,242,96,51,215,68,220,165,10,80,13,89
],[
96,55,221,155,197,197,57,179,50,163,118,185,43,206,237,171,141,71,233,189
],[
134,13,196,240,229,72,76,230,148,199,107,245,98,172,8,122,6,102,40,112
],[
97,224,89,65,4,248,80,219,242,51,209,7,167,175,207,246,89,89,213,29
]
]