aLevelData = [
[
2,2,2,5,2,2,2,5,2,195,193,225,100,162,69,50,29,187,113,140
],[
180,67,52,114,183,95,177,204,121,231,239,210,101,105,210,43,147,113,74,86
],[
153,7,202,74,164,122,252,89,199,92,179,90,146,206,33,7,231,254,74,164
],[
9,237,184,226,246,118,112,2,247,140,38,61,117,195,173,100,14,17,177,196
],[
232,214,168,76,69,27,6,242,88,23,176,82,88,248,180,152,210,224,55,161
],[
67,45,175,93,230,253,82,120,203,241,205,57,41,50,58,170,245,178,76,249
],[
179,181,205,30,141,143,75,190,162,175,14,79,160,220,77,126,149,191,161,205
],[
2,162,185,129,50,119,80,187,201,28,92,229,160,221,136,79,208,59,229,26
],[
13,235,220,86,54,34,104,103,41,16,130,173,220,170,220,100,170,173,209,200
],[
234,224,156,125,198,153,201,47,75,130,234,118,188,157,139,252,44,134,104,225
],[
75,249,221,94,129,147,157,169,57,221,167,25,128,134,118,139,206,240,120,4
],[
35,239,194,152,86,205,2,138,170,145,181,180,163,128,154,41,24,229,102,26
],[
136,14,185,246,178,151,81,213,95,235,126,23,131,7,213,72,132,129,41,71
],[
218,201,183,168,216,176,161,86,201,38,158,125,63,72,239,167,168,154,149,37
],[
34,144,193,176,145,84,140,80,238,195,232,125,226,184,214,132,147,142,218,45
],[
190,224,172,155,6,147,49,115,139,23,169,65,191,233,42,23,117,93,77,119
],[
59,154,39,114,234,230,123,18,123,36,45,246,28,154,250,60,131,248,103,164
],[
131,150,247,241,221,254,161,147,88,170,129,132,20,15,206,112,27,218,12,24
],[
57,121,131,248,14,221,239,39,97,126,121,128,183,160,230,255,36,213,15,109
],[
98,196,145,64,32,40,197,189,156,28,243,95,116,149,194,124,186,48,243,38
]
]