aLevelData = [
[
2,2,2,2,2,12,93,209,239,22,72,43,199,23,240,122,73,137,238,193
],[
2,3,5,3,5,246,61,230,225,188,181,94,26,109,206,208,207,112,161,253
],[
2,3,2,3,2,137,183,172,133,63,240,45,181,213,0,207,160,226,173,136
],[
2,2,2,2,2,113,182,154,194,255,156,121,185,162,92,124,36,70,4,12
],[
2,3,5,3,5,23,189,232,190,40,90,232,131,209,187,241,31,21,230,199
],[
2,3,5,3,5,220,102,152,1,127,199,217,85,123,46,212,21,101,44,230
],[
2,5,5,5,5,250,168,207,245,33,122,200,3,83,14,201,2,137,11,49
],[
234,175,62,235,10,169,139,147,155,148,42,219,155,78,16,46,217,56,170,147
],[
76,58,209,211,168,8,251,222,51,164,174,107,213,37,59,223,111,182,168,112
],[
110,225,238,138,160,14,101,113,70,70,124,41,106,61,173,147,115,144,176,216
],[
246,75,239,10,207,174,59,9,113,49,189,164,122,197,47,1,139,93,76,63
],[
86,173,132,89,248,49,245,78,138,114,151,127,242,133,182,88,255,212,166,50
],[
182,33,178,120,230,199,85,9,3,67,173,222,48,244,44,237,158,31,145,77
],[
21,54,22,154,208,90,235,155,142,30,228,34,230,142,111,52,219,112,200,106
],[
176,201,112,151,254,163,219,171,3,14,104,216,61,101,151,243,55,210,119,28
],[
164,20,93,161,170,128,219,32,128,70,240,236,59,246,125,178,229,67,248,93
],[
208,6,100,54,41,134,129,80,208,246,64,35,103,63,121,119,170,0,224,132
],[
254,211,54,87,76,211,188,119,15,91,237,201,172,16,108,177,3,33,60,122
],[
67,205,47,248,2,38,161,107,141,21,101,167,124,159,0,114,138,102,21,46
],[
164,115,33,184,64,50,105,143,240,190,48,57,55,95,44,226,155,82,59,71
]
]