aLevelData = [
[
2,2,2,2,2,2,182,51,12,62,99,244,178,218,42,22,43,16,224,39
],[
2,2,2,2,2,2,160,249,144,21,24,13,33,65,62,219,50,213,101,254
],[
2,2,2,2,2,2,73,88,201,76,45,127,24,80,144,70,49,251,241,64
],[
2,2,2,3,3,3,43,150,193,43,153,251,197,200,12,5,187,234,218,69
],[
2,2,2,2,2,2,64,204,30,246,241,167,0,51,209,132,55,104,235,79
],[
2,2,2,2,2,2,204,7,56,46,32,124,194,17,48,98,10,137,24,247
],[
2,2,2,2,2,3,167,221,214,205,49,91,81,195,93,236,154,52,105,235
],[
2,2,2,3,3,3,113,110,187,55,11,102,197,135,18,170,43,254,238,150
],[
2,2,2,2,2,2,40,0,67,203,46,67,186,221,204,41,5,76,213,77
],[
2,2,2,2,2,2,29,182,191,91,206,74,73,38,118,128,96,244,10,7
],[
2,2,3,3,3,3,68,28,89,255,231,212,149,105,150,68,15,220,218,223
],[
2,2,2,2,2,2,66,121,161,242,19,33,153,125,87,229,221,67,150,189
],[
211,29,14,125,84,147,251,6,14,173,22,185,39,7,92,50,35,36,16,50
],[
8,4,3,220,192,249,19,37,190,182,242,134,229,169,41,243,165,139,92,17
],[
103,53,207,164,43,181,41,70,111,161,120,95,83,171,118,81,252,118,11,243
],[
54,168,18,65,93,65,96,82,125,43,2,138,184,17,199,16,232,117,255,130
],[
134,253,129,232,203,14,243,231,20,156,69,56,139,65,127,88,4,140,189,128
],[
37,155,119,215,202,236,6,231,167,112,100,77,48,225,52,181,181,86,2,6
],[
210,21,203,218,6,168,192,49,162,51,71,102,229,4,67,98,101,108,149,15
],[
176,205,227,15,52,245,151,175,92,170,43,22,252,134,165,195,239,6,93,54
]
]