aLevelData = [
[
2,2,2,2,2,2,2,2,2,20,162,105,113,50,151,226,64,85,182,36
],[
2,2,13,5,5,2,2,12,5,216,177,123,142,175,47,54,0,179,87,95
],[
2,2,2,5,5,2,2,2,5,225,60,115,41,103,63,241,89,18,196,10
],[
2,2,2,2,2,2,2,2,2,89,122,154,161,136,75,73,110,213,142,72
],[
2,2,2,2,2,2,2,2,2,91,140,42,112,46,111,170,177,105,9,64
],[
2,2,2,2,2,2,2,2,2,4,110,63,10,160,231,40,149,113,101,31
],[
2,2,2,2,2,2,2,2,2,160,198,71,22,34,74,222,45,142,53,207
],[
2,2,2,2,2,2,2,2,2,131,85,195,184,75,172,230,22,35,145,55
],[
2,2,2,2,2,2,2,2,2,102,162,8,51,138,48,171,164,111,27,97
],[
2,2,2,2,2,2,2,2,2,93,237,231,110,42,238,229,172,7,211,7
],[
23,144,19,242,143,185,37,85,218,191,161,121,233,95,162,26,92,69,110,118
],[
72,199,89,163,55,211,230,37,112,38,48,192,121,191,136,139,219,148,96,70
],[
37,131,104,237,51,139,246,141,176,60,171,87,218,108,84,243,133,44,14,23
],[
99,251,174,87,130,57,95,63,22,222,141,159,121,107,2,38,112,33,79,50
],[
176,113,110,231,161,181,165,127,97,29,173,224,12,236,20,116,59,228,224,53
],[
202,254,117,7,223,95,185,75,39,136,117,177,99,205,255,77,36,8,22,238
],[
210,142,13,171,243,98,44,190,170,169,83,150,126,94,224,39,93,71,211,133
],[
225,40,48,177,210,54,165,178,235,206,109,232,225,103,116,158,161,198,188,222
],[
217,113,255,137,187,101,150,167,254,11,153,251,37,105,72,218,3,149,169,62
],[
127,112,115,23,149,144,43,225,157,126,141,123,208,34,45,55,8,123,94,46
]
]