aLevelData = [
[
2,2,2,2,59,13,97,56,172,17,144,59,54,1,94,62,39,127,48,32
],[
2,2,2,2,181,121,143,90,67,92,135,215,224,132,76,7,17,248,36,47
],[
2,2,2,2,208,84,128,3,212,6,108,118,19,189,42,209,134,31,26,2
],[
2,2,2,3,44,187,222,55,81,62,186,172,16,233,65,193,23,66,46,80
],[
2,2,2,2,170,10,144,61,235,112,42,79,88,132,25,62,149,238,183,13
],[
2,2,2,2,108,224,192,153,18,73,179,115,171,76,123,235,17,240,79,109
],[
2,2,2,2,209,25,215,17,119,183,144,109,12,61,113,174,220,85,207,231
],[
2,2,2,3,125,209,126,168,12,229,57,211,186,148,67,171,135,105,79,46
],[
2,2,2,2,78,103,158,165,2,66,103,121,55,208,123,72,228,186,41,56
],[
2,2,2,2,103,119,95,139,201,123,19,116,68,171,225,41,2,21,246,58
],[
2,2,3,3,40,222,44,33,19,123,118,26,225,36,127,53,52,134,142,169
],[
2,2,2,2,50,185,173,107,209,113,10,255,81,120,157,143,10,92,11,58
],[
2,2,2,2,103,101,203,174,51,201,135,249,19,35,197,156,84,34,198,225
],[
2,2,3,3,231,126,174,111,170,49,230,28,234,227,191,2,37,166,88,213
],[
2,2,3,2,20,227,193,116,232,148,96,189,213,180,148,166,205,244,153,137
],[
2,2,3,2,142,176,172,192,222,33,111,114,21,212,142,172,221,91,163,180
],[
2,2,3,3,54,66,87,154,189,69,202,15,45,191,54,122,38,102,207,73
],[
2,2,2,2,45,54,237,133,245,171,108,170,220,51,83,181,185,227,181,126
],[
213,105,213,72,55,66,141,151,37,45,241,66,231,223,47,200,206,248,186,231
],[
117,54,167,107,71,232,87,69,65,166,86,220,249,64,131,168,224,244,113,252
]
]