aLevelData = [
[
2,2,2,2,2,2,2,2,2,6,5,2,2,2,2,2,2,2,2,2
],[
2,3,5,3,5,5,5,3,5,3,5,2,5,3,5,3,5,5,2,2
],[
2,3,2,3,2,2,2,3,5,3,5,2,5,3,5,3,5,5,3,2
],[
2,2,2,2,2,2,2,2,2,2,2,2,5,5,5,5,5,5,3,2
],[
2,3,5,3,5,5,5,3,2,3,5,5,5,3,2,3,5,5,3,2
],[
2,3,5,3,5,5,5,3,2,3,5,5,5,3,2,3,5,5,3,2
],[
2,5,5,5,5,5,5,5,5,5,5,5,5,2,2,5,5,5,3,2
],[
2,3,5,3,5,5,5,3,5,3,5,5,5,3,5,3,5,5,3,2
],[
2,3,5,3,5,5,5,3,5,3,5,5,5,3,5,3,5,5,3,2
],[
2,5,5,5,5,5,5,5,5,5,5,5,5,5,5,5,5,5,3,2
],[
2,3,5,3,2,2,2,3,2,3,2,2,2,3,2,3,5,5,3,2
],[
5,3,5,3,2,2,2,3,2,3,2,2,2,3,2,3,5,5,3,2
],[
5,5,5,5,5,5,5,5,5,5,5,5,5,5,5,5,5,5,3,2
],[
5,3,5,3,5,5,5,3,5,3,5,5,2,3,2,3,5,5,3,2
],[
29,240,161,68,168,69,2,62,160,231,189,102,88,111,89,60,33,120,83,82
],[
16,82,8,165,2,251,212,45,222,74,124,179,26,110,201,227,129,151,118,162
],[
51,243,77,162,237,220,140,51,138,80,141,92,202,161,166,42,83,109,79,72
],[
245,209,130,208,50,218,104,97,254,60,49,114,195,71,67,229,168,22,152,223
],[
19,10,97,216,108,119,240,238,37,156,212,127,247,217,70,246,110,28,196,229
],[
167,157,251,85,89,203,234,90,18,133,69,234,195,142,23,238,127,59,172,154
]
]