aLevelData = [
[
2,2,3,3,3,3,3,3,3,3,3,3,225,226,130,37,98,44,123,249
],[
2,2,2,2,2,2,2,2,2,2,2,2,241,157,12,219,205,202,133,174
],[
3,2,3,3,3,3,3,3,3,3,3,2,217,87,13,205,148,23,55,80
],[
2,2,2,2,2,2,2,2,2,2,2,2,75,116,214,139,142,18,19,216
],[
3,2,3,3,3,3,3,3,3,3,3,3,224,175,188,151,178,78,223,114
],[
147,148,152,230,161,114,39,254,67,4,69,98,26,185,185,145,52,181,38,107
],[
131,115,39,242,142,175,157,81,103,131,72,30,221,208,149,220,242,223,183,196
],[
144,72,249,197,119,19,83,201,122,30,59,58,235,190,189,196,84,169,206,93
],[
103,20,222,131,56,24,172,197,170,90,94,133,39,235,209,252,149,109,46,127
],[
133,120,190,0,173,60,255,215,152,103,247,195,156,73,200,43,13,53,133,170
],[
176,43,68,203,114,181,116,17,90,15,113,59,189,138,86,197,177,50,19,178
],[
195,175,191,137,237,105,47,158,194,240,199,146,236,154,144,29,216,110,139,11
],[
176,64,69,133,138,30,172,146,223,235,33,222,62,74,206,185,65,190,58,98
],[
193,15,26,134,70,239,107,4,193,221,189,243,126,74,210,230,84,250,103,110
],[
31,174,82,225,112,0,205,90,130,142,18,1,112,90,40,141,166,113,252,7
],[
149,203,179,208,172,115,63,229,131,231,48,98,89,194,205,69,192,152,100,117
],[
151,34,222,3,57,155,150,175,244,105,108,174,189,0,21,170,33,4,181,11
],[
127,173,175,117,117,112,187,145,152,220,58,17,104,194,199,238,131,152,15,244
],[
24,31,226,129,159,68,138,138,199,68,91,222,176,20,139,175,91,0,68,78
],[
95,146,248,54,221,181,245,76,181,26,57,101,250,219,135,9,164,95,186,119
]
]