aLevelData = [
[
2,116,6,252,135,78,176,152,43,64,131,100,52,23,105,179,127,204,195,118
],[
2,8,255,8,83,173,160,175,247,53,240,80,172,144,168,6,46,96,119,23
],[
2,186,185,178,215,105,37,72,201,188,236,244,8,120,146,182,229,180,160,131
],[
2,210,48,168,60,127,232,131,221,66,233,221,247,188,100,244,96,186,1,156
],[
2,40,89,117,135,208,110,87,195,183,36,47,132,213,231,209,36,171,129,233
],[
2,104,122,131,214,5,180,231,188,98,176,243,212,160,161,97,7,216,201,188
],[
2,188,163,234,13,238,224,254,183,129,177,39,160,214,199,233,145,157,224,151
],[
2,224,234,141,11,76,139,57,154,40,154,103,72,188,78,59,55,232,22,60
],[
2,102,10,233,88,152,34,215,41,145,52,229,118,136,238,23,253,218,139,206
],[
2,111,252,247,84,189,179,52,182,146,135,252,210,32,117,168,176,32,228,80
],[
2,22,20,218,52,86,208,112,90,107,56,131,121,68,75,173,22,96,97,115
],[
2,237,155,176,192,146,72,21,147,88,127,18,244,114,184,19,44,88,153,245
],[
2,53,109,13,200,112,222,150,212,150,205,228,219,241,175,166,158,204,242,160
],[
2,162,40,227,254,52,176,208,232,171,239,105,86,237,193,108,38,53,7,130
],[
2,108,19,159,100,9,180,148,65,127,99,145,100,3,80,156,18,212,144,0
],[
2,177,204,102,139,48,52,193,250,162,221,5,178,44,108,14,177,34,246,115
],[
2,195,109,205,7,249,48,153,166,87,171,170,46,205,95,140,203,105,114,220
],[
120,202,86,91,194,216,166,65,207,178,80,212,160,232,249,56,147,235,157,137
],[
44,193,118,39,20,253,32,81,98,239,250,246,26,24,207,199,243,224,182,145
],[
94,140,54,202,195,106,174,106,14,78,244,252,106,66,61,244,76,122,61,67
]
]