aLevelData = [
[
2,2,2,2,2,2,2,156,146,80,163,175,107,202,106,5,175,112,99,152
],[
2,2,2,2,2,2,2,187,59,118,67,81,244,25,50,62,71,22,150,57
],[
2,2,2,2,2,2,2,25,143,157,15,27,64,161,253,159,5,160,93,171
],[
2,2,2,13,2,2,2,156,236,134,76,171,35,237,45,5,98,144,104,41
],[
2,2,2,2,2,2,2,182,148,156,12,211,44,64,24,9,190,55,116,115
],[
2,2,2,2,2,2,2,65,164,134,114,234,255,182,89,7,105,117,106,43
],[
2,2,2,2,2,2,2,60,126,2,139,231,92,16,168,249,45,203,46,123
],[
2,2,2,2,2,2,2,165,165,28,131,86,122,38,6,46,14,88,238,65
],[
2,2,11,2,2,2,2,182,251,108,200,85,188,144,106,138,11,23,187,40
],[
2,2,2,2,2,2,2,194,132,3,231,7,114,64,89,115,40,110,31,116
],[
2,2,2,2,2,2,2,110,5,92,239,159,196,106,42,0,173,204,234,80
],[
2,2,2,2,2,2,2,81,100,216,160,77,230,41,101,21,141,126,204,240
],[
2,2,2,2,2,2,2,13,9,77,68,200,242,131,20,68,249,59,199,221
],[
2,2,2,2,2,2,2,92,203,43,183,251,165,185,247,186,43,27,51,39
],[
2,9,2,2,2,2,2,197,235,38,93,49,190,169,40,27,97,223,105,238
],[
2,2,2,2,2,2,2,98,175,188,233,210,119,89,117,74,254,56,182,44
],[
171,121,96,43,245,2,204,14,27,106,75,176,21,22,186,76,202,161,86,247
],[
131,129,210,110,160,232,167,18,138,233,172,49,232,220,230,135,22,3,161,5
],[
210,110,191,209,57,27,81,141,243,98,100,220,170,144,29,34,192,211,9,140
],[
65,86,174,81,22,172,102,55,124,114,109,88,181,48,56,38,253,129,8,173
]
]