aLevelData = [
[
6,2,8,2,9,2,10,2,11,3,2,155,62,93,29,248,199,44,182,92
],[
2,2,2,2,2,2,2,2,12,3,5,75,201,160,150,245,5,125,144,147
],[
2,2,3,3,3,3,3,3,3,3,2,199,163,25,72,246,111,232,128,153
],[
2,2,3,2,2,2,2,2,2,2,5,219,222,41,61,83,140,33,151,197
],[
2,2,3,2,2,2,2,2,2,2,2,245,234,107,248,149,165,173,30,162
],[
2,2,3,2,3,3,3,3,3,3,2,62,229,172,145,228,216,105,220,188
],[
2,2,3,2,2,2,2,5,5,3,2,100,197,3,214,172,109,209,96,117
],[
2,2,3,5,5,5,2,3,3,3,5,28,224,25,208,180,95,9,250,141
],[
2,2,2,2,2,2,2,2,2,2,2,19,112,128,13,156,252,166,121,250
],[
2,3,2,2,3,1,3,2,2,2,2,62,10,10,79,95,133,68,230,15
],[
2,3,2,2,3,2,3,2,2,2,2,82,131,117,191,114,215,159,16,78
],[
2,3,2,3,2,2,2,3,2,2,2,17,189,139,159,30,222,146,139,148
],[
2,3,2,3,2,2,2,3,3,3,2,12,150,16,139,210,139,166,174,251
],[
2,3,2,3,2,2,2,3,2,2,5,153,32,146,155,21,212,70,84,175
],[
2,3,2,3,2,2,3,3,2,2,2,251,43,210,237,91,5,152,216,35
],[
2,3,2,3,2,2,3,3,2,2,2,83,255,245,22,220,123,118,235,139
],[
2,3,2,3,2,2,3,3,2,2,2,33,178,244,124,102,211,255,87,42
],[
206,122,221,245,153,218,192,128,152,61,184,119,88,77,211,125,127,104,13,113
],[
3,255,32,239,155,60,157,26,115,232,60,153,36,139,112,224,227,213,63,177
],[
248,60,81,226,115,231,71,96,26,203,78,116,165,20,243,69,46,198,57,159
]
]