aLevelData = [
[
6,2,2,2,2,2,2,2,2,2,2,2,2,2,2,2,2,2,2,2
],[
2,2,2,2,2,2,2,2,2,2,2,2,2,2,2,2,2,2,2,2
],[
2,2,2,2,2,2,2,2,2,2,2,2,2,2,2,2,2,2,2,2
],[
3,3,3,3,3,3,3,3,3,3,3,3,3,3,3,3,3,3,2,2
],[
2,2,2,2,2,2,2,2,2,2,2,2,2,2,2,2,2,2,2,2
],[
2,2,2,2,2,2,2,2,2,2,2,2,2,2,2,2,2,2,2,2
],[
2,2,2,2,2,3,2,2,3,2,2,3,2,2,2,3,2,2,3,2
],[
2,2,3,3,3,3,3,3,3,3,3,3,3,3,3,3,3,3,3,3
],[
2,2,2,2,2,2,2,2,2,2,2,2,2,2,2,2,2,2,2,2
],[
2,2,2,2,2,2,2,2,2,4,2,2,2,2,2,2,2,2,2,2
],[
3,3,3,3,3,3,3,3,3,3,3,3,3,3,3,3,3,3,2,2
],[
2,2,2,2,2,2,2,2,2,2,2,2,2,2,2,2,2,3,2,2
],[
2,2,2,2,2,2,2,2,2,2,2,2,2,2,2,2,2,3,2,2
],[
2,2,3,3,3,3,3,3,3,3,2,3,3,3,3,3,3,3,2,2
],[
2,2,3,2,2,2,2,2,2,2,2,3,2,2,2,2,2,3,2,2
],[
2,2,3,2,2,2,2,2,2,2,2,3,2,2,2,2,2,3,2,2
],[
43,224,102,147,191,81,200,144,160,108,132,117,231,238,51,6,159,205,198,254
],[
225,201,202,72,61,68,235,113,92,83,183,94,228,21,165,58,156,68,86,179
],[
209,9,26,102,248,21,182,151,148,237,101,38,90,133,28,190,147,17,18,80
],[
195,24,128,192,136,202,165,222,196,147,14,151,254,240,20,109,6,130,166,36
]
]