aLevelData = [
[
6,2,8,2,9,2,10,2,11,3,2,2,5,2,2,115,46,122,16,12
],[
2,2,2,2,2,2,2,2,12,3,5,2,2,2,5,78,152,123,186,183
],[
2,2,3,3,3,3,3,3,3,3,2,2,3,3,3,62,32,70,226,152
],[
2,2,3,2,2,2,2,2,2,2,5,2,3,2,2,204,92,150,215,55
],[
2,2,3,2,2,2,2,2,2,2,2,2,3,2,2,225,246,41,43,134
],[
2,2,3,2,3,3,3,3,3,3,2,5,3,2,2,190,232,232,158,202
],[
17,200,45,216,249,31,65,142,59,101,133,191,245,151,19,234,52,218,138,3
],[
172,98,96,118,173,146,122,106,82,100,250,66,252,12,89,106,254,216,181,80
],[
154,91,108,176,45,202,233,21,166,166,190,157,60,155,243,252,97,169,158,195
],[
241,129,180,227,176,50,31,108,243,4,17,155,157,164,151,20,77,130,113,108
],[
214,120,33,234,240,172,66,143,45,183,27,83,46,7,116,178,22,129,168,103
],[
63,107,252,120,44,138,47,114,191,135,83,246,172,152,219,116,46,92,244,55
],[
249,6,25,162,111,189,225,185,22,67,28,227,74,213,31,237,47,83,92,83
],[
234,161,54,187,17,77,19,195,95,114,178,252,173,220,191,54,29,108,164,255
],[
153,190,163,102,124,10,33,5,142,72,69,62,54,152,194,196,235,224,241,93
],[
236,183,35,231,49,130,53,153,161,220,101,140,133,60,99,122,61,209,172,197
],[
49,177,19,187,11,51,160,24,36,153,158,204,59,243,240,255,109,64,164,83
],[
97,213,203,105,196,3,135,166,245,244,101,55,1,214,237,82,209,59,120,191
],[
162,192,66,152,182,237,192,77,73,93,52,234,199,31,126,157,60,91,53,115
],[
12,57,246,98,228,254,252,140,240,121,241,194,79,157,4,71,196,111,60,215
]
]