aLevelData = [
[
4,188,17,35,105,21,196,15,217,109,8,161,73,228,141,152,17,198,124,73
],[
5,192,178,11,228,86,251,80,249,180,78,82,59,80,149,102,131,45,28,185
],[
2,24,11,242,41,45,219,147,89,171,117,195,4,49,141,189,145,89,227,141
],[
232,62,187,187,133,59,141,41,202,245,253,62,154,155,13,68,35,108,146,15
],[
251,122,229,224,111,174,218,137,24,13,246,209,175,57,220,25,33,59,9,64
],[
230,127,193,197,143,32,73,43,159,103,87,162,156,142,199,227,102,201,143,92
],[
199,135,245,141,74,244,0,178,81,195,44,162,98,44,97,247,194,48,38,111
],[
69,36,19,146,100,109,132,149,144,137,149,127,198,79,74,138,100,119,13,204
],[
59,92,94,22,229,1,198,29,88,82,12,215,188,173,172,40,122,161,133,190
],[
150,246,210,58,62,237,91,144,163,200,237,176,7,141,7,102,23,8,214,126
],[
124,15,99,45,173,10,12,172,7,178,49,38,31,24,47,212,87,233,146,103
],[
175,241,134,166,222,223,143,88,162,72,122,100,84,238,148,55,191,65,25,102
],[
50,38,239,148,212,248,148,151,56,204,86,214,49,250,194,245,232,217,94,181
],[
43,201,155,21,8,119,5,190,155,92,189,157,36,135,41,210,92,157,234,201
],[
10,30,14,166,209,233,135,231,76,3,220,68,93,148,31,218,193,50,31,137
],[
232,98,222,155,4,92,70,166,97,15,23,179,244,101,36,159,54,200,191,194
],[
51,229,114,207,221,176,240,251,167,168,74,98,79,92,102,166,251,46,174,217
],[
136,87,5,157,31,43,255,137,9,158,81,207,196,8,134,28,86,37,244,192
],[
225,96,239,15,120,81,60,7,49,132,200,51,123,124,154,206,178,247,7,44
],[
241,116,37,86,40,243,130,245,110,252,21,113,152,226,116,89,10,73,72,6
]
]