aLevelData = [
[
5,5,3,5,5,5,5,186,248,95,56,48,181,14,183,78,202,195,255,134
],[
4,2,3,5,5,5,5,48,159,119,49,48,223,64,130,128,105,115,184,175
],[
2,2,3,2,3,3,3,164,169,152,194,141,193,27,32,8,221,100,171,115
],[
5,2,2,2,3,2,2,174,244,48,129,242,33,1,70,58,196,224,142,241
],[
2,2,2,3,2,2,2,51,31,115,154,111,6,47,89,158,117,46,181,187
],[
2,2,2,3,2,2,5,202,104,156,140,5,237,167,212,43,193,160,203,232
],[
2,2,2,2,2,2,5,235,66,203,119,201,63,76,199,166,136,18,214,142
],[
200,165,97,97,49,2,192,39,124,144,12,163,43,85,130,43,18,106,44,183
],[
21,172,190,55,51,181,190,42,196,11,231,108,254,150,208,79,190,88,201,238
],[
134,88,5,190,193,223,255,102,79,231,22,209,61,209,122,129,212,86,76,38
],[
214,192,1,111,4,90,8,32,227,37,172,101,192,204,59,101,242,218,104,27
],[
95,43,238,97,66,160,118,78,43,23,187,194,71,155,236,63,225,215,82,251
],[
41,209,50,51,52,213,245,193,69,174,134,241,75,29,252,145,170,131,121,71
],[
62,225,81,40,157,2,111,133,157,247,245,8,23,196,35,0,234,89,122,250
],[
66,196,33,145,26,164,135,135,255,225,74,20,23,154,88,125,99,95,84,233
],[
65,161,59,113,53,102,71,118,232,65,19,55,113,130,1,162,212,170,217,107
],[
200,34,178,92,190,44,22,236,30,25,97,18,212,189,106,91,11,32,101,59
],[
56,118,8,160,91,81,237,205,130,22,56,102,142,173,121,199,57,125,212,154
],[
88,152,95,169,94,50,203,240,34,88,71,247,226,223,161,95,135,154,174,186
],[
42,208,237,160,216,236,103,255,146,119,217,178,152,68,21,85,232,234,166,88
]
]