aLevelData = [
[
2,2,2,2,2,2,2,2,2,2,2,2,227,21,45,139,113,241,75,91
],[
2,2,2,2,2,2,2,2,2,2,2,2,199,224,233,126,163,186,79,174
],[
2,2,2,2,2,2,2,2,2,2,2,2,40,40,84,249,128,182,33,111
],[
2,2,2,3,3,3,3,3,3,3,3,3,199,41,55,30,36,18,180,64
],[
2,2,2,2,2,2,2,2,2,2,2,2,57,163,209,178,190,194,176,168
],[
2,2,2,2,2,2,2,2,2,2,2,2,104,92,85,160,16,252,242,148
],[
2,2,2,2,2,3,2,2,3,2,2,3,17,156,103,116,242,187,9,211
],[
2,2,2,3,3,3,3,3,3,3,3,3,69,175,162,225,206,61,186,153
],[
232,103,21,59,37,133,125,253,53,151,194,253,9,218,254,123,55,153,29,69
],[
161,70,157,114,82,201,147,83,168,24,239,167,184,8,0,14,238,99,59,193
],[
244,58,56,127,213,124,253,203,99,200,127,84,214,128,102,181,181,31,17,94
],[
250,204,218,210,113,47,155,20,97,131,113,91,110,236,191,13,190,11,118,235
],[
91,208,148,137,216,144,235,2,56,88,36,233,11,128,3,131,218,131,237,51
],[
197,14,167,53,107,86,96,143,10,175,242,69,231,91,101,205,241,159,180,194
],[
161,28,212,221,36,93,243,32,188,173,254,84,100,43,101,182,179,32,34,238
],[
2,143,248,64,209,14,248,6,103,213,74,94,185,21,42,32,141,139,49,19
],[
223,84,214,96,132,3,52,70,13,241,14,16,238,212,16,68,224,147,87,30
],[
131,89,52,60,72,233,45,155,142,49,69,194,11,33,126,61,110,189,155,77
],[
66,113,42,222,22,165,194,185,219,146,138,251,141,84,250,198,22,64,230,54
],[
111,119,184,151,8,187,253,213,106,130,35,51,27,73,128,64,193,43,151,8
]
]