aLevelData = [
[
2,2,104,53,162,13,36,140,64,144,203,68,73,28,112,186,253,5,231,253
],[
2,2,119,7,205,202,214,218,200,187,155,6,16,187,82,249,47,189,117,87
],[
2,2,5,174,141,145,14,167,154,185,232,104,181,149,15,2,244,242,236,211
],[
2,2,142,58,14,183,63,73,183,125,238,125,154,152,142,12,227,23,66,155
],[
2,2,120,216,196,12,126,248,7,151,32,141,27,28,139,152,82,183,61,53
],[
161,150,128,21,72,7,49,46,181,213,198,177,166,213,144,61,143,188,60,82
],[
59,51,160,8,181,46,181,1,105,121,223,156,135,147,117,107,168,192,125,232
],[
180,90,183,99,3,104,222,63,194,114,42,94,153,147,25,218,138,207,111,246
],[
29,167,123,84,186,235,157,104,86,208,5,44,82,66,189,21,159,123,234,70
],[
39,213,79,5,104,220,18,107,98,168,195,95,180,106,154,197,2,68,0,242
],[
153,94,81,99,86,54,225,175,196,55,61,187,132,142,179,45,242,57,20,35
],[
5,96,184,36,119,233,195,87,38,71,167,242,187,146,234,246,137,221,42,26
],[
184,196,94,4,162,68,94,191,125,208,166,106,59,160,86,45,174,77,126,114
],[
240,155,153,81,2,149,87,75,179,224,160,60,195,73,213,139,73,160,89,164
],[
82,201,80,168,203,16,166,98,161,189,83,126,38,232,222,245,183,143,32,204
],[
156,230,75,254,47,238,43,183,64,73,171,194,185,77,154,69,126,87,175,172
],[
151,98,203,227,145,216,127,200,33,167,206,224,11,152,52,72,66,221,231,239
],[
81,232,92,3,249,132,13,169,28,30,122,241,218,99,109,9,249,17,131,177
],[
138,6,232,238,201,158,98,3,70,59,145,157,66,37,117,78,92,149,48,60
],[
109,12,13,27,176,233,194,88,38,59,242,151,56,212,246,96,159,159,221,21
]
]