aLevelData = [
[
6,2,2,2,2,2,2,2,2,2,2,2,2,2,2,2,153,31,142,238
],[
2,2,2,2,2,2,2,2,2,2,2,2,2,2,2,2,185,199,187,52
],[
2,2,2,2,2,2,2,2,2,2,2,2,2,2,2,2,191,107,240,118
],[
3,3,3,3,3,3,3,3,3,3,3,3,3,3,3,3,145,102,230,28
],[
2,2,2,2,2,2,2,2,2,2,2,2,2,2,2,2,75,119,52,238
],[
2,2,2,2,2,2,2,2,2,2,2,2,2,2,2,2,226,208,21,203
],[
2,2,2,2,2,3,2,2,3,2,2,3,2,2,2,3,8,105,108,157
],[
2,2,3,3,3,3,3,3,3,3,3,3,3,3,3,3,79,154,5,140
],[
2,2,2,2,2,2,2,2,2,2,2,2,2,2,2,2,144,233,30,114
],[
2,2,2,2,2,2,2,2,2,4,2,2,2,2,2,2,142,33,38,143
],[
3,3,3,3,3,3,3,3,3,3,3,3,3,3,3,3,215,164,196,127
],[
2,2,2,2,2,2,2,2,2,2,2,2,2,2,2,2,235,1,27,104
],[
2,2,2,2,2,2,2,2,2,2,2,2,2,2,2,2,160,201,77,120
],[
2,2,3,3,3,3,3,3,3,3,2,3,3,3,3,3,197,159,61,143
],[
2,2,3,2,2,2,2,2,2,2,2,3,2,2,2,2,6,143,154,56
],[
2,2,3,2,2,2,2,2,2,2,2,3,2,2,2,2,15,161,25,222
],[
2,2,3,3,3,3,3,2,2,2,2,3,2,2,3,2,245,173,1,61
],[
209,112,237,22,174,224,205,39,165,189,47,90,70,105,189,61,58,249,6,178
],[
39,140,129,232,212,219,206,137,142,18,64,53,202,223,153,48,11,200,20,87
],[
6,193,169,89,4,254,140,35,137,6,247,156,51,9,41,147,228,115,175,245
]
]