aLevelData = [
[
2,2,2,2,2,2,2,2,2,6,5,2,2,2,2,2,2,2,2,2
],[
2,3,5,3,5,5,5,3,5,3,5,2,5,3,5,3,5,5,2,2
],[
2,3,2,3,2,2,2,3,5,3,5,2,5,3,5,3,5,5,3,2
],[
2,2,2,2,2,2,2,2,2,2,2,2,5,5,5,5,5,5,3,2
],[
2,3,5,3,5,5,5,3,2,3,5,5,5,3,2,3,5,5,3,2
],[
2,3,5,3,5,5,5,3,2,3,5,5,5,3,2,3,5,5,3,2
],[
2,5,5,5,5,5,5,5,5,5,5,5,5,2,2,5,5,5,3,2
],[
68,74,136,141,56,54,172,171,118,243,85,85,210,15,168,160,90,120,175,7
],[
241,143,21,25,58,126,42,110,184,203,45,223,51,46,203,246,93,160,227,164
],[
181,181,140,50,172,43,89,122,6,195,220,87,132,79,104,90,192,13,27,191
],[
88,51,28,159,78,203,34,103,175,193,54,136,115,59,185,112,165,40,168,186
],[
196,28,31,161,104,91,28,187,40,52,134,228,188,144,110,119,95,202,148,197
],[
119,193,45,191,120,44,227,246,6,46,30,198,90,43,130,205,230,217,185,162
],[
60,154,114,196,44,9,169,209,44,210,41,249,254,200,80,177,140,49,19,172
],[
23,100,65,7,144,151,12,196,70,242,197,121,194,232,231,73,239,198,87,20
],[
127,140,234,235,137,253,40,199,119,242,80,122,31,243,156,229,48,8,197,108
],[
208,205,202,167,131,197,238,90,79,240,255,168,30,160,222,131,99,136,60,103
],[
0,22,162,72,104,3,180,201,0,40,182,174,204,147,79,148,71,218,141,223
],[
146,175,42,245,209,181,14,170,211,146,20,250,241,70,17,254,56,187,19,25
],[
202,156,230,115,129,107,221,168,214,206,206,193,1,42,95,99,98,115,128,70
]
]