aLevelData = [
[
5,5,3,5,5,5,5,5,5,5,241,33,126,15,17,217,70,30,234,120
],[
4,2,3,5,5,5,5,5,5,5,42,116,38,81,59,170,131,119,84,4
],[
2,2,3,2,3,3,3,3,3,2,203,220,170,175,6,186,163,71,238,50
],[
5,2,2,2,3,2,2,2,2,2,236,157,163,52,198,182,160,158,160,23
],[
2,2,2,3,2,2,2,2,2,2,238,168,235,63,151,127,42,118,94,48
],[
2,2,2,3,2,2,5,3,3,2,72,197,173,200,47,70,207,185,150,158
],[
2,2,2,2,2,2,5,5,3,2,95,128,26,199,1,133,145,19,80,67
],[
5,2,2,2,2,2,5,5,3,2,155,109,23,168,121,226,195,191,35,97
],[
2,2,5,5,3,2,5,5,3,2,24,140,148,191,36,56,105,254,113,110
],[
2,2,5,5,3,2,5,5,3,6,170,207,127,4,232,85,113,222,136,44
],[
2,2,3,3,3,2,5,5,3,5,7,15,94,170,204,66,126,101,145,89
],[
2,2,3,2,2,2,5,5,3,5,78,245,25,83,224,251,22,115,127,98
],[
2,2,3,2,2,2,5,5,3,5,84,158,136,228,53,6,124,208,93,5
],[
2,2,3,2,5,2,3,3,3,5,82,11,174,75,18,85,119,60,159,206
],[
2,2,2,2,5,2,3,5,5,5,232,148,212,185,202,77,211,127,109,194
],[
2,2,2,2,5,2,5,5,5,5,154,247,225,20,216,228,104,205,254,192
],[
2,2,3,3,3,2,3,3,5,5,44,195,152,184,46,64,222,247,127,95
],[
134,39,178,185,221,53,145,65,22,85,15,109,226,71,126,151,65,216,2,162
],[
151,171,70,224,2,57,109,51,235,23,76,115,219,120,214,16,144,242,215,249
],[
81,133,230,188,126,217,148,238,107,199,234,205,110,27,19,36,55,152,85,111
]
]