aLevelData = [
[
4,2,2,2,2,2,2,2,2,2,8,2,2,2,2,3,2,79,59,18
],[
2,2,3,2,9,2,2,2,2,2,2,2,2,3,2,2,3,43,183,122
],[
2,3,2,2,2,2,3,2,2,3,2,3,2,2,3,2,2,46,140,176
],[
2,3,2,2,2,3,2,2,3,2,2,2,3,2,2,3,2,119,188,144
],[
2,3,2,2,3,2,2,3,2,2,2,2,2,3,2,2,3,215,172,94
],[
2,3,2,3,2,2,3,2,2,3,2,3,2,2,3,2,2,35,246,10
],[
2,2,3,2,2,3,2,2,3,2,2,2,3,2,2,3,2,85,80,123
],[
2,2,2,2,3,2,2,3,2,2,2,2,2,3,2,2,3,152,150,7
],[
2,2,2,3,2,2,3,2,2,3,2,3,2,2,3,5,2,40,94,32
],[
2,2,3,2,2,3,2,2,3,2,2,2,3,2,2,3,2,29,11,129
],[
2,2,5,2,3,2,2,3,2,2,2,2,2,3,5,2,3,140,148,177
],[
2,2,2,3,2,2,3,2,2,3,2,3,2,2,3,2,2,175,230,29
],[
2,2,3,2,5,3,2,2,3,2,2,2,3,5,2,3,2,151,189,187
],[
2,3,2,2,3,5,2,3,2,2,2,2,2,3,2,2,3,219,225,143
],[
2,2,2,3,2,2,3,2,2,3,2,3,2,2,3,2,2,115,106,78
],[
2,2,3,2,2,3,2,5,3,2,2,2,3,5,2,3,2,57,225,32
],[
2,3,2,2,3,2,2,3,5,2,2,2,2,3,2,2,3,108,99,25
],[
2,2,2,3,2,2,3,2,2,3,2,3,5,2,3,2,2,146,8,242
],[
130,90,233,229,44,24,190,124,99,183,84,160,132,242,12,127,15,22,141,119
],[
254,9,182,53,85,139,214,30,251,188,32,237,200,222,89,158,223,93,212,140
]
]