aLevelData = [
[
4,2,2,2,2,2,46,175,162,88,183,134,6,177,94,188,32,103,107,73
],[
2,2,3,2,9,2,156,204,246,180,115,61,253,214,170,2,180,225,60,117
],[
2,3,2,2,2,2,28,161,85,102,215,1,192,191,59,208,163,100,165,197
],[
2,3,2,2,2,3,106,93,16,193,1,55,230,85,70,167,21,132,190,113
],[
2,3,2,2,3,2,102,202,134,136,11,93,141,119,118,178,1,255,114,67
],[
2,3,2,3,2,2,7,2,108,144,175,160,17,99,39,159,31,89,47,16
],[
2,2,3,2,2,3,116,158,204,47,108,248,65,140,105,7,59,104,179,203
],[
2,2,2,2,3,2,76,98,131,102,154,83,90,35,217,118,151,184,118,204
],[
73,200,21,190,66,172,62,5,109,115,83,199,97,39,198,2,53,82,136,46
],[
150,193,197,30,24,136,206,40,202,71,87,133,13,171,226,250,166,55,123,184
],[
17,68,166,130,24,70,150,13,165,82,159,172,213,221,238,45,77,199,120,253
],[
209,152,48,147,19,9,125,12,200,198,235,19,1,114,33,4,185,235,19,81
],[
170,208,120,36,102,65,127,70,162,230,189,63,213,51,106,191,2,234,206,60
],[
209,225,246,221,229,5,171,151,106,159,165,150,237,214,251,222,113,117,222,50
],[
191,239,135,52,253,161,110,207,130,86,189,210,233,16,4,221,100,6,46,129
],[
83,233,180,163,22,107,16,33,31,2,117,185,75,233,189,38,114,105,163,139
],[
61,86,50,21,55,220,125,220,39,124,145,11,158,81,168,65,204,152,159,55
],[
151,111,170,162,239,221,71,91,91,19,112,189,216,241,21,78,228,204,201,162
],[
214,111,188,125,112,95,233,56,183,100,144,102,2,68,231,183,82,210,13,28
],[
225,39,63,43,254,48,78,198,23,105,80,247,24,231,150,31,244,156,223,80
]
]