aLevelData = [
[
2,2,2,2,2,2,2,2,2,2,2,2,2,148,214,142,33,165,19,202
],[
2,2,13,5,5,2,2,12,5,5,2,3,2,213,146,111,135,97,225,237
],[
2,2,2,5,5,2,2,2,5,5,2,3,2,19,241,220,56,185,172,221
],[
2,2,2,2,2,2,2,2,2,2,2,3,2,217,45,141,201,172,42,110
],[
2,2,2,2,2,2,2,2,2,2,2,3,3,219,149,89,102,163,111,117
],[
2,2,2,2,2,2,2,2,2,2,2,2,2,85,78,69,173,189,39,197
],[
2,2,2,2,2,2,2,2,2,2,2,2,2,73,212,94,241,145,215,8
],[
2,2,2,2,2,2,2,2,2,2,2,2,2,24,234,160,104,5,67,123
],[
2,2,2,2,2,2,2,2,2,2,3,2,2,109,118,175,54,123,208,83
],[
2,2,2,2,2,2,2,2,2,3,3,2,3,119,111,16,131,82,221,5
],[
2,2,2,2,2,2,2,2,3,3,2,9,3,40,27,155,189,101,121,132
],[
2,2,2,2,2,2,2,2,3,2,2,2,3,61,122,188,118,116,232,113
],[
157,114,214,51,244,214,179,196,8,133,29,92,0,162,1,64,218,186,4,151
],[
247,62,34,121,218,55,149,74,45,53,249,70,4,136,173,92,102,179,124,64
],[
10,30,125,188,94,11,55,71,205,203,9,216,66,50,202,252,232,72,172,39
],[
53,65,102,71,38,176,146,159,204,247,83,211,7,2,60,63,146,53,109,141
],[
63,162,255,135,132,128,163,41,55,216,133,251,150,130,119,158,138,80,75,164
],[
45,137,128,165,137,153,34,142,163,6,235,61,184,166,174,75,198,16,246,41
],[
78,80,234,111,88,223,115,112,185,210,161,18,145,81,75,221,23,75,246,81
],[
153,104,248,125,190,63,222,205,15,202,10,36,181,22,161,42,132,63,164,232
]
]