aLevelData = [
[
4,2,5,5,2,2,2,2,2,2,2,2,217,18,6,60,153,247,40,167
],[
2,2,2,2,2,2,5,2,2,2,5,2,41,24,155,13,242,3,67,24
],[
2,2,2,2,2,2,3,3,3,3,3,3,12,68,16,68,16,228,117,137
],[
3,3,3,3,3,3,3,2,2,2,2,2,39,47,28,57,103,186,216,43
],[
2,2,3,2,2,2,2,2,2,2,2,2,96,165,219,25,241,30,41,71
],[
13,2,3,2,2,2,2,2,2,3,2,2,97,38,76,101,170,152,73,183
],[
2,5,3,2,2,2,2,2,2,3,2,2,24,103,212,115,19,39,192,107
],[
2,12,3,2,2,2,2,2,2,3,2,2,57,207,185,235,177,189,53,229
],[
5,2,3,3,3,3,3,3,3,3,2,2,187,250,168,75,139,192,247,189
],[
11,2,3,2,2,2,2,2,2,2,2,2,87,57,48,100,175,138,120,30
],[
2,5,3,2,2,2,2,2,2,2,2,2,13,16,69,219,173,233,205,71
],[
2,10,3,2,2,2,2,2,2,2,2,2,158,183,190,169,26,160,47,10
],[
19,154,214,155,14,229,124,81,52,216,175,210,166,225,183,148,18,200,203,67
],[
132,51,132,100,126,111,145,57,74,109,173,228,143,11,206,206,35,149,159,74
],[
32,140,49,118,58,166,237,98,79,21,206,117,64,12,205,12,0,128,156,99
],[
234,44,150,185,88,215,247,175,113,217,72,242,66,220,30,25,17,224,4,209
],[
237,130,182,55,138,125,144,133,76,113,69,241,162,227,212,210,149,133,184,5
],[
161,184,95,143,195,80,222,131,211,151,227,39,20,148,235,82,10,141,181,24
],[
139,202,246,169,25,156,78,119,111,158,123,151,90,59,205,106,202,112,217,124
],[
41,211,114,172,235,213,213,142,103,68,36,13,229,20,22,85,248,94,236,240
]
]