aLevelData = [
[
2,2,3,3,3,3,3,3,3,3,3,3,3,3,3,3,2,3,2,2
],[
2,2,2,2,2,2,2,2,2,2,2,2,2,2,2,2,2,2,3,3
],[
3,2,3,3,3,3,3,3,3,3,3,2,3,3,3,2,2,2,2,4
],[
2,2,2,2,2,2,2,2,2,2,2,2,2,2,3,2,2,2,2,2
],[
3,2,3,3,3,3,3,3,3,3,3,3,3,2,3,2,2,3,3,2
],[
2,2,3,2,2,2,2,2,2,2,2,2,3,2,3,2,3,2,3,2
],[
126,151,124,176,30,166,202,153,42,111,229,35,55,135,32,39,74,44,210,113
],[
145,41,169,196,81,250,64,31,32,49,243,63,84,24,242,101,187,152,148,89
],[
141,89,238,175,158,43,165,73,216,165,0,29,233,11,65,56,57,117,54,3
],[
31,46,11,198,84,91,98,106,168,221,165,131,243,120,155,142,79,52,58,118
],[
132,3,189,94,196,165,246,154,153,201,228,254,27,117,136,92,102,167,245,72
],[
75,61,167,30,70,18,21,71,176,106,137,183,54,144,48,186,138,189,109,241
],[
88,60,115,151,124,204,19,9,114,70,210,134,14,127,63,51,109,112,132,98
],[
43,148,58,19,214,146,130,187,163,28,81,69,96,23,11,87,170,252,84,214
],[
96,126,35,172,88,109,23,201,80,218,15,103,39,124,245,147,77,82,218,233
],[
120,138,72,159,152,162,211,197,14,205,242,202,24,152,13,67,144,205,215,232
],[
215,151,222,223,12,232,97,62,129,24,97,203,111,207,250,6,232,36,244,105
],[
14,6,150,238,131,219,186,210,32,104,39,152,234,241,26,82,65,161,38,28
],[
91,44,62,233,241,178,17,130,56,231,150,203,19,113,231,72,135,145,82,225
],[
111,6,173,226,113,46,235,70,48,111,237,53,195,213,154,203,103,252,50,27
]
]