aLevelData = [
[
2,2,2,2,2,11,2,2,2,2,2,2,2,2,9,2,2,2,128,17
],[
2,2,2,2,2,2,2,2,2,2,2,2,2,2,2,2,2,2,111,14
],[
5,2,5,2,5,5,5,2,5,5,5,2,5,5,5,2,5,2,56,24
],[
5,2,5,2,5,2,5,2,5,2,5,2,5,2,5,2,2,5,16,77
],[
5,5,5,2,5,5,5,2,5,5,5,2,5,5,5,2,2,5,89,91
],[
145,45,211,221,122,100,150,160,87,161,164,103,105,112,106,192,156,93,80,66
],[
185,92,143,20,221,104,66,175,42,107,193,228,188,94,42,32,222,177,64,239
],[
126,237,121,191,223,152,82,231,142,89,230,231,151,92,191,241,248,248,236,169
],[
86,143,83,42,239,182,73,73,208,150,96,29,72,146,128,191,156,43,58,78
],[
252,32,88,54,182,217,185,178,170,5,92,144,254,131,186,53,19,126,89,224
],[
183,221,158,51,156,218,227,239,8,240,201,255,207,251,207,184,127,155,36,95
],[
218,217,186,235,137,13,156,13,14,255,129,110,251,76,161,56,97,11,199,215
],[
140,177,168,1,237,50,115,243,88,105,169,254,112,186,47,67,95,246,162,187
],[
202,126,234,122,3,172,18,52,129,110,86,0,142,52,126,92,64,13,107,113
],[
170,12,240,153,83,241,227,31,232,5,115,70,45,70,187,140,57,196,152,47
],[
227,75,184,241,120,66,244,24,175,211,224,186,222,77,160,55,109,198,253,7
],[
139,4,184,182,33,158,29,44,4,94,220,50,111,234,21,50,176,163,178,62
],[
33,206,249,84,90,242,97,225,165,128,165,131,179,185,24,19,141,205,56,227
],[
204,64,133,68,13,146,148,76,160,31,95,214,128,68,223,201,136,195,221,158
],[
227,105,5,28,197,238,60,102,88,28,51,56,250,51,60,110,165,141,93,198
]
]