aLevelData = [
[
5,5,5,5,5,2,46,203,133,90,191,14,27,185,125,134,219,64,212,0
],[
5,2,2,2,2,2,45,71,9,191,26,64,29,204,86,162,244,142,126,38
],[
5,2,5,3,3,3,183,154,158,54,118,204,246,162,18,151,254,150,90,153
],[
2,2,5,2,3,2,167,201,116,115,228,246,127,215,105,144,118,227,178,178
],[
2,2,3,2,3,2,87,173,72,85,133,31,64,197,107,5,4,86,99,100
],[
2,2,3,2,3,3,86,82,214,13,145,55,164,115,50,31,198,186,152,128
],[
4,2,3,2,2,2,50,16,8,21,254,64,244,28,201,132,125,194,87,155
],[
54,220,123,28,43,215,58,10,34,242,45,168,32,170,39,143,47,118,24,253
],[
95,181,49,112,11,229,73,116,93,21,128,185,20,157,34,104,133,12,206,183
],[
224,98,215,188,181,128,234,126,183,220,241,82,191,121,56,101,20,23,206,149
],[
233,167,47,133,39,1,31,240,109,217,217,61,85,239,105,84,250,135,87,177
],[
183,25,133,182,49,73,90,70,151,25,32,143,40,94,171,39,246,113,60,91
],[
234,38,165,196,9,2,173,27,245,168,181,77,183,149,156,210,187,13,225,59
],[
28,85,7,11,35,35,62,200,10,83,63,82,5,219,120,115,131,1,105,182
],[
176,204,78,125,63,184,254,78,104,173,19,110,44,50,75,177,224,223,46,144
],[
233,16,241,124,197,225,155,114,75,86,102,208,51,217,104,103,216,234,114,209
],[
61,18,57,4,78,24,179,40,105,120,196,166,29,17,26,130,50,30,86,234
],[
233,103,108,15,132,185,76,51,9,147,194,3,68,34,154,40,11,111,9,25
],[
198,216,72,51,46,189,130,11,84,123,240,3,229,158,67,27,173,82,66,10
],[
91,27,180,142,132,198,128,0,234,160,19,43,253,229,2,94,162,123,240,192
]
]