aLevelData = [
[
4,2,2,2,2,2,2,2,2,2,152,152,96,221,92,172,66,31,24,48
],[
5,2,5,3,2,2,2,2,2,2,212,81,15,228,37,80,119,187,177,191
],[
57,141,60,89,242,12,1,133,61,249,12,43,52,152,229,199,52,97,110,188
],[
225,248,14,234,106,95,15,130,15,107,69,25,224,116,241,252,199,81,228,196
],[
200,131,232,42,136,177,91,28,12,85,29,16,196,180,173,152,200,19,142,54
],[
97,40,240,114,203,207,140,43,57,254,208,43,26,251,60,254,155,204,12,3
],[
109,240,23,195,200,76,247,130,176,104,106,20,119,219,248,242,131,4,214,141
],[
81,251,11,226,186,199,209,79,117,210,62,165,222,154,35,126,245,168,53,209
],[
170,198,106,195,88,109,166,192,143,125,151,203,22,48,221,18,48,81,111,198
],[
31,169,58,41,231,187,11,233,84,177,174,172,62,149,88,236,12,196,66,5
],[
119,160,151,140,145,134,144,227,5,0,221,10,160,59,72,184,16,187,149,171
],[
236,77,172,60,245,61,250,54,156,202,20,232,196,215,157,121,200,227,107,124
],[
192,59,229,196,0,110,175,122,226,2,138,108,198,101,117,168,86,38,24,74
],[
15,101,99,146,253,137,115,58,197,49,181,6,233,108,77,156,72,44,185,150
],[
228,248,177,214,232,226,82,25,234,185,124,207,109,127,121,43,170,29,223,118
],[
144,86,183,168,9,250,222,57,127,92,172,53,159,5,212,143,92,170,139,183
],[
55,92,237,110,190,255,156,218,83,253,170,213,47,60,185,139,167,77,96,68
],[
173,230,209,126,153,146,185,63,42,167,104,169,199,120,50,207,11,205,21,199
],[
129,144,156,1,172,201,2,214,75,205,155,100,218,177,112,154,92,5,41,143
],[
88,191,49,24,34,118,20,153,91,209,44,27,187,62,124,159,14,231,220,178
]
]