aLevelData = [
[
10,2,2,8,2,2,2,2,104,160,174,81,52,149,3,244,158,153,114,125
],[
2,2,2,2,2,2,2,2,199,27,58,123,9,215,184,39,211,88,222,255
],[
2,2,2,2,2,2,3,3,180,187,224,176,181,183,48,57,236,218,173,78
],[
9,2,2,2,2,2,2,2,78,21,24,250,197,123,199,137,131,70,157,165
],[
3,3,3,3,3,3,3,2,149,27,57,191,187,143,110,177,119,233,243,161
],[
2,2,2,2,2,2,2,2,100,41,92,40,201,74,73,179,110,197,222,42
],[
2,2,2,2,2,2,2,2,174,86,115,208,206,2,140,107,141,89,11,164
],[
2,2,2,2,2,2,2,2,252,249,164,176,144,83,146,48,118,178,136,86
],[
2,2,2,2,2,2,2,2,38,121,235,74,59,171,62,204,130,177,222,26
],[
2,2,2,2,3,3,3,3,81,88,239,20,26,26,150,158,63,158,104,70
],[
2,2,2,2,3,2,2,3,40,130,35,39,148,87,156,12,44,237,249,217
],[
2,2,2,2,3,2,2,3,94,209,32,39,104,21,112,47,179,79,174,233
],[
2,2,2,2,3,2,2,3,99,228,66,117,44,135,163,185,103,252,16,76
],[
2,2,2,2,3,2,2,3,101,34,129,146,3,48,221,41,126,63,109,132
],[
2,2,2,2,3,2,2,3,137,9,145,214,157,240,177,50,145,66,119,240
],[
2,2,2,2,3,2,2,3,106,187,59,82,116,75,191,104,146,26,29,48
],[
2,2,2,2,3,2,2,3,210,202,253,2,68,252,11,43,13,21,169,217
],[
2,2,2,2,3,2,2,3,183,66,224,55,203,185,157,216,162,66,26,89
],[
120,246,154,66,194,71,89,46,193,65,195,44,88,16,228,100,27,193,32,254
],[
168,77,36,63,58,211,28,245,123,37,38,22,154,134,7,164,158,178,30,211
]
]