aLevelData = [
[
2,2,2,2,2,2,2,2,2,11,33,254,192,91,20,188,253,127,87,37
],[
2,3,5,3,5,5,5,3,5,110,105,38,80,94,134,73,187,226,229,161
],[
2,3,2,3,2,2,2,3,5,144,16,156,1,38,108,104,63,203,163,147
],[
2,2,2,2,2,2,2,2,2,138,193,124,27,253,134,11,16,117,88,40
],[
2,3,5,3,5,5,5,3,2,62,160,249,31,12,87,176,169,164,46,144
],[
2,3,5,3,5,5,5,3,2,27,84,73,252,222,52,113,107,31,10,102
],[
2,5,5,5,5,5,5,5,5,105,199,106,119,223,174,34,81,147,11,213
],[
2,3,5,3,5,5,5,3,5,21,242,48,229,173,14,116,150,95,227,112
],[
2,3,5,3,5,5,5,3,5,113,162,222,110,231,49,160,30,55,95,255
],[
2,5,5,5,5,5,5,5,5,139,146,170,77,78,124,146,221,1,117,172
],[
2,3,5,3,2,2,2,3,2,196,247,217,242,221,42,5,93,16,117,187
],[
5,3,5,3,2,2,2,3,2,182,211,4,200,169,240,8,227,27,137,175
],[
5,5,5,5,5,5,5,5,5,217,189,90,83,231,225,63,242,103,141,246
],[
5,3,5,3,5,5,5,3,5,222,176,206,37,181,55,79,159,148,250,42
],[
5,3,5,3,5,5,5,3,5,227,136,30,254,230,69,214,66,18,27,136
],[
1,5,5,5,5,5,5,5,5,217,142,37,43,230,192,196,244,225,16,75
],[
5,3,2,3,2,2,2,3,2,49,235,239,252,117,94,24,52,245,169,22
],[
226,50,91,7,61,216,125,159,183,230,37,112,44,16,72,104,96,98,208,155
],[
168,37,238,66,231,6,178,4,188,117,217,117,250,76,230,221,89,177,116,58
],[
107,61,202,136,209,94,176,63,174,249,129,30,92,84,130,39,94,52,114,235
]
]