aLevelData = [
[
2,2,2,2,2,2,2,2,2,2,2,2,114,18,246,175,69,118,121,96
],[
2,2,2,2,2,2,2,2,2,2,2,2,201,97,141,224,81,241,172,85
],[
2,2,2,2,2,2,2,2,2,2,2,2,189,143,107,144,230,196,252,135
],[
60,78,248,6,173,116,91,161,201,150,209,237,36,8,48,240,252,33,69,213
],[
28,142,211,228,0,236,217,178,58,151,20,149,21,188,197,91,119,182,180,60
],[
12,151,117,12,160,4,234,182,205,71,9,229,215,159,223,4,212,218,213,105
],[
16,38,51,205,175,37,226,0,148,63,118,218,130,60,108,117,129,18,175,153
],[
132,251,97,120,72,203,217,156,127,129,232,29,46,28,97,23,84,176,216,91
],[
204,184,169,101,116,174,61,143,143,217,136,132,104,103,214,246,57,187,200,148
],[
74,8,153,54,93,31,166,91,74,133,46,214,231,201,86,196,42,20,112,193
],[
146,2,124,92,194,176,239,200,112,23,180,212,125,152,113,28,101,215,11,129
],[
218,205,108,216,172,25,132,223,236,151,141,117,81,52,148,10,218,1,53,84
],[
181,134,166,67,96,88,247,56,14,238,151,114,76,176,27,200,228,81,59,158
],[
2,95,29,18,149,24,215,118,248,128,47,3,210,176,164,203,59,113,179,240
],[
32,9,83,20,232,85,194,16,87,24,131,233,179,147,168,0,38,86,77,136
],[
100,85,101,61,141,62,185,83,85,10,45,173,98,211,69,80,246,229,233,23
],[
205,23,101,168,73,92,180,166,204,149,254,41,101,169,95,107,176,216,234,196
],[
247,76,238,216,157,241,119,15,189,135,24,69,14,246,232,195,10,225,203,110
],[
79,125,243,63,69,164,166,243,1,37,65,4,105,95,125,215,153,14,241,55
],[
134,100,216,2,225,92,21,34,63,75,116,191,118,183,51,179,74,109,193,63
]
]