aLevelData = [
[
10,2,2,8,2,2,2,2,2,2,2,2,2,2,2,2,2,2,2,34
],[
2,2,2,2,2,2,2,2,2,2,2,2,2,2,2,2,2,2,2,14
],[
2,2,2,2,2,2,3,3,3,3,2,2,2,2,2,3,3,3,2,30
],[
38,90,7,147,235,218,84,129,218,30,146,231,136,184,29,130,75,243,34,147
],[
241,181,252,226,178,170,189,3,98,158,10,216,236,43,45,87,251,149,101,141
],[
250,242,128,227,63,142,172,161,131,141,139,176,150,210,133,164,80,32,98,250
],[
203,127,24,157,207,226,225,175,142,6,145,135,146,157,39,246,243,172,162,207
],[
205,50,22,166,241,10,254,215,219,18,212,203,229,141,223,118,186,198,77,36
],[
12,247,129,118,138,104,174,167,12,219,165,20,17,40,235,252,108,37,15,132
],[
58,200,58,254,23,144,8,106,146,32,150,61,222,46,221,98,202,155,62,127
],[
242,227,93,121,55,184,51,58,110,234,95,178,85,138,189,27,203,79,58,130
],[
64,56,231,131,106,115,76,84,57,126,254,5,14,140,116,5,40,42,22,233
],[
94,34,151,105,20,160,133,171,104,147,30,197,172,86,102,125,25,144,118,82
],[
193,89,23,193,198,158,143,193,202,198,187,144,166,149,94,177,95,81,185,54
],[
86,36,92,59,190,194,59,179,83,75,4,103,73,115,176,59,131,224,89,179
],[
6,212,75,183,173,11,93,147,30,231,130,66,252,202,155,236,95,195,143,173
],[
129,110,158,152,186,21,242,252,174,27,119,229,197,155,237,230,219,76,60,22
],[
57,168,7,89,196,77,131,225,117,163,138,244,9,191,235,239,250,135,5,139
],[
173,23,148,95,237,100,202,166,152,31,162,67,152,221,113,2,21,116,189,33
],[
233,168,83,15,85,7,148,115,242,17,16,112,234,156,86,39,103,119,9,126
]
]