aLevelData = [
[
2,2,2,11,85,87,33,3,139,154,228,87,254,55,115,186,230,144,119,195
],[
2,2,2,202,31,78,230,164,14,84,163,64,1,98,253,229,55,149,46,55
],[
2,2,2,209,81,153,92,113,133,0,94,7,48,247,208,232,36,152,181,33
],[
2,2,2,10,121,157,10,166,219,17,30,92,36,49,9,243,144,156,3,154
],[
2,2,2,35,144,93,40,226,83,89,168,66,209,63,21,225,134,173,98,116
],[
2,2,2,158,47,189,0,91,15,21,78,184,111,218,153,76,148,4,137,112
],[
2,2,2,133,86,101,164,213,228,132,47,189,211,4,6,110,96,191,239,164
],[
2,2,2,35,123,230,127,149,97,192,143,209,177,14,45,151,179,68,18,150
],[
2,2,11,241,27,34,235,163,51,137,229,107,253,9,11,66,216,146,96,178
],[
2,2,2,122,20,229,71,146,145,96,64,171,118,92,137,84,43,113,238,126
],[
2,2,2,233,197,137,37,204,211,124,51,41,107,230,161,33,250,15,223,118
],[
2,2,2,12,230,118,158,15,174,236,22,90,244,231,249,110,196,150,209,123
],[
2,2,2,28,77,173,38,161,111,116,137,145,145,120,123,249,220,78,18,40
],[
2,2,2,179,222,103,99,150,182,153,218,71,164,21,219,43,131,20,70,242
],[
2,9,2,85,101,65,123,146,108,44,241,192,107,216,59,68,0,243,147,120
],[
2,2,2,239,199,116,253,34,37,186,83,238,155,5,166,152,237,94,235,24
],[
2,2,2,195,29,44,28,160,9,32,80,19,194,255,221,49,92,148,47,66
],[
2,2,2,77,148,252,187,137,46,130,109,235,227,16,251,215,152,199,145,30
],[
2,2,2,234,162,211,33,193,180,20,58,40,177,201,87,92,176,61,232,34
],[
2,2,2,47,134,252,94,88,183,166,226,131,87,166,132,251,18,69,115,5
]
]