aLevelData = [
[
4,2,2,2,2,2,2,2,2,2,2,2,2,2,2,2,2,136,225,199
],[
5,2,5,3,2,2,2,2,2,2,2,2,2,2,2,2,53,187,41,143
],[
2,5,5,3,3,3,3,3,3,3,3,3,3,3,3,3,64,177,65,155
],[
3,3,5,5,5,5,5,5,5,5,3,2,2,2,2,2,95,201,218,105
],[
2,3,5,5,5,5,5,5,5,5,3,6,2,2,2,2,105,140,44,225
],[
3,3,5,5,5,5,3,3,3,3,3,3,3,3,3,2,248,62,58,136
],[
3,5,5,5,5,5,3,2,2,2,2,2,2,2,2,2,202,179,88,246
],[
3,5,5,3,3,3,3,8,2,2,2,5,5,5,5,5,103,101,235,138
],[
3,5,5,3,2,2,3,3,3,3,2,5,3,3,3,5,4,195,113,92
],[
3,5,5,3,2,2,2,2,2,3,2,5,3,5,5,5,168,203,193,115
],[
3,5,5,3,2,2,3,2,2,3,2,5,3,5,5,5,141,218,147,57
],[
5,5,5,3,2,2,3,2,2,3,2,5,3,5,5,5,201,195,66,43
],[
5,5,5,3,2,2,3,2,2,3,2,5,3,3,3,5,45,31,209,213
],[
5,3,3,3,2,2,3,2,2,3,2,5,2,2,3,3,110,229,45,254
],[
130,59,177,32,77,139,239,27,125,216,174,41,179,83,47,21,227,41,181,168
],[
253,160,67,101,205,98,168,118,32,24,185,229,40,59,222,15,33,39,208,86
],[
53,114,160,23,157,123,252,220,10,70,174,210,67,135,101,125,15,252,184,170
],[
85,0,104,165,130,94,229,173,43,99,20,165,244,55,80,12,176,109,175,47
],[
201,216,134,157,226,160,47,220,188,150,9,90,86,197,193,166,89,73,208,224
],[
178,101,69,111,129,207,197,241,50,78,208,120,233,135,69,243,36,20,41,234
]
]