aLevelData = [
[
2,54,147,192,91,86,116,155,151,125,170,55,62,83,9,176,81,225,78,93
],[
2,25,91,165,72,201,60,111,225,95,152,65,243,203,174,48,214,83,190,76
],[
5,231,54,26,106,53,143,126,39,125,125,164,41,89,129,20,168,180,39,58
],[
2,45,129,233,186,154,172,80,8,107,81,92,51,59,45,38,1,138,82,196
],[
2,65,189,30,109,93,102,109,221,47,198,14,251,21,145,116,186,72,240,174
],[
2,61,105,204,154,62,93,74,85,176,91,146,245,163,67,213,123,105,50,142
],[
2,3,247,83,8,62,141,248,32,34,154,233,76,224,218,251,220,23,193,229
],[
2,128,71,28,80,11,136,246,45,118,124,184,75,40,130,149,41,116,44,37
],[
2,9,100,244,80,69,181,42,110,230,34,49,172,115,230,235,178,7,124,114
],[
2,131,166,169,9,164,209,188,82,128,88,21,193,11,112,228,80,166,5,51
],[
2,116,67,82,39,80,201,174,130,41,186,169,109,27,19,87,117,10,115,236
],[
2,211,219,128,137,240,227,134,86,40,159,98,209,206,166,159,102,113,221,222
],[
2,63,94,234,123,93,102,235,109,232,226,103,110,195,244,132,93,100,15,123
],[
2,224,227,185,74,77,80,143,169,203,74,138,62,180,205,130,20,62,76,240
],[
2,74,91,0,248,8,221,127,167,183,222,144,121,114,95,62,30,183,47,43
],[
125,99,15,39,250,221,19,1,244,145,75,157,146,160,163,71,192,213,8,71
],[
116,220,204,182,54,174,76,144,223,80,208,10,161,189,178,37,71,33,195,131
],[
190,71,234,121,213,85,14,103,65,183,54,68,228,89,239,125,79,25,239,0
],[
133,124,247,147,1,159,254,107,251,113,139,250,232,32,99,8,64,209,100,5
],[
131,148,177,158,126,151,15,142,203,154,143,183,151,162,110,113,167,242,57,34
]
]