aLevelData = [
[
2,2,2,5,2,2,2,5,2,2,2,5,2,2,2,5,2,2,2,2
],[
2,2,2,2,2,5,2,2,2,5,2,2,2,5,2,2,2,2,2,2
],[
2,2,3,3,3,3,3,3,3,3,3,3,3,3,3,3,2,2,2,2
],[
2,3,2,2,2,2,2,2,2,2,2,2,2,5,2,5,2,2,2,2
],[
6,45,7,189,62,129,83,63,198,250,240,136,195,187,200,242,248,10,89,9
],[
139,0,163,229,12,132,69,183,179,122,227,161,233,55,202,203,10,56,215,179
],[
106,20,149,196,150,176,165,43,220,178,99,230,13,56,198,29,129,201,136,182
],[
92,140,135,36,16,183,108,127,35,75,138,218,51,255,9,209,55,121,67,97
],[
7,196,110,253,31,255,124,221,159,82,63,154,151,39,209,248,130,150,51,2
],[
16,32,52,93,41,161,148,214,46,128,106,61,130,41,195,118,73,189,140,205
],[
111,7,178,138,236,179,135,197,71,186,104,124,89,33,157,227,84,227,128,251
],[
4,44,225,102,84,199,170,122,19,218,191,148,248,209,40,175,228,152,114,53
],[
104,13,82,20,135,181,140,21,189,173,19,106,64,228,114,133,133,136,106,49
],[
6,190,221,219,67,150,235,48,6,62,90,238,236,118,59,243,33,67,202,155
],[
107,232,151,72,106,18,227,66,30,83,77,194,169,209,174,73,86,64,65,54
],[
219,13,7,152,219,220,105,65,175,53,32,28,102,122,82,192,10,29,253,68
],[
37,15,153,85,132,124,249,135,59,181,115,233,234,110,64,220,62,41,37,37
],[
186,242,83,64,183,77,141,247,169,109,136,52,165,166,151,20,32,37,136,60
],[
250,223,200,112,187,199,206,98,28,68,183,199,201,226,46,176,101,72,143,24
],[
206,106,76,185,163,255,143,37,4,54,33,17,153,164,138,244,214,129,122,209
]
]