aLevelData = [
[
4,2,2,2,2,2,2,2,2,2,150,246,220,199,28,14,217,72,120,159
],[
2,2,3,2,9,2,2,2,2,2,113,220,236,249,136,101,32,46,184,172
],[
2,3,2,2,2,2,3,2,2,3,11,105,78,83,22,129,149,12,127,206
],[
2,3,2,2,2,3,2,2,3,2,88,9,252,60,162,180,162,157,200,159
],[
2,3,2,2,3,2,2,3,2,2,4,68,169,190,159,207,53,212,118,68
],[
2,3,2,3,2,2,3,2,2,3,44,43,249,96,40,136,43,43,222,94
],[
2,2,3,2,2,3,2,2,3,2,4,208,161,66,20,172,40,159,106,165
],[
2,2,2,2,3,2,2,3,2,2,144,171,180,189,164,153,168,230,93,17
],[
2,2,2,3,2,2,3,2,2,3,162,25,165,221,142,162,96,229,8,190
],[
2,2,3,2,2,3,2,2,3,2,173,93,194,103,105,61,38,111,246,241
],[
2,2,5,2,3,2,2,3,2,2,61,204,58,82,208,51,234,214,205,232
],[
2,2,2,3,2,2,3,2,2,3,8,3,235,212,170,42,145,216,254,81
],[
2,2,3,2,5,3,2,2,3,2,245,97,139,113,129,60,185,226,122,172
],[
2,3,2,2,3,5,2,3,2,2,148,19,227,186,205,126,159,205,1,219
],[
2,2,2,3,2,2,3,2,2,3,215,122,62,148,155,157,196,122,204,169
],[
2,2,3,2,2,3,2,5,3,2,8,182,57,60,255,2,8,247,152,25
],[
2,3,2,2,3,2,2,3,5,2,88,140,139,107,36,24,81,22,106,180
],[
115,18,141,70,8,171,249,158,121,53,5,190,136,251,29,120,145,120,32,63
],[
15,202,7,55,97,99,200,142,207,2,121,15,200,225,185,244,109,48,76,252
],[
84,195,5,190,133,8,233,61,201,59,145,188,37,221,208,212,161,98,150,195
]
]