aLevelData = [
[
12,2,2,2,2,2,2,2,232,177,230,6,27,109,249,63,89,55,74,120
],[
2,2,2,2,2,2,2,2,110,255,33,167,3,23,151,84,20,217,167,88
],[
2,2,3,3,3,3,3,3,165,144,136,229,177,150,58,198,100,185,96,232
],[
11,2,3,2,2,2,2,2,138,227,77,26,70,251,97,17,7,6,150,175
],[
184,146,86,133,55,84,144,150,9,16,10,93,76,185,249,18,236,218,207,42
],[
26,52,84,29,250,168,248,107,156,88,103,225,46,10,95,24,112,205,190,64
],[
104,222,224,27,86,204,39,76,234,219,219,210,181,166,53,208,222,9,182,143
],[
22,62,189,197,205,70,89,24,166,139,92,222,41,195,177,39,185,23,239,253
],[
197,133,45,234,66,131,25,187,88,229,68,132,91,0,192,228,254,16,237,138
],[
195,215,144,248,182,135,37,135,91,226,119,172,229,160,109,121,168,17,39,103
],[
209,3,73,82,85,230,151,197,39,46,195,120,174,249,130,23,118,242,229,69
],[
38,117,231,225,178,244,67,136,209,153,136,91,178,44,110,2,234,56,107,241
],[
178,105,130,233,79,57,92,194,209,203,153,105,0,23,104,37,148,72,85,30
],[
164,98,99,31,97,40,91,155,4,61,99,238,5,137,210,230,142,222,67,130
],[
47,220,233,249,211,18,34,254,243,101,78,67,9,182,225,60,72,191,183,37
],[
138,62,168,70,138,86,93,118,83,50,97,222,248,235,123,255,134,172,60,247
],[
55,20,212,255,232,219,42,57,205,185,43,169,100,131,97,128,167,152,200,161
],[
134,123,222,94,148,193,250,130,1,46,222,149,200,27,143,91,41,26,101,158
],[
90,221,94,45,122,84,183,37,198,22,190,111,15,2,226,138,108,38,12,139
],[
44,224,50,98,14,66,41,94,181,187,186,244,86,244,249,188,180,249,210,188
]
]