aLevelData = [
[
2,2,2,2,158,206,242,91,208,211,84,34,245,56,235,76,239,39,202,236
],[
2,2,2,2,144,247,120,194,176,246,162,23,125,102,12,233,19,197,205,72
],[
2,2,2,2,77,82,188,0,218,204,38,120,147,125,194,218,11,119,230,116
],[
2,2,2,13,104,30,250,95,114,230,46,94,234,94,104,8,29,110,128,42
],[
2,2,2,2,185,220,176,103,222,21,70,33,120,43,156,157,205,26,74,97
],[
2,2,2,2,82,79,154,225,195,107,61,91,114,68,60,0,224,44,49,84
],[
2,2,2,2,138,119,182,215,5,55,30,229,77,74,99,219,91,151,96,123
],[
2,2,2,2,245,148,64,146,202,12,55,215,190,31,112,23,131,138,70,143
],[
2,2,11,2,105,40,182,154,119,185,20,140,186,227,254,221,221,118,143,138
],[
2,2,2,2,250,244,212,184,176,81,132,154,118,247,235,150,46,13,40,163
],[
2,2,2,2,254,249,152,246,91,35,146,221,102,252,85,235,124,64,62,85
],[
2,2,2,2,8,120,63,156,156,194,140,108,65,212,151,197,11,63,63,88
],[
2,2,2,2,240,241,68,52,217,254,255,161,250,160,80,76,95,124,215,165
],[
2,2,2,2,200,38,103,134,183,232,183,21,199,191,91,235,63,167,243,118
],[
2,9,2,2,231,24,163,155,27,209,195,160,29,212,215,74,176,178,193,66
],[
2,2,2,2,226,8,53,189,41,74,110,92,177,191,31,81,245,205,173,196
],[
2,2,2,2,141,119,155,117,70,36,70,162,120,162,210,43,148,106,100,244
],[
2,2,2,6,253,38,145,139,25,112,23,11,167,221,203,64,83,58,211,11
],[
135,21,21,8,133,128,239,111,179,17,41,56,53,45,40,131,193,134,100,54
],[
175,227,28,232,80,32,72,254,129,117,207,19,128,251,250,158,254,107,40,206
]
]