aLevelData = [
[
2,2,2,2,2,2,2,2,2,6,5,2,2,2,28,224,24,214,154,193
],[
2,3,5,3,5,5,5,3,5,3,5,2,5,3,165,219,198,210,250,137
],[
2,3,2,3,2,2,2,3,5,3,5,2,5,3,241,234,27,38,96,20
],[
2,2,2,2,2,2,2,2,2,2,2,2,5,5,126,158,88,75,190,109
],[
2,3,5,3,5,5,5,3,2,3,5,5,5,3,120,130,147,191,76,232
],[
2,3,5,3,5,5,5,3,2,3,5,5,5,3,2,214,30,105,209,173
],[
2,5,5,5,5,5,5,5,5,5,5,5,5,2,15,120,62,219,103,12
],[
2,3,5,3,5,5,5,3,5,3,5,5,5,3,241,185,42,232,46,199
],[
2,3,5,3,5,5,5,3,5,3,5,5,5,3,236,32,79,76,229,217
],[
114,61,72,80,111,96,209,30,13,177,157,186,117,5,63,63,230,237,16,111
],[
171,221,198,248,74,142,73,247,255,160,194,187,104,132,244,203,130,153,207,42
],[
212,149,66,217,234,39,82,158,5,219,105,4,17,61,240,163,215,65,31,161
],[
116,226,20,121,10,10,35,251,181,178,110,149,193,74,181,208,26,91,111,29
],[
3,107,25,210,11,33,206,112,61,169,24,39,152,90,6,156,191,150,126,233
],[
241,242,213,229,58,151,157,167,235,233,190,69,73,102,201,225,130,208,136,231
],[
229,142,218,144,81,80,189,171,238,242,173,156,28,163,45,165,169,70,163,100
],[
71,24,104,157,61,147,32,58,92,147,71,144,53,184,13,228,137,11,100,46
],[
1,228,87,28,31,11,157,90,117,29,110,17,21,49,149,174,72,188,199,228
],[
131,178,51,244,150,238,90,44,39,212,33,173,95,53,36,114,227,114,78,142
],[
6,229,167,181,61,124,108,254,211,167,101,231,221,117,115,154,113,250,105,111
]
]