aLevelData = [
[
2,2,2,2,5,5,2,2,2,2,2,91,4,112,103,129,34,160,117,180
],[
2,2,2,4,2,2,2,2,2,2,2,172,219,127,171,204,175,165,146,74
],[
5,3,3,3,5,5,3,3,3,3,3,213,143,2,177,192,177,48,173,118
],[
2,3,2,2,2,2,2,2,2,3,2,205,101,184,159,185,174,245,219,98
],[
2,3,2,2,2,2,2,2,2,3,2,212,92,89,17,142,24,166,237,246
],[
2,3,2,2,3,2,2,2,2,3,2,45,194,194,58,94,121,0,148,78
],[
2,3,2,2,3,2,2,2,2,3,2,240,7,124,229,127,161,28,245,190
],[
2,3,2,2,3,5,5,3,3,3,3,208,4,30,227,203,31,239,75,67
],[
2,3,3,2,3,2,2,3,2,2,2,229,77,86,234,211,25,120,54,24
],[
2,2,3,2,3,2,2,3,2,1,2,13,141,98,146,231,109,183,248,202
],[
2,2,3,2,3,2,2,3,2,2,2,193,9,89,225,21,132,197,69,46
],[
2,2,3,2,3,2,2,3,2,2,2,169,74,33,157,147,34,20,148,127
],[
2,2,2,2,3,2,2,3,2,2,2,42,214,249,139,150,31,185,190,227
],[
2,2,2,2,3,2,2,3,2,2,2,196,95,73,14,35,229,12,4,194
],[
2,2,2,2,3,2,2,3,2,2,2,201,92,89,51,100,4,60,59,120
],[
6,2,2,2,3,2,2,3,5,5,5,137,171,51,8,179,227,173,108,72
],[
8,2,2,2,3,2,2,3,5,5,5,27,91,164,27,113,45,237,69,37
],[
9,2,2,2,3,2,2,3,5,5,5,186,146,179,5,225,5,225,40,176
],[
10,2,2,2,3,5,5,5,2,2,2,46,228,223,132,3,174,233,114,89
],[
11,2,2,2,2,2,2,2,2,2,2,142,230,230,249,246,14,138,247,129
]
]