aLevelData = [
[
2,16,129,191,68,42,137,229,89,143,169,214,210,136,215,67,229,126,166,2
],[
2,99,15,13,191,155,98,106,238,124,183,198,3,249,66,91,230,178,57,83
],[
2,161,208,44,211,92,48,149,56,140,197,176,161,103,55,140,173,155,208,98
],[
2,134,63,153,39,30,10,192,93,184,195,61,46,171,248,181,187,98,243,159
],[
2,178,168,234,165,30,34,118,77,132,29,70,216,43,139,21,107,187,71,217
],[
2,108,10,161,62,47,50,22,82,210,231,95,130,101,7,174,197,78,115,52
],[
23,236,30,230,41,123,99,129,87,56,156,203,218,197,240,28,63,206,108,30
],[
23,237,85,209,241,203,189,210,133,137,85,220,50,94,130,143,171,129,179,112
],[
237,73,241,50,116,146,184,52,174,100,5,74,176,207,176,192,40,25,252,156
],[
146,28,109,36,175,233,217,160,51,177,194,97,190,230,227,2,14,157,9,238
],[
115,55,36,34,131,64,158,53,14,151,235,149,85,207,98,19,118,214,75,162
],[
43,212,57,91,180,86,154,197,18,172,140,84,118,143,242,47,249,8,199,54
],[
141,141,179,68,52,108,220,177,112,109,255,28,250,178,191,103,182,227,61,2
],[
231,136,232,109,160,182,151,248,123,238,213,206,140,66,123,49,152,185,133,7
],[
131,245,30,150,8,19,253,140,173,211,244,66,245,249,198,65,215,243,58,6
],[
111,187,109,2,244,255,108,229,234,128,2,28,152,184,207,152,189,191,154,210
],[
127,111,233,12,164,199,206,217,4,141,3,223,62,55,57,220,171,12,174,231
],[
144,135,254,249,152,252,59,171,129,125,63,65,21,255,65,232,92,185,167,60
],[
16,205,27,13,81,42,225,99,154,177,104,191,244,151,31,164,105,10,137,86
],[
188,23,148,226,87,203,39,94,133,152,250,114,225,251,170,24,15,92,13,159
]
]