aLevelData = [
[
5,28,206,36,76,8,42,244,115,19,199,31,47,100,135,13,28,183,126,145
],[
5,144,155,87,191,33,221,243,254,103,68,84,94,3,126,186,43,223,91,11
],[
5,194,184,57,120,163,218,192,94,200,43,207,106,53,107,181,1,209,186,165
],[
2,223,116,91,100,254,65,183,69,185,54,165,87,49,1,232,221,240,21,249
],[
2,254,204,254,8,190,14,241,61,45,212,168,67,222,180,109,7,155,162,116
],[
2,189,87,20,109,37,100,100,90,12,231,117,158,21,136,153,87,185,110,178
],[
4,238,141,106,152,237,195,114,187,16,244,82,10,158,29,158,19,249,231,235
],[
2,107,116,43,62,80,102,181,197,141,125,72,197,158,84,227,212,21,71,67
],[
2,72,60,134,169,239,252,104,221,1,253,2,115,82,15,249,77,204,201,148
],[
2,97,29,111,21,188,173,25,74,199,211,18,95,202,72,127,246,174,220,65
],[
2,121,7,103,28,175,82,3,24,142,122,120,39,81,162,248,9,202,30,13
],[
2,109,248,194,207,89,220,96,90,203,137,140,127,161,123,162,186,182,41,11
],[
2,100,78,221,187,42,180,196,254,190,33,65,117,204,224,135,91,48,176,103
],[
13,102,106,102,202,66,227,19,183,225,20,152,38,223,120,142,23,202,182,22
],[
255,215,128,37,201,212,187,31,27,94,224,168,218,84,162,183,240,140,209,235
],[
77,196,126,35,43,219,96,73,151,65,118,110,45,172,238,28,35,12,70,231
],[
137,194,177,70,206,12,188,161,135,196,49,171,108,75,59,242,163,192,204,181
],[
66,117,60,245,15,163,51,206,138,92,200,8,45,194,234,234,242,119,255,78
],[
22,84,204,251,28,94,149,46,22,245,133,122,32,79,80,210,45,37,22,229
],[
6,172,139,170,143,199,85,59,76,123,181,230,37,163,106,129,102,229,210,255
]
]