aLevelData = [
[
2,2,2,2,2,2,2,2,2,6,5,2,2,2,2,2,2,74,231,37
],[
2,3,5,3,5,5,5,3,5,3,5,2,5,3,5,3,5,223,65,151
],[
2,3,2,3,2,2,2,3,5,3,5,2,5,3,5,3,5,143,106,126
],[
2,2,2,2,2,2,2,2,2,2,2,2,5,5,5,5,5,132,31,253
],[
2,3,5,3,5,5,5,3,2,3,5,5,5,3,2,3,5,71,235,230
],[
2,3,5,3,5,5,5,3,2,3,5,5,5,3,2,3,5,235,237,229
],[
2,5,5,5,5,5,5,5,5,5,5,5,5,2,2,5,5,114,35,247
],[
2,3,5,3,5,5,5,3,5,3,5,5,5,3,5,3,5,243,7,98
],[
2,3,5,3,5,5,5,3,5,3,5,5,5,3,5,3,5,124,218,44
],[
2,5,5,5,5,5,5,5,5,5,5,5,5,5,5,5,5,167,209,177
],[
2,3,5,3,2,2,2,3,2,3,2,2,2,3,2,3,5,105,232,101
],[
5,3,5,3,2,2,2,3,2,3,2,2,2,3,2,3,5,56,80,3
],[
5,5,5,5,5,5,5,5,5,5,5,5,5,5,5,5,5,232,107,186
],[
247,179,87,83,84,100,45,89,240,200,149,160,220,255,68,218,150,218,209,21
],[
128,136,196,133,145,114,241,132,75,99,4,215,237,236,92,51,233,7,29,255
],[
152,250,128,92,45,126,110,99,232,33,78,173,140,233,27,25,18,58,185,201
],[
159,249,137,110,180,242,59,198,164,119,227,99,76,74,79,173,254,190,152,42
],[
190,24,248,253,177,59,219,173,210,133,57,40,231,244,34,8,180,141,155,20
],[
110,254,168,10,114,130,170,156,55,5,235,184,129,137,120,12,216,200,47,202
],[
57,26,24,168,11,154,249,44,84,132,36,38,45,226,148,126,116,104,56,47
]
]