aLevelData = [
[
2,2,2,2,2,2,2,2,2,2,2,2,2,2,2,2,2,2,200,151
],[
2,2,13,5,5,2,2,12,5,5,2,3,2,5,5,2,2,2,131,168
],[
2,2,2,5,5,2,2,2,5,5,2,3,2,5,5,2,2,2,174,170
],[
2,2,2,2,2,2,2,2,2,2,2,3,2,2,2,2,2,2,58,244
],[
2,2,2,2,2,2,2,2,2,2,2,3,3,3,3,3,3,3,188,239
],[
2,2,2,2,2,2,2,2,2,2,2,2,2,2,6,2,2,2,95,229
],[
2,2,2,2,2,2,2,2,2,2,2,2,2,3,3,3,2,3,4,254
],[
2,2,2,2,2,2,2,2,2,2,2,2,2,2,2,2,2,2,188,110
],[
2,2,2,2,2,2,2,2,2,2,3,2,2,2,2,2,2,2,198,233
],[
172,210,65,193,136,81,201,91,99,6,26,83,247,16,236,82,222,240,200,141
],[
6,50,25,142,95,80,134,55,214,211,127,4,135,187,22,144,46,33,17,91
],[
223,27,61,202,248,224,5,111,83,44,66,139,192,230,85,209,178,1,116,109
],[
56,160,65,69,47,125,161,127,183,139,203,67,227,218,159,194,181,187,58,119
],[
73,38,199,172,80,88,151,65,192,192,117,169,202,28,51,53,13,224,137,149
],[
9,215,32,156,214,12,233,67,21,235,179,241,40,164,253,249,158,208,8,100
],[
241,87,49,242,116,145,126,91,135,171,119,218,13,77,55,236,32,121,194,86
],[
3,183,153,101,87,111,140,121,146,150,208,197,174,140,81,80,30,69,73,63
],[
6,168,18,87,171,52,57,190,41,233,211,1,100,102,20,91,64,79,29,53
],[
21,241,22,233,93,41,125,203,176,129,189,106,243,157,3,19,204,214,77,151
],[
88,36,196,78,33,65,75,92,74,11,88,51,13,43,2,90,104,244,92,108
]
]