aLevelData = [
[
2,2,2,2,2,11,2,2,2,2,109,218,149,146,126,194,206,81,66,182
],[
2,2,2,2,2,2,2,2,2,2,117,21,14,69,43,7,60,245,177,245
],[
5,2,5,2,5,5,5,2,5,5,43,52,9,237,136,145,216,11,204,44
],[
5,2,5,2,5,2,5,2,5,2,15,143,6,107,202,50,219,239,121,187
],[
5,5,5,2,5,5,5,2,5,5,203,199,61,205,182,227,149,3,158,203
],[
5,2,5,2,5,2,5,2,5,2,57,63,174,145,70,62,123,3,156,112
],[
5,2,5,2,5,2,5,2,5,2,139,38,132,7,20,224,151,78,5,245
],[
2,2,2,12,2,2,2,2,2,2,219,61,74,53,46,74,76,243,232,129
],[
2,2,7,2,2,2,2,2,8,2,184,184,188,215,130,57,223,188,41,135
],[
2,2,7,2,5,5,5,2,5,5,108,239,60,134,8,150,29,160,194,142
],[
2,2,7,2,5,2,2,2,2,5,5,186,60,0,72,103,16,53,219,92
],[
2,2,7,2,5,5,5,2,2,5,109,171,19,37,1,104,175,22,28,142
],[
2,2,7,2,5,2,2,2,2,5,25,131,18,48,233,52,225,100,171,19
],[
2,2,7,2,5,5,5,2,5,5,19,153,226,40,230,43,77,199,171,53
],[
2,2,2,2,2,2,2,2,2,2,104,8,108,167,54,120,209,152,62,14
],[
13,2,2,2,3,3,3,3,3,3,68,221,211,97,84,218,153,23,87,152
],[
2,2,2,2,2,2,2,2,2,2,69,161,84,24,164,38,32,231,223,188
],[
2,2,2,2,2,2,2,2,2,2,198,243,253,222,44,157,169,27,244,15
],[
54,11,161,208,224,135,251,149,85,25,180,91,116,178,75,178,84,155,49,92
],[
136,174,43,22,161,198,247,182,245,116,50,118,159,244,121,144,199,95,207,11
]
]