aLevelData = [
[
2,2,2,5,2,127,91,77,148,93,85,222,162,46,55,130,30,195,150,71
],[
2,2,2,2,2,106,75,251,97,125,47,57,42,217,58,254,103,188,253,169
],[
2,2,3,3,3,205,155,114,91,196,204,223,81,106,131,253,113,219,255,90
],[
2,3,2,2,2,34,176,5,252,97,197,142,71,18,64,189,33,147,206,19
],[
2,3,2,2,2,83,151,48,230,50,50,247,15,128,48,139,228,141,171,114
],[
2,2,2,2,2,102,161,221,207,187,158,50,41,222,226,161,110,149,107,61
],[
2,2,3,3,3,56,163,62,7,78,63,9,7,110,198,7,155,74,173,36
],[
2,2,3,2,2,14,208,185,98,108,174,114,123,149,22,213,200,145,190,73
],[
2,2,3,2,2,97,35,44,212,134,161,48,143,61,2,178,87,61,57,173
],[
4,2,3,2,2,198,11,194,124,97,99,122,85,19,217,179,19,219,192,136
],[
2,2,3,3,3,56,193,75,110,50,14,242,12,221,188,23,77,74,44,234
],[
2,2,3,2,3,179,191,23,138,238,254,199,109,173,202,135,1,180,168,88
],[
2,2,3,2,3,147,46,227,229,113,69,210,185,75,241,93,176,223,13,190
],[
2,2,3,2,2,171,214,176,133,136,232,186,223,82,71,173,23,180,59,191
],[
93,180,9,45,199,158,26,209,149,61,89,247,185,81,221,109,151,62,200,217
],[
9,2,111,79,166,105,187,35,68,132,207,252,187,87,234,42,236,210,143,58
],[
2,3,228,199,248,137,89,147,92,76,137,214,82,107,101,213,219,118,143,183
],[
87,222,4,148,73,169,254,208,91,106,25,167,162,113,180,8,34,63,154,167
],[
149,61,226,78,104,173,19,115,7,224,140,16,90,169,35,175,143,19,13,196
],[
27,79,254,64,251,240,144,99,64,91,233,210,202,120,152,233,84,174,193,82
]
]