aLevelData = [
[
4,2,2,2,2,2,2,7,78,74,208,253,174,163,155,93,137,96,184,67
],[
2,2,3,2,9,2,2,90,161,30,220,107,20,13,121,155,176,241,226,96
],[
2,3,2,2,2,2,3,166,137,237,8,148,72,79,68,252,252,177,230,246
],[
2,3,2,2,2,3,2,173,7,234,33,200,29,179,223,125,114,152,194,101
],[
2,3,2,2,3,2,2,74,159,65,104,255,136,176,222,152,14,111,244,156
],[
2,3,2,3,2,2,3,105,97,81,41,23,159,250,64,220,110,115,99,8
],[
2,2,3,2,2,3,2,111,40,98,248,22,11,114,223,93,125,127,199,186
],[
2,2,2,2,3,2,2,114,195,210,78,208,152,198,95,25,138,200,8,74
],[
2,2,2,3,2,2,3,177,104,47,3,62,222,184,231,83,147,248,70,24
],[
2,2,3,2,2,3,2,228,109,250,11,34,172,142,151,221,154,166,233,98
],[
2,2,5,2,3,2,2,223,154,255,130,152,101,1,149,76,190,213,191,34
],[
2,2,2,3,2,2,3,132,238,114,81,95,100,52,215,165,74,163,110,122
],[
2,2,3,2,5,3,2,60,182,188,60,55,69,202,30,173,204,183,18,217
],[
2,3,2,2,3,5,2,108,174,237,81,50,21,197,218,156,7,158,127,89
],[
2,2,2,3,2,2,3,5,70,229,81,232,126,217,229,26,90,43,120,6
],[
2,2,3,2,2,3,2,235,191,46,205,27,225,243,59,215,217,192,249,116
],[
191,25,4,75,145,219,93,167,131,52,3,226,150,243,30,202,108,2,125,73
],[
91,48,66,70,192,52,220,198,150,239,54,87,71,242,46,174,193,64,73,143
],[
205,85,165,237,156,103,47,83,163,235,21,130,170,91,127,92,31,55,122,0
],[
175,74,52,55,24,46,111,15,56,18,48,197,106,187,183,232,19,201,180,188
]
]