aLevelData = [
[
2,2,2,2,5,5,2,2,29,225,9,41,48,86,222,75,39,154,221,49
],[
2,2,2,4,2,2,2,2,16,79,174,48,252,22,253,150,13,84,43,144
],[
5,3,3,3,5,5,3,3,208,54,68,75,205,242,50,90,93,80,48,88
],[
2,3,2,2,2,2,2,2,188,106,129,206,95,175,97,86,136,46,60,1
],[
2,3,2,2,2,2,2,2,23,18,30,247,163,104,107,93,201,41,208,124
],[
2,3,2,2,3,2,2,2,196,116,121,31,62,27,132,60,102,97,182,215
],[
2,3,2,2,3,2,2,2,67,2,109,36,72,116,214,236,40,109,96,49
],[
236,165,113,21,66,221,87,248,24,32,129,225,105,73,239,31,87,197,231,48
],[
123,154,234,225,121,168,230,183,215,47,173,142,15,146,166,128,226,91,194,8
],[
240,126,178,103,134,226,88,71,183,29,123,159,174,128,190,214,66,83,211,43
],[
203,97,236,84,52,184,114,101,82,170,250,244,116,23,117,123,60,239,166,253
],[
173,242,218,237,132,186,211,75,204,252,5,16,173,11,5,204,133,157,62,142
],[
58,210,230,4,206,114,48,227,51,118,195,137,97,203,108,226,167,82,15,136
],[
62,43,228,46,36,51,223,62,39,203,112,193,64,220,109,128,35,24,77,104
],[
20,130,150,51,252,48,152,69,188,79,92,212,193,105,216,76,217,227,100,242
],[
69,202,114,199,15,207,121,175,158,143,50,210,135,24,7,67,166,169,201,224
],[
110,186,161,121,125,60,73,52,115,34,123,47,5,32,170,104,77,179,241,218
],[
100,97,73,233,51,66,254,0,134,191,100,121,98,154,198,189,153,47,159,172
],[
155,249,12,63,143,87,130,107,163,144,188,73,160,21,248,117,193,7,99,180
],[
197,249,210,217,67,247,178,233,62,199,66,125,249,110,0,104,12,247,96,154
]
]