aLevelData = [
[
12,2,2,2,2,2,2,2,2,217,155,180,190,78,135,80,12,64,94,8
],[
2,2,2,2,2,2,2,2,2,112,181,90,61,147,64,22,46,140,49,244
],[
2,2,3,3,3,3,3,3,3,201,95,9,188,194,195,49,133,227,41,235
],[
11,2,3,2,2,2,2,2,2,217,163,249,136,20,249,31,220,13,114,198
],[
2,2,3,2,2,2,2,2,2,239,248,130,99,245,139,23,246,128,96,116
],[
2,2,3,2,2,2,2,2,2,141,245,155,61,9,60,204,206,36,188,23
],[
10,2,3,2,2,2,2,2,2,209,179,135,146,16,41,209,238,135,93,167
],[
2,2,3,2,2,2,2,2,3,90,190,141,222,164,86,162,73,161,225,181
],[
2,2,3,2,2,2,2,3,2,47,208,247,211,251,58,134,253,54,156,105
],[
9,2,3,2,2,2,2,3,2,115,179,200,60,51,9,73,111,188,70,70
],[
2,2,3,2,2,2,3,2,2,154,23,226,169,16,24,242,127,183,226,158
],[
2,2,3,2,2,3,2,2,2,162,23,169,213,150,176,188,64,178,145,194
],[
8,2,3,2,2,3,2,2,2,116,128,38,67,107,102,82,107,53,133,189
],[
11,235,225,112,225,229,194,159,25,44,91,197,19,50,170,247,103,193,159,113
],[
39,50,128,118,100,223,140,87,243,219,223,209,112,224,149,155,132,136,50,64
],[
100,192,66,43,154,122,60,0,8,163,172,51,42,85,145,211,155,77,4,166
],[
219,159,27,123,79,168,13,188,137,69,151,67,202,66,158,110,197,22,21,118
],[
166,205,33,252,83,69,123,229,242,157,23,104,171,235,3,101,175,45,145,249
],[
121,131,184,79,84,155,184,185,29,108,253,255,74,39,70,247,43,106,6,85
],[
112,183,10,197,236,38,93,55,152,86,105,122,219,169,94,13,8,177,216,50
]
]