aLevelData = [
[
2,2,3,3,3,120,217,202,173,14,64,89,243,159,160,64,100,30,239,50
],[
2,2,2,2,2,53,251,171,65,127,247,99,81,231,56,121,204,126,152,38
],[
3,2,3,3,3,151,230,67,190,69,183,129,54,139,32,208,227,244,210,54
],[
2,2,2,2,2,132,214,25,213,131,133,76,192,120,198,104,13,239,135,248
],[
3,2,3,3,3,44,107,205,56,119,171,237,121,9,43,255,199,212,238,144
],[
2,2,3,2,2,202,238,123,151,234,44,38,170,182,242,144,114,135,73,113
],[
3,2,3,2,2,93,96,50,149,146,25,59,37,42,189,79,40,157,48,210
],[
2,2,3,2,2,73,122,21,238,219,92,238,39,26,25,133,54,180,60,140
],[
2,3,3,2,2,20,136,182,128,85,173,208,211,183,182,100,73,251,52,77
],[
2,2,2,2,2,163,243,125,28,123,221,172,12,111,239,233,57,129,51,235
],[
3,3,3,3,2,12,190,149,186,250,30,59,186,110,172,20,229,3,230,180
],[
8,2,6,3,2,88,247,103,95,17,221,195,99,247,145,179,171,26,113,114
],[
2,2,2,3,2,146,61,202,102,245,146,145,3,140,196,84,237,122,58,111
],[
2,2,2,2,2,92,34,155,131,197,61,141,36,183,41,195,210,3,132,54
],[
2,2,2,2,2,43,31,250,178,94,204,91,149,227,247,241,212,106,221,16
],[
62,17,115,238,5,217,5,181,122,91,29,215,24,183,166,162,196,206,81,20
],[
83,177,56,240,77,88,194,17,240,152,198,255,120,79,243,192,158,226,111,241
],[
95,233,190,21,254,40,230,44,76,194,208,136,39,169,242,220,65,89,43,150
],[
35,198,238,110,113,146,163,63,111,132,74,22,196,54,98,137,126,13,9,75
],[
87,110,100,253,54,47,65,70,249,76,251,37,114,220,158,134,175,67,76,20
]
]