aLevelData = [
[
10,79,52,156,11,249,239,122,135,130,155,233,32,67,242,75,4,192,67,68
],[
2,145,240,115,182,116,216,67,240,18,95,208,34,39,93,96,20,172,245,91
],[
2,24,255,37,152,62,62,155,218,198,243,202,155,219,247,62,8,126,144,44
],[
9,76,192,221,78,17,52,116,237,68,164,73,64,25,3,210,244,80,163,104
],[
3,12,182,168,241,235,238,189,188,175,113,5,172,193,212,84,153,170,74,160
],[
2,243,41,105,178,168,130,49,33,72,24,74,129,104,62,141,216,68,75,198
],[
2,81,168,236,184,53,16,191,98,22,14,29,129,78,236,55,86,168,146,100
],[
2,169,92,171,185,14,65,4,219,103,62,52,17,170,1,130,157,229,244,3
],[
2,77,127,109,3,77,192,38,166,63,147,236,207,141,139,155,65,254,37,73
],[
2,5,136,77,194,11,102,35,53,20,106,254,44,206,147,177,193,65,226,14
],[
2,15,107,106,169,232,39,167,223,198,84,16,22,3,50,239,69,76,15,113
],[
2,184,83,36,249,13,196,186,186,131,123,145,133,116,244,129,223,31,2,98
],[
2,87,171,196,42,23,105,213,85,184,90,196,138,91,241,196,123,245,25,164
],[
2,13,234,122,1,185,222,248,186,49,199,125,164,71,71,249,127,11,58,167
],[
2,41,52,139,145,18,194,75,86,240,225,4,43,180,15,74,32,188,129,148
],[
2,165,74,195,74,76,53,160,31,208,222,65,161,87,102,153,14,244,30,0
],[
2,106,112,63,29,206,74,220,10,3,252,20,179,80,128,140,127,143,19,29
],[
2,51,134,57,201,19,117,1,244,74,236,138,208,139,223,198,26,249,252,126
],[
4,68,60,150,114,21,185,147,104,173,191,90,195,201,37,58,40,200,222,45
],[
59,15,203,91,17,173,211,224,231,59,54,207,20,6,30,119,60,113,120,229
]
]