aLevelData = [
[
4,2,2,2,2,2,2,2,192,21,181,105,67,196,69,39,2,223,44,9
],[
2,2,3,2,9,2,2,2,215,40,54,122,23,241,125,253,197,130,58,182
],[
2,3,2,2,2,2,3,2,6,187,220,44,213,251,87,77,248,64,191,179
],[
2,3,2,2,2,3,2,2,51,143,21,37,187,150,97,97,237,144,0,24
],[
2,3,2,2,3,2,2,3,64,105,64,59,121,34,42,117,30,120,159,249
],[
2,3,2,3,2,2,3,2,44,192,167,125,12,22,5,134,196,182,15,231
],[
2,2,3,2,2,3,2,2,107,170,188,132,223,166,255,92,186,48,83,199
],[
2,2,2,2,3,2,2,3,129,3,151,251,31,182,29,213,146,153,254,215
],[
2,2,2,3,2,2,3,2,229,224,176,109,94,3,218,116,248,100,102,252
],[
2,2,3,2,2,3,2,2,19,51,216,77,107,142,223,41,71,237,42,81
],[
2,2,5,2,3,2,2,3,243,190,125,75,111,76,4,97,105,229,231,237
],[
2,2,2,3,2,2,3,2,105,60,30,212,76,12,135,81,243,254,54,244
],[
2,2,3,2,5,3,2,2,60,205,12,234,49,168,139,126,128,216,232,224
],[
2,3,2,2,3,5,2,3,44,162,98,37,129,111,211,144,77,42,133,16
],[
2,2,2,3,2,2,3,2,77,234,70,9,230,209,191,87,21,52,1,145
],[
169,251,97,138,176,75,134,30,47,99,192,43,22,196,155,221,114,149,181,47
],[
229,69,204,174,83,114,27,128,223,10,231,166,22,176,85,126,105,97,126,140
],[
225,87,197,121,14,45,105,92,65,69,86,57,251,103,65,199,164,170,243,119
],[
128,152,229,177,224,141,14,97,149,96,249,178,170,69,26,25,83,242,98,150
],[
32,1,17,55,118,150,204,221,64,65,239,66,226,38,36,59,110,91,53,59
]
]