aLevelData = [
[
2,2,3,3,3,3,3,3,175,238,60,164,36,108,114,51,36,167,77,59
],[
2,2,2,2,2,2,2,2,123,141,20,188,191,174,39,94,132,158,218,250
],[
208,155,131,92,207,112,210,72,199,153,97,186,77,168,140,114,186,232,131,176
],[
217,63,157,61,226,89,240,170,172,2,30,220,30,212,113,201,231,19,43,124
],[
110,213,23,95,12,102,100,185,122,234,179,118,133,68,111,39,9,55,93,73
],[
28,203,116,202,138,243,238,201,130,108,159,158,142,232,134,26,200,108,162,15
],[
76,247,6,19,233,100,48,130,28,145,151,194,62,193,131,203,252,63,33,230
],[
8,69,215,180,14,27,213,115,234,131,237,125,24,85,164,17,107,103,137,86
],[
2,175,197,157,121,172,244,231,92,1,51,167,225,100,122,201,214,182,45,242
],[
216,115,237,10,198,77,180,248,117,20,33,172,165,217,16,99,52,83,110,38
],[
146,130,76,148,117,145,49,226,206,1,181,32,251,4,75,190,62,39,95,78
],[
110,52,161,139,236,87,160,155,217,127,154,145,134,7,146,54,44,150,164,9
],[
222,68,150,132,187,254,175,161,104,43,204,157,190,143,176,252,191,112,156,205
],[
207,248,31,47,33,219,48,20,111,58,122,69,238,198,247,167,129,40,192,188
],[
44,161,36,108,204,237,247,6,6,110,44,130,126,134,167,9,73,69,76,183
],[
164,68,92,159,230,208,1,15,179,75,39,22,115,208,142,68,2,22,29,177
],[
169,151,122,64,78,241,215,37,231,140,15,165,53,125,241,29,174,170,219,70
],[
187,47,140,183,35,1,51,172,199,209,203,5,145,52,171,146,167,0,89,141
],[
228,249,160,104,136,173,226,202,46,156,175,212,255,156,149,168,38,124,58,44
],[
131,232,169,11,164,140,234,253,241,125,213,73,38,212,39,136,7,156,214,171
]
]