aLevelData = [
[
12,2,2,2,2,2,2,2,2,2,2,2,2,2,2,2,2,2,186,160
],[
2,2,2,2,2,2,2,2,2,2,2,2,13,2,2,2,2,2,107,8
],[
229,34,30,126,17,50,118,32,112,134,95,249,110,50,171,94,157,204,173,47
],[
238,206,3,89,39,59,179,159,145,134,122,155,241,175,96,255,186,175,144,33
],[
129,22,103,183,177,243,203,222,128,244,190,98,34,206,50,57,60,223,31,80
],[
155,18,212,139,38,4,139,7,17,101,63,162,84,160,194,189,92,190,10,64
],[
0,135,203,223,182,235,76,156,7,161,115,141,64,14,33,224,107,104,198,28
],[
125,27,44,169,209,108,151,147,213,92,16,139,4,207,254,47,20,237,246,139
],[
112,201,212,223,232,64,11,162,167,37,57,200,102,155,255,65,224,193,15,194
],[
134,149,134,199,115,18,125,217,162,156,218,12,95,158,108,205,251,114,56,218
],[
196,129,13,146,52,171,95,111,105,233,82,209,213,48,20,253,55,153,112,101
],[
202,192,160,42,188,105,99,223,225,106,80,144,169,197,106,2,80,20,244,61
],[
84,42,135,72,44,247,97,52,55,172,0,91,243,32,240,234,111,114,225,157
],[
3,241,252,202,62,56,119,161,32,157,103,178,137,205,214,176,242,176,22,116
],[
91,147,84,68,132,133,112,86,96,1,13,144,199,206,228,146,107,36,93,246
],[
13,16,96,214,241,25,104,143,143,36,218,197,139,149,150,168,231,183,203,117
],[
120,94,15,63,150,203,175,239,24,207,67,138,128,52,134,178,114,88,101,112
],[
107,27,86,48,175,251,235,13,131,126,167,79,157,209,16,50,217,174,5,234
],[
45,130,82,227,223,208,130,77,245,208,245,216,238,93,50,188,175,14,125,253
],[
192,162,173,237,184,161,56,242,246,64,144,137,146,133,178,139,147,173,251,176
]
]