aLevelData = [
[
2,2,3,3,3,3,3,3,3,3,3,3,3,164,130,40,232,63,105,143
],[
2,2,2,2,2,2,2,2,2,2,2,2,2,161,139,90,114,13,69,120
],[
3,2,3,3,3,3,3,3,3,3,3,2,3,127,245,159,115,175,61,125
],[
2,2,2,2,2,2,2,2,2,2,2,2,2,244,28,106,227,60,18,97
],[
3,2,3,3,3,3,3,3,3,3,3,3,3,174,8,104,113,131,183,17
],[
2,2,3,2,2,2,2,2,2,2,2,2,3,148,6,174,238,242,76,252
],[
3,2,3,2,2,3,3,3,3,3,3,3,3,230,167,146,58,57,198,47
],[
2,2,3,2,2,3,2,2,2,2,2,3,3,181,17,158,199,208,91,60
],[
2,3,3,2,2,3,3,3,3,2,2,2,2,194,163,212,49,252,232,103
],[
2,2,2,2,2,2,2,2,2,3,2,3,2,149,190,24,182,75,238,209
],[
3,3,3,3,2,2,2,2,2,3,2,3,2,247,135,130,123,1,142,58
],[
8,2,6,3,2,3,3,3,3,3,2,3,2,43,166,189,143,199,68,205
],[
2,2,2,3,2,3,2,2,2,3,2,3,2,231,108,151,85,10,12,209
],[
2,2,2,2,2,3,2,2,2,3,2,3,3,144,217,92,237,97,62,237
],[
64,148,95,152,81,103,23,32,234,73,166,19,111,225,167,241,111,82,67,144
],[
121,190,165,191,49,9,173,42,162,223,233,126,214,248,193,205,164,154,241,51
],[
202,96,61,186,60,59,95,123,187,182,69,6,168,126,121,4,27,33,225,27
],[
48,22,168,18,161,254,124,54,154,41,250,252,200,92,102,231,180,209,160,172
],[
79,128,83,149,205,157,112,35,183,98,219,247,60,14,100,242,201,46,248,156
],[
217,27,24,194,13,196,139,100,127,173,80,206,84,56,215,4,144,36,113,99
]
]