aLevelData = [
[
2,2,2,5,2,2,2,73,180,253,182,60,69,72,25,137,64,247,109,170
],[
2,2,2,2,2,5,2,193,4,210,20,255,29,82,116,126,3,185,56,134
],[
2,2,3,3,3,3,3,48,167,81,211,188,227,55,142,129,242,46,124,126
],[
2,3,2,2,2,2,2,233,201,118,121,127,172,25,232,102,149,190,18,220
],[
2,3,2,2,2,2,2,158,172,114,125,188,141,92,91,140,31,227,80,79
],[
2,2,2,2,2,5,5,44,249,147,50,188,216,138,212,137,161,223,2,179
],[
2,2,3,3,3,3,2,67,214,197,181,159,222,158,152,234,102,16,103,82
],[
2,2,3,2,2,3,2,241,95,226,228,109,152,118,173,192,209,109,31,165
],[
2,2,3,2,2,3,2,178,99,183,182,52,249,221,201,169,205,12,128,253
],[
4,2,3,2,2,3,2,169,50,28,59,250,90,146,82,132,136,225,26,85
],[
2,2,3,3,3,2,2,228,162,146,247,27,225,108,234,3,43,203,81,126
],[
2,2,3,2,3,2,2,232,75,236,160,236,66,70,20,72,69,48,187,102
],[
2,2,3,2,3,2,2,238,109,151,85,221,175,232,97,253,195,148,231,8
],[
2,2,3,2,2,3,2,8,204,103,78,37,237,219,178,251,164,71,245,217
],[
2,2,3,2,2,3,2,86,146,55,239,191,148,186,6,217,112,234,110,255
],[
2,2,2,2,2,5,5,36,154,55,82,94,145,164,92,146,69,220,243,73
],[
2,3,2,2,2,2,2,230,227,96,188,158,201,193,161,24,33,172,69,63
],[
2,3,3,3,3,2,2,181,21,219,72,120,114,19,242,188,28,239,12,165
],[
249,211,56,222,88,219,240,138,28,112,198,126,29,30,240,173,203,160,3,227
],[
21,61,255,183,137,88,140,187,188,66,131,245,236,82,176,147,228,56,215,218
]
]