aLevelData = [
[
5,5,5,5,5,2,2,2,2,2,2,2,2,2,2,2,2,2,2,2
],[
5,2,2,2,2,2,2,2,2,2,2,2,2,2,2,2,2,2,2,2
],[
5,2,5,3,3,3,3,3,3,3,2,2,3,3,3,3,3,3,2,2
],[
2,2,5,2,3,2,2,2,2,2,2,2,3,2,2,2,2,3,2,2
],[
75,219,182,246,115,50,124,122,161,186,239,65,42,196,42,202,36,90,28,21
],[
28,36,223,170,12,141,68,220,135,33,179,79,55,57,50,184,137,219,195,228
],[
167,220,243,252,167,71,176,7,1,3,91,176,71,175,30,73,16,209,128,17
],[
54,48,54,178,65,126,60,14,34,58,37,59,37,213,176,204,33,20,155,83
],[
241,181,188,36,40,85,77,91,1,145,136,32,149,108,116,41,81,240,254,129
],[
166,25,75,136,2,238,77,60,0,241,148,182,220,185,103,247,41,222,20,229
],[
198,21,132,145,14,156,18,187,79,217,157,152,125,62,220,211,40,111,242,209
],[
172,167,67,57,168,88,133,180,177,17,26,241,71,165,157,237,7,138,187,113
],[
35,127,68,220,16,113,129,34,126,160,201,21,141,254,79,227,62,215,62,224
],[
39,183,8,134,108,137,250,186,234,252,21,81,181,43,25,211,197,124,226,127
],[
236,200,247,143,11,189,97,189,134,129,185,5,245,152,133,173,29,8,197,131
],[
30,187,200,102,237,36,68,7,5,38,166,241,90,49,167,199,143,174,32,205
],[
104,157,31,170,130,124,58,109,66,107,35,205,11,143,125,181,180,180,238,0
],[
57,54,118,129,176,33,255,70,127,151,53,29,205,114,151,88,54,43,206,206
],[
195,251,62,34,25,63,220,72,240,33,63,68,199,117,249,53,214,225,39,147
],[
69,65,71,181,155,73,74,150,121,108,234,216,136,253,62,9,176,149,140,38
]
]