aLevelData = [
[
2,2,2,2,2,11,2,2,2,123,129,168,185,101,117,254,105,132,206,21
],[
3,95,134,77,117,249,39,92,175,83,60,241,181,51,6,151,243,36,113,220
],[
210,190,70,179,136,39,162,24,52,218,167,242,42,167,113,61,139,251,76,104
],[
26,98,36,252,74,74,61,127,156,10,36,152,39,35,229,116,120,197,126,103
],[
157,149,148,215,125,173,101,86,107,228,254,14,250,80,173,98,18,10,186,210
],[
67,49,82,31,90,50,196,176,50,70,240,53,205,60,251,138,163,120,72,222
],[
58,60,164,20,247,38,193,105,52,250,230,88,147,162,228,187,145,115,76,50
],[
94,178,223,200,236,87,70,212,69,16,4,30,35,137,168,67,186,235,71,91
],[
217,163,41,216,49,100,195,177,244,111,229,193,163,18,53,106,33,110,220,125
],[
11,126,127,94,76,85,113,99,235,167,39,126,40,139,236,28,200,127,213,76
],[
173,173,248,36,169,109,217,96,148,10,37,77,156,201,163,230,221,39,103,60
],[
50,99,73,27,74,60,149,234,254,252,4,211,225,181,235,36,25,203,179,245
],[
110,178,137,12,161,249,86,253,255,136,242,149,53,38,149,121,102,62,142,11
],[
123,226,55,141,187,16,40,137,155,52,171,112,215,239,112,129,193,23,130,236
],[
217,255,122,56,159,248,243,226,165,23,61,71,232,57,86,195,96,69,21,27
],[
214,177,169,24,246,72,66,117,165,42,14,252,149,20,103,235,22,225,75,156
],[
47,81,12,101,237,10,72,190,251,220,28,161,115,73,149,55,244,69,103,176
],[
245,58,226,114,88,79,33,119,66,234,133,240,43,115,98,47,49,92,247,195
],[
178,94,164,229,25,5,87,19,248,110,72,250,88,80,230,153,77,57,16,164
],[
205,26,137,38,193,6,166,107,93,55,74,29,173,82,20,173,113,235,215,244
]
]