aLevelData = [
[
2,2,2,2,2,11,2,2,2,2,2,2,2,2,9,2,2,2,2,92
],[
2,2,2,2,2,2,2,2,2,2,2,2,2,2,2,2,2,2,2,22
],[
5,2,5,2,5,5,5,2,5,5,5,2,5,5,5,2,5,2,5,129
],[
5,2,5,2,5,2,5,2,5,2,5,2,5,2,5,2,2,5,2,167
],[
5,5,5,2,5,5,5,2,5,5,5,2,5,5,5,2,2,5,2,116
],[
5,2,5,2,5,2,5,2,5,2,2,2,5,2,2,2,2,5,2,5
],[
5,2,5,2,5,2,5,2,5,2,2,2,5,2,2,2,5,5,5,86
],[
2,2,2,12,2,2,2,2,2,2,2,2,2,10,2,2,2,2,2,135
],[
2,2,7,2,2,2,2,2,8,2,2,2,2,2,2,2,7,2,2,250
],[
2,2,7,2,5,5,5,2,5,5,5,2,5,5,2,2,7,2,2,62
],[
2,2,7,2,5,2,2,2,2,5,2,2,5,2,5,2,7,2,2,141
],[
2,2,7,2,5,5,5,2,2,5,2,2,5,2,5,2,7,2,2,122
],[
2,2,7,2,5,2,2,2,2,5,2,2,5,2,5,2,7,2,2,144
],[
2,2,7,2,5,5,5,2,5,5,5,2,5,5,2,2,7,2,2,105
],[
126,144,217,50,119,235,57,251,163,24,221,205,48,160,252,149,176,217,92,141
],[
192,2,23,248,232,143,159,18,195,194,0,71,96,123,101,163,231,81,222,138
],[
128,225,96,169,112,102,14,44,133,139,182,49,181,125,159,125,2,67,130,110
],[
161,82,214,49,90,92,80,53,50,106,171,224,72,42,165,128,253,138,74,132
],[
87,133,116,236,168,61,147,254,106,75,170,59,110,83,154,145,54,219,163,210
],[
159,93,40,101,194,154,178,60,29,50,56,5,238,114,158,165,224,109,123,226
]
]