aLevelData = [
[
2,2,2,2,2,2,2,2,2,2,2,2,2,2,2,2,18,195,83,235
],[
2,2,2,2,2,2,2,2,2,2,2,2,2,2,2,2,192,24,121,71
],[
2,2,2,2,2,2,2,2,2,2,2,2,2,2,2,2,128,153,239,63
],[
2,2,2,3,3,3,3,3,3,3,3,3,3,3,3,3,195,136,57,90
],[
2,2,2,2,2,2,2,2,2,2,2,2,2,2,2,2,202,177,72,211
],[
2,2,2,2,2,2,2,2,2,2,2,2,2,2,2,2,174,87,158,52
],[
2,2,2,2,2,3,2,2,3,2,2,3,2,2,2,3,163,111,178,38
],[
125,12,150,136,116,27,215,190,36,80,165,76,216,96,51,163,7,113,97,58
],[
31,206,153,225,130,224,246,83,206,90,172,10,98,179,164,87,30,217,102,177
],[
105,36,60,78,121,136,148,240,207,16,167,2,0,135,88,227,187,120,95,130
],[
8,90,166,43,206,4,243,160,152,103,200,108,152,123,136,116,237,122,218,207
],[
33,77,82,215,246,67,79,128,98,9,31,233,216,215,106,49,201,231,205,140
],[
107,43,197,150,185,63,207,231,187,157,205,231,7,16,172,227,136,107,68,97
],[
126,122,127,177,198,57,190,197,92,68,120,67,30,143,36,215,210,87,90,206
],[
107,88,53,225,136,65,251,78,62,101,0,46,23,179,199,2,90,232,107,143
],[
141,3,61,236,57,249,175,217,237,171,113,82,133,21,217,100,172,200,136,64
],[
160,154,75,142,54,156,63,3,29,76,57,54,102,12,100,175,68,211,44,65
],[
17,35,91,155,146,59,130,25,124,141,155,224,55,114,236,41,225,29,47,221
],[
150,205,239,99,239,71,53,181,200,132,100,186,71,167,98,208,26,50,248,167
],[
255,120,124,86,138,86,173,168,35,30,222,183,78,212,87,189,47,157,248,38
]
]