aLevelData = [
[
4,2,2,2,2,242,67,179,110,134,19,224,74,9,138,188,55,0,171,137
],[
5,2,5,3,2,125,101,21,188,207,239,53,94,32,148,187,178,185,77,74
],[
2,5,5,3,3,24,137,25,116,49,188,68,229,68,143,233,222,225,98,182
],[
3,3,5,5,5,230,196,14,239,188,251,122,181,143,76,105,137,113,209,150
],[
12,10,229,3,8,137,68,142,180,224,109,197,52,49,75,251,96,131,21,156
],[
198,186,115,189,242,198,226,247,237,26,89,118,3,96,45,77,201,107,50,12
],[
95,109,35,149,243,106,67,43,134,236,69,204,243,249,105,193,45,66,233,115
],[
200,157,147,128,187,181,183,14,100,0,67,96,204,242,45,167,45,113,17,26
],[
177,136,28,72,125,95,40,173,238,107,40,132,34,226,199,221,187,114,76,239
],[
223,50,193,175,131,217,84,162,234,46,253,239,104,191,97,184,108,214,247,170
],[
190,169,105,211,4,209,61,180,139,253,180,152,68,232,242,36,13,136,96,46
],[
50,137,79,211,52,249,222,195,201,69,29,224,35,100,114,8,117,82,60,46
],[
180,192,183,176,155,10,32,228,241,105,25,244,14,106,78,237,156,158,89,18
],[
155,147,227,118,167,4,12,202,126,77,13,115,189,33,28,224,234,127,145,26
],[
183,226,70,156,133,185,67,102,40,22,155,77,234,170,145,149,210,241,255,193
],[
38,170,249,170,46,138,173,207,59,49,141,236,232,93,177,206,160,94,118,101
],[
96,202,108,27,190,113,111,100,43,147,19,150,117,81,70,252,144,98,48,37
],[
149,7,94,130,11,65,32,49,102,65,47,19,205,32,147,36,32,208,196,12
],[
58,83,16,241,115,42,60,144,105,17,110,140,1,233,75,5,168,246,92,109
],[
223,74,182,151,246,129,218,17,23,175,218,180,135,151,189,121,41,30,37,143
]
]