aLevelData = [
[
2,2,2,2,5,5,2,2,171,65,205,49,31,121,173,52,102,237,175,85
],[
2,2,2,4,2,2,2,2,211,125,196,14,4,22,176,98,255,124,189,195
],[
5,3,3,3,5,5,3,3,129,70,176,52,146,42,252,171,93,122,54,185
],[
2,3,2,2,2,2,2,2,63,239,201,108,30,166,235,117,252,104,207,134
],[
2,3,2,2,2,2,2,2,203,46,28,254,131,228,159,200,115,110,60,128
],[
2,3,2,2,3,2,2,2,212,233,43,216,164,51,97,59,178,173,75,176
],[
2,3,2,2,3,2,2,2,245,63,194,0,33,157,60,27,124,201,63,184
],[
2,3,2,2,3,5,5,3,238,218,28,60,88,251,217,221,39,182,111,7
],[
2,3,3,2,3,2,2,3,41,115,54,254,159,59,157,198,147,194,30,64
],[
2,2,3,2,3,2,2,3,108,165,113,149,191,240,0,215,104,227,156,230
],[
2,2,3,2,3,2,2,3,218,246,110,145,179,26,48,254,148,66,157,76
],[
2,2,3,2,3,2,2,3,47,34,37,118,161,54,230,123,3,7,216,188
],[
2,2,2,2,3,2,2,3,59,170,71,165,24,137,135,143,159,102,227,229
],[
2,2,2,2,3,2,2,3,159,156,214,134,140,168,126,107,137,233,77,138
],[
199,164,2,250,14,75,215,87,153,255,252,104,39,83,69,255,79,83,32,33
],[
20,197,201,103,185,174,193,164,215,24,124,200,172,19,89,5,182,250,216,48
],[
128,247,8,105,189,201,62,254,147,197,12,141,57,27,113,105,196,91,78,63
],[
62,56,25,250,249,139,213,227,34,155,66,13,153,155,81,240,0,116,218,84
],[
19,197,145,113,55,40,55,84,85,184,13,132,232,208,142,230,85,21,93,222
],[
124,182,125,183,140,242,192,69,27,219,130,200,118,90,150,20,53,116,129,239
]
]