aLevelData = [
[
10,2,2,8,2,2,2,2,2,2,188,99,87,243,35,55,254,208,88,119
],[
2,2,2,2,2,2,2,2,2,2,229,107,218,52,37,134,56,82,99,68
],[
2,2,2,2,2,2,3,3,3,3,212,59,176,131,231,212,174,107,197,177
],[
9,2,2,2,2,2,2,2,2,3,244,71,99,133,180,148,22,220,155,88
],[
3,3,3,3,3,3,3,2,2,3,157,12,249,182,98,104,34,190,253,184
],[
20,138,250,230,90,134,220,250,48,15,97,72,231,64,8,232,139,8,209,103
],[
196,128,68,188,250,124,180,126,188,97,197,84,99,54,44,172,242,253,182,176
],[
65,67,140,117,91,246,181,118,36,119,220,66,63,240,84,113,46,232,89,220
],[
187,20,153,14,151,112,243,245,66,143,126,221,42,47,205,160,23,17,113,22
],[
198,8,192,211,212,79,213,18,223,31,216,236,231,129,128,206,250,98,213,41
],[
16,229,59,107,52,253,172,47,228,58,69,176,187,227,4,132,77,70,208,135
],[
83,76,185,21,8,80,130,124,210,49,92,176,37,166,245,65,164,210,177,139
],[
138,25,55,45,73,49,48,188,113,124,75,184,210,149,133,190,229,41,167,0
],[
104,8,16,243,73,123,180,71,197,217,101,28,209,85,82,115,185,26,205,226
],[
7,154,81,141,166,34,195,81,71,178,248,66,4,13,120,88,67,12,129,101
],[
222,55,79,74,129,150,155,107,83,197,98,96,216,71,231,238,22,28,251,53
],[
246,150,124,42,238,104,28,72,221,0,99,131,54,23,248,126,97,134,28,253
],[
94,91,119,157,172,44,23,195,105,171,182,210,186,123,59,161,109,66,132,44
],[
221,0,99,137,22,159,230,30,58,203,220,18,36,3,148,1,74,240,232,244
],[
232,246,122,144,91,10,62,141,202,195,57,106,12,179,136,95,198,247,163,148
]
]