aLevelData = [
[
2,2,2,2,5,5,2,2,2,2,2,2,2,57,250,217,73,131,39,116
],[
2,2,2,4,2,2,2,2,2,2,2,5,2,79,40,82,228,113,175,58
],[
5,3,3,3,5,5,3,3,3,3,3,3,3,246,21,113,32,0,11,149
],[
2,3,2,2,2,2,2,2,2,3,2,2,2,225,116,204,63,98,180,255
],[
2,3,2,2,2,2,2,2,2,3,2,2,2,5,48,40,66,163,104,143
],[
2,3,2,2,3,2,2,2,2,3,2,2,2,38,239,213,146,123,15,89
],[
2,3,2,2,3,2,2,2,2,3,2,2,2,159,207,233,142,244,49,219
],[
2,3,2,2,3,5,5,3,3,3,3,3,2,172,250,59,172,174,213,79
],[
195,176,57,32,151,156,127,116,103,5,248,41,43,83,129,118,202,33,87,116
],[
141,227,45,221,212,204,124,19,8,239,27,100,208,164,15,140,136,45,164,123
],[
239,153,189,89,31,233,104,200,195,114,181,105,132,130,201,161,196,70,46,157
],[
143,235,109,147,206,4,223,75,190,44,192,223,161,236,133,191,180,223,111,247
],[
96,19,97,181,180,179,239,5,19,227,183,224,42,236,244,101,37,153,80,102
],[
35,225,250,38,231,197,249,97,208,124,192,141,11,206,2,96,7,190,199,146
],[
41,107,192,228,194,56,215,97,62,43,11,228,158,147,123,218,40,238,192,73
],[
92,9,128,18,43,105,64,115,100,234,122,207,111,166,240,178,61,24,63,16
],[
127,130,183,205,22,139,106,130,203,45,131,127,65,206,218,12,39,173,197,245
],[
178,128,48,69,75,92,240,81,133,212,84,248,81,101,253,42,117,18,240,167
],[
58,75,234,9,101,19,244,5,105,98,54,238,219,200,16,122,38,84,103,201
],[
128,180,61,163,29,157,133,2,162,110,53,208,220,16,156,241,178,32,246,132
]
]