aLevelData = [
[
4,2,5,5,2,2,97,88,19,45,108,187,151,217,4,94,172,220,113,247
],[
2,2,2,2,2,2,130,188,239,98,210,88,177,149,10,124,38,214,170,179
],[
2,2,2,2,2,2,123,44,238,92,97,19,173,0,16,115,129,227,140,211
],[
3,3,3,3,3,3,40,217,39,202,42,91,71,183,188,218,105,178,229,83
],[
2,2,3,2,2,2,102,195,223,36,245,81,192,30,114,221,90,219,222,240
],[
13,2,3,2,2,2,95,82,38,81,201,168,168,124,120,74,243,80,29,56
],[
2,5,3,2,2,2,206,8,88,164,125,108,29,187,63,72,92,195,27,30
],[
2,12,3,2,2,2,225,102,220,24,121,77,91,64,86,241,252,243,180,174
],[
5,2,3,3,3,3,123,147,189,26,233,125,170,148,241,59,44,32,96,250
],[
11,2,3,2,2,2,10,114,229,62,11,72,20,212,22,253,177,9,152,91
],[
2,5,3,2,2,2,44,25,38,178,104,234,100,38,192,250,37,77,76,150
],[
2,10,3,2,2,2,211,250,96,78,18,83,86,165,160,42,142,13,127,138
],[
5,2,2,2,2,2,178,18,87,143,63,213,22,123,65,188,217,7,94,104
],[
2,2,2,2,2,2,15,247,21,231,219,241,72,43,187,143,248,187,104,179
],[
9,5,3,2,2,2,81,169,253,27,230,196,90,53,61,14,203,52,142,113
],[
2,2,3,2,2,2,229,99,200,173,177,185,213,149,13,174,31,123,78,78
],[
5,8,3,2,2,2,83,233,42,140,101,146,214,216,212,135,107,244,47,174
],[
2,2,3,2,2,2,142,3,216,113,80,227,8,179,83,188,19,8,47,217
],[
6,5,3,3,3,3,237,37,19,183,237,149,176,92,210,174,82,234,4,196
],[
80,116,28,156,167,16,165,35,226,46,36,96,61,40,87,168,9,26,187,17
]
]