aLevelData = [
[
10,2,2,8,2,2,2,102,3,15,176,49,112,159,189,22,224,52,147,19
],[
2,2,2,2,2,2,2,168,221,215,205,43,128,163,130,254,114,207,63,74
],[
2,2,2,2,2,2,3,69,111,83,114,225,156,3,246,214,120,127,152,241
],[
9,2,2,2,2,2,2,108,21,189,14,180,165,21,44,30,85,126,199,14
],[
3,3,3,3,3,3,3,133,38,98,198,6,240,99,228,134,26,35,44,79
],[
2,2,2,2,2,2,2,28,70,136,50,211,72,77,189,222,89,192,181,73
],[
2,2,2,2,2,2,2,107,217,192,104,137,71,97,6,106,179,41,192,70
],[
2,2,2,2,2,2,2,73,44,171,232,117,179,61,5,234,48,106,204,233
],[
2,2,2,2,2,2,2,119,13,190,192,42,138,192,145,117,177,110,84,252
],[
2,2,2,2,3,3,3,230,179,31,18,127,150,165,44,110,87,254,149,32
],[
2,2,2,2,3,2,2,187,166,99,165,164,199,169,16,228,187,238,33,83
],[
2,2,2,2,3,2,2,204,222,33,32,63,64,14,100,146,40,248,253,1
],[
2,2,2,2,3,2,2,110,171,153,79,94,142,17,194,177,203,249,112,189
],[
2,2,2,2,3,2,2,176,117,185,232,86,77,21,98,128,68,16,20,197
],[
2,2,2,2,3,2,2,166,146,211,242,33,100,218,170,213,240,119,79,174
],[
2,2,2,2,3,2,2,72,4,38,242,106,25,181,22,195,0,112,214,241
],[
2,2,2,2,3,2,2,105,149,133,205,95,85,161,169,123,52,170,214,88
],[
2,2,2,2,3,2,2,178,52,106,70,43,60,63,67,252,184,63,39,231
],[
3,3,3,3,3,2,2,113,223,30,185,21,234,91,41,136,128,11,4,124
],[
2,2,1,2,2,2,2,94,136,135,65,96,208,12,222,67,53,234,96,176
]
]