aLevelData = [
[
2,2,2,2,2,2,2,2,2,2,2,2,2,2,2,2,2,84,76,201
],[
2,2,13,5,5,2,2,12,5,5,2,3,2,5,5,2,2,86,22,80
],[
2,2,2,5,5,2,2,2,5,5,2,3,2,5,5,2,2,30,113,179
],[
2,2,2,2,2,2,2,2,2,2,2,3,2,2,2,2,2,233,70,98
],[
2,2,2,2,2,2,2,2,2,2,2,3,3,3,3,3,3,236,98,175
],[
2,2,2,2,2,2,2,2,2,2,2,2,2,2,6,2,2,233,70,188
],[
2,2,2,2,2,2,2,2,2,2,2,2,2,3,3,3,2,166,53,14
],[
2,2,2,2,2,2,2,2,2,2,2,2,2,2,2,2,2,163,121,109
],[
2,2,2,2,2,2,2,2,2,2,3,2,2,2,2,2,2,155,160,216
],[
138,211,143,129,103,241,84,29,27,133,202,100,134,187,252,136,42,225,152,209
],[
60,36,160,132,251,154,99,10,65,134,172,78,88,215,57,103,14,241,110,119
],[
12,176,75,211,99,170,156,100,104,181,111,77,194,170,203,205,193,104,159,103
],[
242,27,249,65,240,190,120,203,124,222,4,160,208,161,188,177,49,8,48,160
],[
196,113,209,106,162,96,166,73,46,126,64,217,167,226,239,121,249,144,54,244
],[
217,63,125,97,16,96,6,71,23,91,34,5,229,28,165,113,5,206,151,192
],[
235,230,44,166,136,100,246,189,28,85,90,43,76,157,65,128,116,243,15,221
],[
62,45,217,91,116,190,211,170,18,125,7,249,160,168,77,22,190,40,119,215
],[
1,22,204,184,253,127,184,197,163,100,193,187,206,5,189,106,24,96,66,93
],[
242,244,95,189,244,202,137,115,113,182,216,141,79,219,116,227,21,109,74,250
],[
70,187,3,40,238,108,54,249,122,8,220,210,204,187,5,212,143,86,202,3
]
]