aLevelData = [
[
2,2,2,2,2,11,2,2,2,2,2,2,2,2,9,58,197,179,43,45
],[
2,2,2,2,2,2,2,2,2,2,2,2,2,2,2,86,2,123,199,42
],[
5,2,5,2,5,5,5,2,5,5,5,2,5,5,5,220,42,63,110,73
],[
5,2,5,2,5,2,5,2,5,2,5,2,5,2,5,114,251,192,3,116
],[
5,5,5,2,5,5,5,2,5,5,5,2,5,5,5,165,240,42,32,129
],[
5,2,5,2,5,2,5,2,5,2,2,2,5,2,2,3,57,84,254,126
],[
5,2,5,2,5,2,5,2,5,2,2,2,5,2,2,57,72,139,225,52
],[
2,2,2,12,2,2,2,2,2,2,2,2,2,10,2,41,171,113,237,4
],[
2,2,7,2,2,2,2,2,8,2,2,2,2,2,2,76,58,206,230,85
],[
2,2,7,2,5,5,5,2,5,5,5,2,5,5,2,85,34,66,126,103
],[
2,2,7,2,5,2,2,2,2,5,2,2,5,2,5,132,146,100,106,151
],[
2,2,7,2,5,5,5,2,2,5,2,2,5,2,5,65,221,176,248,201
],[
2,2,7,2,5,2,2,2,2,5,2,2,5,2,5,136,36,113,25,169
],[
2,2,7,2,5,5,5,2,5,5,5,2,5,5,2,212,112,57,52,172
],[
2,2,2,2,2,2,2,2,2,2,2,2,2,2,2,183,48,40,132,84
],[
13,2,2,2,3,3,3,3,3,3,3,3,3,3,3,38,30,94,212,198
],[
2,2,2,2,2,2,2,2,2,2,2,2,2,2,2,34,232,180,230,193
],[
2,2,2,2,2,2,2,2,2,2,2,2,2,2,2,73,24,106,99,25
],[
2,2,2,2,2,2,2,2,2,2,2,2,2,2,2,191,101,220,177,55
],[
130,61,166,77,163,240,144,200,199,4,16,87,49,197,17,199,199,144,77,121
]
]