aLevelData = [
[
2,2,2,96,178,219,186,251,202,27,156,169,4,223,57,87,172,19,93,242
],[
2,2,2,10,173,177,204,54,53,50,66,46,132,225,156,38,204,188,52,31
],[
2,2,2,216,238,219,187,149,67,120,80,210,222,242,59,68,46,80,119,205
],[
2,2,2,30,31,110,253,140,20,14,218,253,243,32,220,143,175,213,60,47
],[
2,2,2,211,162,111,11,32,78,237,74,120,74,54,251,251,64,23,76,111
],[
2,2,2,238,41,253,229,53,156,20,153,109,50,209,27,252,142,228,172,39
],[
2,2,2,175,222,235,40,184,230,177,128,242,173,57,142,19,164,132,97,193
],[
2,2,2,108,251,203,82,141,87,182,214,108,190,187,87,119,46,241,95,163
],[
2,2,11,31,3,187,24,100,134,127,42,83,137,74,140,37,109,203,192,160
],[
2,2,2,247,132,210,243,163,206,70,225,59,30,79,33,169,134,66,5,10
],[
2,2,2,127,73,91,3,229,92,145,88,67,109,28,186,81,227,25,225,187
],[
2,2,2,74,53,219,36,73,203,164,107,212,77,246,45,162,229,98,139,226
],[
2,2,2,92,160,45,42,58,36,134,176,47,241,90,188,177,178,126,93,231
],[
2,2,2,7,224,92,198,29,199,110,122,129,91,173,7,54,103,73,48,5
],[
2,9,2,94,123,152,20,156,187,39,186,239,51,175,146,86,115,207,206,8
],[
2,2,2,102,24,206,184,133,111,242,24,74,178,172,156,232,159,217,128,57
],[
2,2,2,241,81,12,248,203,188,23,48,90,168,202,244,183,217,166,81,10
],[
224,200,129,245,240,108,97,48,236,177,38,112,196,156,75,142,2,94,205,229
],[
160,218,155,252,29,98,72,101,208,193,4,228,123,127,202,212,35,96,219,199
],[
31,46,106,109,112,184,153,183,80,27,164,59,13,64,92,219,24,166,216,161
]
]