aLevelData = [
[
4,2,5,5,74,191,105,191,113,44,178,109,3,220,177,132,193,217,86,2
],[
2,2,2,2,63,182,246,185,152,118,158,82,95,169,166,145,217,216,137,219
],[
2,2,2,2,105,35,244,245,75,41,28,14,133,40,85,0,27,101,225,211
],[
3,3,3,3,131,207,5,130,88,223,98,2,83,194,131,129,118,186,179,236
],[
2,2,3,2,138,194,17,179,204,113,230,208,228,32,53,6,22,79,148,102
],[
13,2,3,2,188,69,59,24,244,247,91,88,150,43,177,191,105,221,90,196
],[
2,5,3,2,150,226,233,130,92,203,183,188,6,12,122,30,26,94,25,197
],[
2,12,3,2,212,97,191,2,210,134,47,91,17,44,87,211,24,9,39,108
],[
5,2,3,3,115,204,163,233,99,0,55,216,212,52,75,208,143,89,24,248
],[
11,2,3,2,177,107,186,200,92,84,134,20,172,13,157,70,237,6,193,235
],[
11,200,104,113,73,217,15,46,54,223,209,165,222,9,56,5,61,171,83,243
],[
249,40,9,137,80,21,172,159,78,155,210,73,68,29,96,160,119,27,231,198
],[
21,87,52,36,109,54,34,246,94,104,179,10,16,203,95,196,227,141,172,102
],[
165,146,255,142,8,21,178,1,83,145,102,166,87,226,155,214,165,167,126,211
],[
254,236,1,149,11,6,49,205,78,189,197,36,89,177,242,195,62,246,135,25
],[
70,2,53,216,230,201,46,65,238,38,243,162,4,125,102,29,81,159,39,170
],[
122,237,29,95,210,193,83,240,206,9,6,114,185,53,252,100,168,84,23,239
],[
177,121,41,109,88,100,10,41,74,94,232,101,78,101,223,162,120,137,201,27
],[
159,150,88,147,18,243,98,80,135,202,123,104,84,105,201,59,226,233,20,65
],[
94,13,29,6,177,108,49,114,179,211,253,78,155,229,164,4,187,4,15,166
]
]