aLevelData = [
[
12,2,2,2,2,2,2,2,85,33,149,163,106,171,214,123,78,3,7,135
],[
2,2,2,2,2,2,2,2,143,76,70,185,108,156,229,108,230,187,29,68
],[
2,2,3,3,3,3,3,3,26,40,0,92,205,93,176,160,73,84,207,119
],[
11,2,3,2,2,2,2,2,104,74,54,166,238,195,234,113,27,206,75,2
],[
2,2,3,2,2,2,2,2,129,138,143,15,20,233,111,184,128,180,32,174
],[
2,2,3,2,2,2,2,2,191,208,133,154,234,191,163,189,79,105,85,211
],[
10,2,3,2,2,2,2,2,197,29,65,62,60,211,10,96,152,180,200,73
],[
2,2,3,2,2,2,2,2,192,220,181,146,241,94,40,136,89,136,200,142
],[
2,2,3,2,2,2,2,3,225,105,249,188,74,145,155,204,123,24,244,55
],[
9,2,3,2,2,2,2,3,25,226,234,155,89,32,118,96,18,26,85,155
],[
2,2,3,2,2,2,3,2,23,45,1,50,195,15,223,66,213,91,186,189
],[
2,2,3,2,2,3,2,2,126,73,112,88,185,188,235,164,219,131,83,122
],[
8,2,3,2,2,3,2,2,107,216,130,157,51,45,185,155,151,41,145,244
],[
2,2,3,2,3,3,2,2,38,237,52,126,111,155,204,8,22,25,60,62
],[
2,2,3,2,3,2,2,2,39,18,15,205,169,62,173,199,119,228,213,72
],[
6,2,3,2,3,2,2,2,75,157,71,90,28,90,193,22,170,168,45,12
],[
2,2,3,3,3,2,2,2,87,51,25,229,56,137,103,71,108,33,70,249
],[
2,2,2,2,2,2,2,3,172,156,97,72,36,74,86,169,129,240,105,159
],[
76,201,122,223,118,202,52,179,52,42,136,156,13,34,89,59,48,242,121,113
],[
12,36,213,198,27,20,236,7,254,176,134,51,207,125,162,153,179,219,176,58
]
]