aLevelData = [
[
2,2,2,2,2,2,2,2,2,2,2,2,19,24,110,232,249,118,100,26
],[
2,2,2,2,2,2,2,2,3,3,3,3,100,114,246,14,204,181,255,195
],[
2,2,3,2,3,2,2,2,2,3,2,2,126,101,215,190,66,63,29,183
],[
2,2,3,2,3,2,2,2,2,2,3,2,59,230,179,147,14,122,9,146
],[
2,2,3,2,3,2,2,2,2,2,2,3,71,109,159,202,248,146,197,212
],[
2,2,3,2,2,2,2,2,2,2,2,2,162,119,166,197,89,245,132,95
],[
2,2,3,2,3,3,3,3,3,3,3,3,36,5,69,137,163,213,47,253
],[
2,2,3,2,2,2,2,2,2,2,2,2,244,28,240,65,214,170,225,216
],[
2,2,3,2,3,3,3,3,3,3,3,3,15,67,139,185,12,173,107,0
],[
2,2,3,2,2,2,2,2,2,2,2,2,200,8,242,228,239,94,208,233
],[
2,2,3,3,3,3,3,3,3,3,3,3,66,123,114,86,61,255,201,234
],[
1,2,3,2,2,2,2,2,2,2,2,2,247,177,78,203,75,22,67,191
],[
2,2,3,5,5,2,2,2,5,5,5,5,53,67,59,158,126,239,220,8
],[
2,2,3,2,2,5,5,5,5,5,2,2,156,204,228,83,212,24,106,199
],[
6,5,3,3,3,2,5,2,2,2,2,2,161,110,103,14,89,227,116,230
],[
5,2,3,2,2,3,2,5,2,2,2,2,14,78,213,25,178,231,183,175
],[
5,3,2,2,2,2,3,2,5,5,2,2,127,20,182,98,150,127,162,82
],[
5,3,2,2,2,2,2,3,2,5,2,2,231,108,131,250,80,74,218,99
],[
9,135,42,151,63,169,183,89,255,155,142,19,86,68,197,16,183,94,4,235
],[
156,134,69,72,112,143,215,193,173,28,169,36,66,110,197,219,55,122,27,171
]
]