aLevelData = [
[
2,2,2,2,2,2,2,2,2,6,5,2,192,72,217,216,49,212,210,89
],[
2,3,5,3,5,5,5,3,5,3,5,2,180,131,100,10,173,180,191,106
],[
2,3,2,3,2,2,2,3,5,3,5,2,112,249,127,189,6,204,136,93
],[
2,2,2,2,2,2,2,2,2,2,2,2,47,125,53,81,163,111,179,32
],[
2,3,5,3,5,5,5,3,2,3,5,5,157,132,167,231,154,214,23,170
],[
2,3,5,3,5,5,5,3,2,3,5,5,94,168,135,232,57,156,98,114
],[
2,5,5,5,5,5,5,5,5,5,5,5,136,38,156,125,126,64,150,245
],[
2,3,5,3,5,5,5,3,5,3,5,5,37,95,66,20,159,166,135,52
],[
2,3,5,3,5,5,5,3,5,3,5,5,178,90,231,225,132,151,95,51
],[
162,65,142,90,71,60,26,123,220,224,80,187,187,167,10,153,56,41,214,128
],[
226,75,84,156,6,179,224,238,117,127,113,155,135,54,193,138,96,254,175,45
],[
114,16,225,159,67,106,173,240,113,195,58,189,243,196,226,3,161,117,219,52
],[
247,246,23,139,22,111,104,157,11,73,232,50,84,159,152,82,160,239,71,163
],[
215,22,182,242,90,123,249,15,140,138,32,222,145,100,23,171,86,212,203,190
],[
209,134,142,47,138,115,189,252,90,160,160,89,114,8,145,71,160,214,97,104
],[
206,216,247,18,204,49,58,162,79,78,50,19,57,27,105,207,26,118,152,196
],[
247,228,127,187,75,130,21,229,76,63,225,183,111,73,168,248,46,197,72,25
],[
9,195,228,196,203,113,65,183,14,142,112,211,1,34,174,112,105,109,136,244
],[
230,29,67,164,120,196,122,186,65,136,9,183,141,29,42,250,15,240,222,146
],[
109,165,143,81,0,196,243,33,213,175,51,155,247,216,77,214,240,48,183,125
]
]