aLevelData = [
[
2,2,2,2,5,5,2,2,2,5,129,7,242,107,69,19,6,204,138,74
],[
2,2,2,4,2,2,2,2,2,142,229,105,111,23,161,114,227,77,139,79
],[
5,3,3,3,5,5,3,3,3,188,190,136,163,22,225,198,56,174,87,240
],[
2,3,2,2,2,2,2,2,2,90,173,112,164,126,193,241,38,40,114,21
],[
2,3,2,2,2,2,2,2,2,86,11,180,209,223,113,184,92,178,221,8
],[
2,3,2,2,3,2,2,2,2,239,179,239,211,202,177,137,133,119,156,48
],[
2,3,2,2,3,2,2,2,2,155,82,242,181,182,73,123,20,238,225,54
],[
2,3,2,2,3,5,5,3,3,156,104,121,147,80,43,211,226,142,47,208
],[
2,3,3,2,3,2,2,3,2,12,238,183,123,129,109,225,73,113,203,124
],[
2,2,3,2,3,2,2,3,2,160,63,49,25,149,51,23,101,250,111,101
],[
2,2,3,2,3,2,2,3,2,182,152,36,216,227,185,5,168,89,234,252
],[
2,2,3,2,3,2,2,3,2,104,107,254,28,45,234,86,216,242,246,96
],[
2,2,2,2,3,2,2,3,2,114,59,19,94,182,249,128,105,231,174,196
],[
2,2,2,2,3,2,2,3,2,181,250,209,137,22,2,116,173,195,236,36
],[
2,2,2,2,3,2,2,3,2,151,91,108,17,199,37,55,111,177,156,115
],[
6,2,2,2,3,2,2,3,5,27,204,43,107,130,230,53,136,191,186,88
],[
125,3,196,243,193,58,84,229,66,235,226,152,88,96,161,63,247,8,86,91
],[
42,25,107,132,188,121,63,102,56,223,193,10,21,54,61,87,42,66,118,216
],[
104,133,244,191,199,100,159,42,129,134,141,166,127,125,25,241,16,168,53,5
],[
225,87,1,81,42,49,156,74,37,211,57,34,196,186,118,215,163,99,234,112
]
]