aLevelData = [
[
2,2,2,2,2,2,2,2,2,2,2,2,220,4,130,27,71,75,91,201
],[
2,2,2,2,2,2,2,2,2,2,2,2,212,35,147,24,56,62,171,221
],[
2,2,2,2,2,2,2,2,2,2,2,2,10,170,2,67,210,155,144,182
],[
2,2,2,13,2,2,2,2,2,2,2,2,100,107,214,0,108,223,21,178
],[
2,2,2,2,2,2,2,2,2,2,2,2,73,172,191,198,31,57,43,130
],[
39,167,140,160,74,15,36,171,239,10,181,172,17,119,57,6,148,120,210,159
],[
217,190,4,64,144,7,34,63,205,228,6,91,94,192,5,231,93,30,35,43
],[
1,34,130,7,185,83,33,217,124,159,195,161,90,160,44,99,88,29,147,205
],[
122,212,85,26,33,118,231,54,151,244,14,35,233,249,82,155,245,183,176,247
],[
195,231,143,79,25,11,245,227,73,247,251,185,78,143,126,136,23,210,24,213
],[
35,24,78,92,78,151,11,177,235,44,78,39,18,89,31,241,59,138,199,135
],[
12,156,64,76,112,159,235,109,233,219,129,12,39,18,76,158,217,5,151,145
],[
195,57,99,50,17,251,91,207,235,162,10,24,73,20,76,203,9,140,2,145
],[
63,154,10,35,204,107,111,176,50,74,220,131,166,103,87,225,103,215,43,48
],[
79,221,38,95,167,104,5,129,64,220,45,187,191,21,156,97,57,170,30,92
],[
0,110,196,207,188,61,146,250,189,245,120,94,143,194,132,33,207,159,85,181
],[
62,25,211,181,20,86,29,15,151,87,195,104,235,122,54,188,44,67,124,69
],[
186,91,40,159,212,217,138,41,105,193,35,174,42,202,91,69,228,101,119,117
],[
13,250,197,157,157,117,25,147,31,1,125,140,7,19,37,60,70,171,161,62
],[
28,215,86,181,45,120,47,52,216,72,144,219,196,28,140,195,187,103,87,157
]
]