aLevelData = [
[
4,2,5,5,2,2,2,2,2,2,2,2,2,2,132,30,255,70,224,49
],[
2,2,2,2,2,2,5,2,2,2,5,2,2,2,144,107,38,126,141,13
],[
2,2,2,2,2,2,3,3,3,3,3,3,3,2,181,187,94,70,73,128
],[
3,3,3,3,3,3,3,2,2,2,2,2,3,2,203,11,20,8,179,16
],[
2,2,3,2,2,2,2,2,2,2,2,2,3,2,17,54,0,230,149,214
],[
13,2,3,2,2,2,2,2,2,3,2,2,3,2,218,102,39,38,27,83
],[
2,5,3,2,2,2,2,2,2,3,2,2,3,2,145,148,3,59,55,202
],[
2,12,3,2,2,2,2,2,2,3,2,2,3,2,46,158,168,232,194,83
],[
5,2,3,3,3,3,3,3,3,3,2,2,3,3,115,16,237,38,60,40
],[
11,2,3,2,2,2,2,2,2,2,2,2,2,2,143,198,14,219,51,223
],[
2,5,3,2,2,2,2,2,2,2,2,2,2,2,243,225,68,131,194,129
],[
2,10,3,2,2,2,2,2,2,2,2,2,2,2,126,206,57,84,162,202
],[
5,2,2,2,2,2,2,2,2,2,2,2,2,2,75,75,110,144,187,243
],[
2,2,2,2,2,2,2,2,2,2,2,2,2,2,204,176,234,248,74,211
],[
9,5,3,2,2,2,2,2,2,2,2,2,2,2,238,233,202,159,227,58
],[
2,2,3,2,2,2,2,2,3,3,3,3,3,3,122,219,134,143,7,212
],[
5,8,3,2,2,2,2,2,3,2,2,2,2,3,0,56,14,255,255,247
],[
2,2,3,2,2,2,2,2,5,2,1,2,2,3,212,223,11,10,54,41
],[
6,5,3,3,3,3,3,3,3,2,2,2,2,3,24,101,227,39,87,64
],[
2,2,2,2,2,2,2,2,2,2,2,2,2,2,200,90,82,209,204,99
]
]