aLevelData = [
[
2,2,2,2,2,2,2,2,2,2,2,2,2,2,2,2,2,2,2,176
],[
2,2,2,2,2,2,2,2,2,2,2,2,2,2,2,2,2,2,2,28
],[
2,2,2,2,2,2,2,2,2,2,2,2,2,2,2,2,2,2,2,122
],[
2,2,2,3,3,3,3,3,3,3,3,3,3,3,3,3,3,3,2,108
],[
2,2,2,2,2,2,2,2,2,2,2,2,2,2,2,2,2,2,2,163
],[
2,2,2,2,2,2,2,2,2,2,2,2,2,2,2,2,2,2,2,70
],[
2,2,2,2,2,3,2,2,3,2,2,3,2,2,2,3,2,2,3,55
],[
2,2,2,3,3,3,3,3,3,3,3,3,3,3,3,3,3,3,3,202
],[
2,2,2,2,2,2,2,2,2,2,2,2,2,2,2,2,2,2,2,11
],[
2,2,2,2,2,2,2,2,2,2,2,2,2,2,2,2,2,2,2,201
],[
2,2,3,3,3,3,3,3,3,3,3,3,3,3,3,3,3,3,2,188
],[
81,117,209,23,40,124,89,231,190,226,238,20,177,223,182,189,239,184,178,114
],[
27,148,64,164,50,140,228,89,110,1,71,36,106,50,128,85,136,13,147,109
],[
144,70,55,213,153,167,221,207,45,167,237,172,168,61,83,64,225,246,58,147
],[
12,70,23,217,223,27,234,164,244,184,193,89,111,193,125,224,224,146,216,160
],[
107,213,167,171,38,84,93,53,194,11,209,75,110,130,65,194,248,90,150,109
],[
53,37,233,147,164,123,71,159,78,74,177,26,240,109,103,215,92,128,103,109
],[
29,243,48,234,90,94,203,198,253,20,12,22,19,251,22,2,118,155,29,121
],[
170,116,112,36,6,149,182,152,20,106,119,207,58,214,223,217,153,129,191,207
],[
53,116,213,9,86,227,77,144,47,73,135,214,190,187,27,165,243,117,27,86
]
]