aLevelData = [
[
4,2,2,2,250,239,162,4,221,1,120,159,248,50,160,47,108,173,239,74
],[
5,2,5,3,70,216,124,183,4,207,73,129,86,16,37,74,33,120,208,226
],[
2,5,5,3,201,110,97,24,176,94,229,208,250,105,73,86,148,90,122,242
],[
3,3,5,5,116,220,202,189,34,235,150,178,119,137,37,8,164,178,212,192
],[
2,3,5,5,119,145,112,122,218,244,228,140,157,254,20,85,117,27,8,207
],[
3,3,5,5,68,57,77,100,154,54,152,3,124,148,173,114,101,116,127,230
],[
3,5,5,5,139,194,153,209,99,173,188,251,103,90,202,212,23,217,226,9
],[
3,5,5,3,62,88,205,85,118,150,153,154,238,155,131,48,107,167,27,124
],[
3,5,5,3,141,104,162,197,84,111,183,68,226,229,51,122,131,122,81,199
],[
3,5,5,3,234,159,18,55,190,245,223,159,85,5,112,233,191,49,238,172
],[
3,5,5,3,6,234,84,0,180,36,27,144,150,7,22,240,192,232,155,49
],[
5,5,5,3,209,119,227,179,120,58,179,59,55,58,60,69,103,252,65,156
],[
5,5,5,3,125,178,119,39,139,179,49,6,10,41,60,222,214,9,8,112
],[
5,3,3,3,122,73,9,113,174,77,93,149,30,162,175,238,109,238,91,116
],[
5,3,2,2,122,39,211,229,226,4,65,207,198,177,110,234,206,199,226,172
],[
5,3,3,2,109,123,77,24,103,22,37,215,145,165,145,137,216,241,134,93
],[
133,177,47,223,192,255,147,18,82,9,114,191,175,9,111,12,51,119,117,80
],[
172,124,83,38,25,171,169,193,177,236,8,127,39,184,85,192,45,140,110,248
],[
55,151,16,3,129,182,249,185,83,163,73,195,132,106,46,173,61,28,192,59
],[
255,198,42,1,231,164,11,46,49,147,28,169,252,197,18,95,76,184,198,219
]
]