aLevelData = [
[
2,2,2,2,2,2,2,2,2,2,2,156,106,190,249,80,42,49,201,167
],[
2,2,2,2,2,2,2,2,2,2,2,14,3,22,187,29,52,171,188,23
],[
2,2,2,2,2,2,2,2,2,2,2,144,251,227,159,60,98,168,159,144
],[
2,2,2,13,2,2,2,2,2,2,2,174,53,233,36,222,26,26,46,42
],[
2,2,2,2,2,2,2,2,2,2,2,66,196,11,67,38,204,27,219,64
],[
2,2,2,2,2,2,2,2,2,2,2,16,210,104,195,77,12,37,137,65
],[
2,2,2,2,2,2,2,2,2,2,2,161,90,77,12,58,222,26,220,99
],[
2,2,2,2,2,2,2,2,2,1,2,218,3,201,225,207,21,254,69,219
],[
2,2,11,2,2,2,2,2,2,2,2,138,26,193,56,63,214,59,5,105
],[
2,2,2,2,2,2,2,2,2,2,2,231,160,73,131,38,123,53,139,238
],[
2,2,2,2,2,2,2,2,2,2,2,198,169,109,197,255,250,192,63,127
],[
2,2,2,2,2,2,2,2,2,2,2,243,176,32,8,25,59,193,157,51
],[
2,2,2,2,2,2,2,2,2,2,2,161,181,150,10,21,171,243,110,185
],[
2,2,2,2,2,2,2,2,2,2,2,150,241,121,201,12,219,24,22,236
],[
35,198,183,68,177,155,251,114,123,134,162,137,86,215,76,246,11,0,49,99
],[
174,156,19,219,43,176,113,47,34,49,254,153,245,199,81,160,31,209,222,59
],[
199,169,37,57,148,41,41,224,196,110,36,213,120,219,121,60,82,97,234,31
],[
66,254,11,20,157,132,246,26,112,156,65,197,19,10,45,155,1,51,32,189
],[
230,220,86,202,250,52,211,0,142,21,156,164,228,135,38,164,68,134,15,124
],[
76,5,12,86,136,50,35,117,67,252,26,211,156,210,47,9,220,174,9,112
]
]