aLevelData = [
[
2,2,2,2,5,5,2,2,2,2,2,2,2,2,2,2,199,68,67,214
],[
2,2,2,4,2,2,2,2,2,2,2,5,2,2,2,5,155,69,9,98
],[
5,3,3,3,5,5,3,3,3,3,3,3,3,3,3,3,154,155,71,41
],[
2,3,2,2,2,2,2,2,2,3,2,2,2,2,3,2,5,90,80,127
],[
2,3,2,2,2,2,2,2,2,3,2,2,2,2,3,2,241,12,19,231
],[
2,3,2,2,3,2,2,2,2,3,2,2,2,2,3,2,227,249,77,124
],[
2,3,2,2,3,2,2,2,2,3,2,2,2,2,3,2,156,165,253,143
],[
2,3,2,2,3,5,5,3,3,3,3,3,2,2,3,2,54,153,25,146
],[
2,3,3,2,3,2,2,3,2,2,2,3,2,2,3,2,112,102,127,52
],[
2,2,3,2,3,2,2,3,2,1,2,3,2,2,3,2,71,232,46,206
],[
2,2,3,2,3,2,2,3,2,2,2,3,2,2,3,2,198,200,182,254
],[
30,68,237,145,249,51,228,167,12,67,25,17,235,134,238,254,34,45,90,215
],[
129,147,223,103,183,125,188,63,35,160,99,89,230,99,45,251,61,231,77,222
],[
14,68,3,144,192,22,18,23,80,57,115,215,161,208,75,182,20,140,27,125
],[
89,43,54,129,133,62,121,132,100,48,54,214,16,132,113,191,194,94,79,34
],[
233,69,203,90,121,39,171,104,134,157,178,80,17,113,24,192,34,94,55,243
],[
23,22,135,213,59,138,204,104,154,101,142,102,20,217,202,40,177,159,231,198
],[
52,57,235,128,243,123,239,92,229,73,209,17,253,162,40,36,182,222,125,81
],[
240,51,184,44,250,126,216,8,240,64,231,24,71,231,45,212,166,80,165,158
],[
247,137,173,166,191,219,1,11,170,8,234,67,107,209,179,188,194,187,93,195
]
]