aLevelData = [
[
2,217,184,4,214,239,229,112,246,159,228,133,199,67,251,125,103,11,227,62
],[
2,242,58,42,50,1,146,214,83,112,12,75,133,101,205,111,41,141,86,11
],[
2,239,169,251,117,235,74,150,108,236,216,124,67,9,217,176,66,124,112,87
],[
2,73,180,36,108,182,165,227,181,137,99,71,246,198,239,24,100,27,80,17
],[
2,92,195,230,231,85,170,252,135,20,210,156,159,31,245,167,97,115,108,37
],[
132,121,79,217,139,55,222,24,73,195,31,220,165,254,201,21,155,126,97,63
],[
131,204,163,57,150,208,35,85,174,137,52,172,77,2,9,180,225,129,26,20
],[
70,1,201,182,141,226,70,30,252,224,176,251,85,66,125,252,92,83,27,229
],[
147,22,215,226,72,54,255,27,209,60,67,136,23,4,97,7,81,114,2,172
],[
18,97,222,88,134,220,39,141,248,145,37,128,152,130,30,112,124,254,120,55
],[
228,208,33,31,194,182,47,246,122,21,196,101,230,234,53,125,157,4,107,147
],[
117,113,137,78,70,54,206,254,241,67,190,47,161,165,124,127,81,254,123,172
],[
143,50,85,241,127,100,251,147,34,33,15,183,216,218,142,118,36,152,178,51
],[
176,235,23,44,145,35,28,80,203,195,140,81,24,51,126,249,229,181,121,193
],[
158,154,220,160,43,182,125,33,187,17,145,184,192,223,204,86,58,179,201,59
],[
57,239,171,12,157,127,5,37,33,199,247,48,152,217,154,246,118,236,158,118
],[
145,10,50,52,41,8,36,212,38,187,74,231,162,105,32,5,167,126,178,28
],[
58,128,189,7,152,69,17,99,191,100,57,158,48,233,94,80,244,77,105,207
],[
221,165,104,254,14,25,51,101,189,152,79,135,56,202,18,111,38,70,8,141
],[
16,6,150,192,32,23,221,180,40,149,225,110,229,215,235,37,134,231,44,84
]
]