aLevelData = [
[
6,2,2,2,208,35,33,118,248,158,29,123,61,19,42,75,42,120,188,152
],[
2,2,2,2,119,49,241,26,208,203,116,223,217,236,161,227,110,138,234,224
],[
2,2,2,2,47,92,121,103,60,142,22,48,61,185,76,175,166,18,199,231
],[
3,3,3,3,57,226,1,131,204,54,30,35,76,215,20,244,2,124,14,131
],[
2,2,2,2,21,63,19,211,80,78,226,173,38,227,33,55,243,118,183,200
],[
2,2,2,2,133,49,119,251,219,164,254,2,44,186,222,61,44,235,252,11
],[
2,2,2,2,138,180,54,225,189,68,73,153,0,121,242,12,155,10,84,226
],[
2,2,3,3,101,6,154,169,135,125,221,37,130,124,72,231,116,63,122,33
],[
2,2,2,2,151,163,43,185,10,218,19,156,212,98,7,85,38,56,102,222
],[
2,2,2,2,224,73,179,182,87,41,131,51,85,7,154,26,98,225,81,109
],[
3,3,3,3,66,244,59,132,191,119,7,95,169,136,168,59,26,103,180,99
],[
2,2,2,2,254,226,10,73,211,16,184,213,174,66,28,253,127,55,73,150
],[
2,2,2,2,149,143,171,106,101,130,239,138,135,210,29,230,1,254,7,26
],[
2,2,3,3,200,185,231,139,132,154,68,179,148,21,21,185,82,170,41,69
],[
2,2,3,2,152,92,198,146,131,101,145,197,118,40,173,125,98,103,39,171
],[
2,2,3,2,69,182,146,164,241,48,238,116,15,104,207,117,99,163,187,33
],[
2,2,3,3,82,68,211,37,161,135,181,182,127,114,162,40,198,9,220,189
],[
126,194,82,187,163,56,127,193,39,35,144,90,59,136,197,211,203,45,25,74
],[
71,80,37,8,169,152,66,17,180,76,238,248,121,195,113,248,32,28,192,65
],[
229,47,161,144,97,194,16,2,11,1,225,42,254,40,168,97,253,131,214,93
]
]