aLevelData = [
[
2,2,2,2,2,11,2,2,2,2,2,2,2,2,9,2,2,2,2,245
],[
2,2,2,2,2,2,2,2,2,2,2,2,2,2,2,2,2,2,2,136
],[
5,2,5,2,5,5,5,2,5,5,5,2,5,5,5,2,5,2,5,117
],[
5,2,5,2,5,2,5,2,5,2,5,2,5,2,5,2,2,5,2,238
],[
5,5,5,2,5,5,5,2,5,5,5,2,5,5,5,2,2,5,2,52
],[
5,2,5,2,5,2,5,2,5,2,2,2,5,2,2,2,2,5,2,252
],[
197,55,238,84,107,123,189,84,107,191,104,49,115,7,173,73,190,180,62,16
],[
56,16,9,78,227,40,188,136,121,218,137,187,83,46,39,81,137,234,25,77
],[
91,96,50,201,208,139,89,162,156,90,138,114,71,76,29,190,140,61,75,113
],[
0,128,238,137,244,45,136,17,155,188,135,79,112,211,199,62,210,93,89,63
],[
241,220,131,11,238,0,7,236,62,120,168,45,80,8,235,206,111,220,27,125
],[
233,28,143,194,113,192,48,122,194,166,53,134,133,225,49,196,117,85,80,62
],[
193,129,221,162,177,155,8,243,141,226,231,125,187,48,186,14,39,206,115,99
],[
232,141,118,225,32,18,157,134,35,114,127,30,220,255,242,186,109,97,206,94
],[
22,232,244,250,88,32,143,155,90,166,154,227,139,59,163,183,137,23,206,55
],[
66,127,28,243,89,154,237,91,203,129,196,120,210,149,75,218,9,21,151,210
],[
209,240,172,225,244,215,68,111,137,151,204,192,24,166,176,37,254,251,216,111
],[
18,35,115,169,136,146,243,7,22,55,88,25,86,83,178,68,108,138,225,115
],[
232,59,160,10,238,13,194,28,148,202,186,221,139,113,97,90,2,134,244,103
],[
199,173,92,217,175,119,179,246,57,124,3,42,110,170,81,252,11,220,218,63
]
]