aLevelData = [
[
2,2,2,2,2,2,2,2,2,2,2,2,2,180,231,185,117,86,101,78
],[
2,2,2,2,2,2,2,2,2,2,2,2,2,194,140,169,18,10,57,91
],[
2,2,2,2,2,2,2,2,2,2,2,2,2,22,234,15,177,207,214,73
],[
2,2,2,13,2,2,2,2,2,2,2,2,2,74,106,21,157,89,95,13
],[
2,2,2,2,2,2,2,2,2,2,2,2,2,108,5,73,193,61,16,245
],[
2,2,2,2,2,2,2,2,2,2,2,2,2,152,105,183,185,96,23,218
],[
2,2,2,2,2,2,2,2,2,2,2,2,2,7,146,107,93,65,216,251
],[
206,207,204,131,72,112,3,217,151,205,74,35,156,84,47,71,243,67,196,163
],[
212,3,159,255,55,184,37,191,60,22,9,93,201,118,15,23,117,41,22,229
],[
165,12,85,174,244,92,229,187,217,204,127,108,132,213,136,42,8,78,74,156
],[
191,60,133,30,234,235,38,111,153,62,86,169,203,67,182,119,213,10,233,130
],[
8,184,84,44,142,215,33,129,149,240,138,106,176,92,84,36,121,87,153,241
],[
124,86,203,14,80,155,246,228,7,6,69,130,201,46,200,75,187,176,116,236
],[
37,199,108,146,213,29,127,89,190,225,241,7,229,26,126,250,126,59,156,95
],[
81,247,1,165,99,86,101,49,211,9,137,84,2,251,120,122,246,40,12,164
],[
1,178,181,24,157,49,118,86,155,75,48,79,125,134,35,210,32,89,178,71
],[
158,137,102,159,114,179,54,139,221,36,6,236,137,241,109,139,109,69,187,11
],[
240,245,59,28,81,90,181,241,70,95,55,243,227,217,21,183,190,23,47,45
],[
81,186,114,27,159,199,162,202,27,251,86,0,197,95,68,45,150,28,190,233
],[
30,143,125,158,108,160,158,130,46,80,234,201,25,146,90,24,139,92,218,60
]
]