aLevelData = [
[
2,2,2,2,2,11,2,2,2,2,2,2,2,2,9,2,2,2,2,222
],[
2,2,2,2,2,2,2,2,2,2,2,2,2,2,2,2,2,2,2,143
],[
163,33,231,135,194,240,56,155,173,247,7,186,233,185,162,140,204,65,176,168
],[
226,255,186,8,144,210,234,185,247,102,18,215,27,192,239,185,69,23,176,105
],[
166,230,178,87,60,63,142,78,250,98,85,166,35,142,26,188,247,23,177,159
],[
145,185,183,12,16,44,210,157,245,248,58,61,204,139,121,223,15,137,111,112
],[
71,99,152,9,116,43,146,106,175,167,217,164,14,164,214,21,200,140,24,153
],[
153,59,225,255,104,15,228,186,40,62,77,217,252,109,2,58,158,126,40,250
],[
1,169,234,47,53,206,117,218,140,9,71,23,251,136,170,151,194,153,123,80
],[
79,7,48,115,96,167,26,159,105,46,230,84,53,69,106,170,207,224,159,67
],[
163,203,233,126,225,133,159,237,34,82,199,10,78,140,33,37,189,58,104,161
],[
156,228,212,96,147,165,227,124,164,129,89,56,87,249,133,54,20,221,199,234
],[
208,98,79,78,236,116,39,215,89,77,116,168,1,71,249,7,98,238,220,13
],[
124,90,173,161,238,188,164,167,92,54,42,116,19,240,155,133,240,104,75,113
],[
126,9,199,29,94,0,93,47,236,75,222,197,31,18,162,102,177,59,205,57
],[
128,57,209,116,53,36,52,24,35,15,148,220,114,150,232,102,124,182,8,193
],[
119,226,112,12,85,82,64,111,232,159,136,84,74,141,195,211,124,39,161,109
],[
77,18,10,254,125,27,95,237,35,18,3,166,76,219,26,74,229,194,144,164
],[
219,15,93,96,128,218,8,119,49,33,106,238,54,24,181,192,233,192,181,25
],[
26,187,85,196,179,95,100,231,152,9,153,238,209,180,213,197,235,202,169,74
]
]