aLevelData = [
[
2,2,3,3,3,3,3,3,3,3,3,3,27,130,124,112,157,231,197,104
],[
2,2,2,2,2,2,2,2,2,2,2,2,124,55,75,177,76,7,97,36
],[
3,2,3,3,3,3,3,3,3,3,3,2,19,147,94,141,252,167,239,175
],[
2,2,2,2,2,2,2,2,2,2,2,2,80,191,178,137,161,109,0,216
],[
3,2,3,3,3,3,3,3,3,3,3,3,73,251,10,221,19,81,39,96
],[
2,2,3,2,2,2,2,2,2,2,2,2,55,26,108,245,140,35,126,126
],[
3,2,3,2,2,3,3,3,3,3,3,3,249,3,164,241,44,1,32,92
],[
2,2,3,2,2,3,2,2,2,2,2,3,143,50,192,38,120,226,176,151
],[
2,3,3,2,2,3,3,3,3,2,2,2,161,53,146,154,215,14,208,194
],[
2,2,2,2,2,2,2,2,2,3,2,3,246,48,49,140,20,164,171,228
],[
3,3,3,3,2,2,2,2,2,3,2,3,253,90,121,234,224,19,109,245
],[
8,2,6,3,2,3,3,3,3,3,2,3,71,125,134,216,76,160,197,101
],[
2,2,2,3,2,3,2,2,2,3,2,3,10,122,61,48,83,230,106,150
],[
2,2,2,2,2,3,2,2,2,3,2,3,161,195,195,253,78,81,146,92
],[
7,222,4,255,126,163,124,132,95,233,45,42,134,112,232,75,111,16,50,38
],[
237,161,154,226,31,25,74,208,160,244,219,241,255,217,110,184,111,122,248,16
],[
191,188,221,161,140,24,193,79,181,64,154,4,15,6,10,176,90,122,237,142
],[
116,83,46,168,205,145,222,157,27,96,135,162,79,62,189,199,199,96,247,124
],[
197,82,157,83,32,223,98,7,57,48,212,190,49,56,49,139,89,79,125,55
],[
234,28,209,65,247,185,246,35,159,18,51,215,135,142,98,154,136,242,73,240
]
]