aLevelData = [
[
4,2,191,177,251,176,8,10,145,68,133,32,233,178,20,42,231,163,201,187
],[
2,2,102,207,133,255,113,104,202,65,182,182,205,177,55,255,205,101,67,169
],[
2,2,164,157,165,162,156,75,27,0,131,211,10,229,2,15,111,166,42,150
],[
3,3,25,44,80,62,22,154,27,223,107,47,219,90,8,111,28,218,250,125
],[
2,2,124,90,227,204,185,104,167,246,14,40,105,236,192,155,182,80,244,33
],[
13,2,255,31,195,61,77,147,144,153,48,72,153,74,248,157,205,84,40,93
],[
2,5,222,113,40,159,150,14,58,234,110,151,175,157,93,244,91,142,238,84
],[
2,12,70,242,149,41,164,125,67,115,8,202,56,66,212,252,25,118,244,166
],[
66,202,204,232,93,17,110,219,51,191,17,47,195,170,191,19,145,18,77,85
],[
65,223,144,203,100,43,206,241,146,0,115,211,185,99,5,46,180,145,90,210
],[
32,136,9,74,107,201,30,191,45,93,18,26,188,22,250,105,251,23,254,132
],[
114,150,13,240,164,225,207,3,156,159,219,73,202,89,43,39,13,57,204,190
],[
17,17,218,18,219,158,172,108,162,15,76,253,225,193,42,195,170,77,17,177
],[
61,196,89,10,217,57,95,14,210,128,50,216,228,54,143,135,199,1,16,156
],[
3,25,160,163,6,8,50,22,116,174,179,126,190,135,60,219,246,49,141,70
],[
226,40,183,213,79,213,24,191,167,199,140,192,198,64,226,191,10,243,141,175
],[
169,12,156,179,72,113,237,133,201,71,157,24,100,185,194,124,249,244,93,3
],[
164,118,138,162,147,137,250,153,20,10,163,86,242,111,182,151,2,9,210,208
],[
249,133,119,204,128,185,189,150,139,158,70,154,230,152,113,8,16,254,208,121
],[
77,214,221,213,247,224,232,116,21,215,84,131,47,243,3,170,96,178,15,235
]
]