aLevelData = [
[
4,2,5,5,2,2,2,2,2,2,2,2,2,2,2,2,2,2,2,2
],[
2,2,2,2,2,2,5,2,2,2,5,2,2,2,5,3,3,3,3,2
],[
2,2,2,2,2,2,3,3,3,3,3,3,3,2,2,2,2,5,2,2
],[
3,3,3,3,3,3,3,2,2,2,2,2,3,2,2,2,2,5,2,2
],[
2,2,3,2,2,2,2,2,2,2,2,2,3,2,2,2,2,3,2,2
],[
13,2,3,2,2,2,2,2,2,3,2,2,3,2,2,2,2,3,2,2
],[
2,5,3,2,2,2,2,2,2,3,2,2,3,2,2,2,2,3,2,2
],[
2,12,3,2,2,2,2,2,2,3,2,2,3,2,2,2,2,3,2,2
],[
238,93,208,34,90,154,210,51,41,103,249,83,72,207,180,136,179,173,3,35
],[
138,110,44,161,102,24,176,208,237,139,125,51,164,8,101,166,5,239,207,69
],[
210,205,172,139,168,149,173,183,215,46,179,116,113,46,136,184,161,230,204,237
],[
62,158,50,79,160,33,236,149,179,125,99,211,73,4,44,159,181,150,55,115
],[
149,35,74,82,239,107,174,174,128,8,41,138,80,175,44,220,138,179,76,53
],[
139,202,246,163,57,20,95,215,150,89,187,131,149,147,175,6,44,172,8,75
],[
170,136,173,238,75,70,210,161,9,195,111,207,182,96,241,127,72,6,47,122
],[
116,103,159,176,126,134,202,216,79,121,253,87,200,109,66,99,86,236,142,104
],[
198,91,60,170,91,199,186,45,30,225,131,210,118,70,77,194,248,4,131,15
],[
128,90,245,153,129,192,207,47,153,39,199,247,105,130,155,16,163,133,187,117
],[
100,173,66,37,197,128,43,129,173,22,194,245,233,216,88,218,126,136,59,155
],[
61,130,230,23,153,65,116,71,182,36,91,33,194,114,86,188,136,157,163,180
]
]