aLevelData = [
[
2,2,2,2,2,11,2,2,244,37,179,85,125,9,204,253,236,201,171,73
],[
2,2,2,2,2,2,2,2,144,133,189,127,231,214,8,32,190,98,108,26
],[
5,2,5,2,5,5,5,2,154,174,41,63,87,52,162,246,15,182,97,49
],[
5,2,5,2,5,2,5,2,61,209,90,159,34,213,116,34,104,212,69,131
],[
5,5,5,2,5,5,5,2,6,249,29,101,99,27,71,119,190,146,139,238
],[
5,2,5,2,5,2,5,2,205,74,247,51,164,22,224,216,217,70,35,209
],[
5,2,5,2,5,2,5,2,230,123,176,225,206,186,74,82,4,192,136,233
],[
2,2,2,12,2,2,2,2,136,149,32,25,83,100,100,119,245,138,13,110
],[
2,2,7,2,2,2,2,2,125,237,56,52,153,143,174,252,254,99,104,110
],[
2,2,7,2,5,5,5,2,10,95,83,84,168,210,80,150,117,248,127,104
],[
2,2,7,2,5,2,2,2,33,203,189,194,23,29,107,16,96,228,114,44
],[
2,2,7,2,5,5,5,2,196,213,131,137,51,52,164,177,100,234,232,241
],[
2,2,7,2,5,2,2,2,188,216,125,82,113,107,236,204,239,112,157,183
],[
2,2,7,2,5,5,5,2,123,42,154,130,22,162,148,167,164,63,43,222
],[
2,2,2,2,2,2,2,2,77,150,106,146,36,131,145,145,6,121,24,7
],[
13,2,2,2,3,3,3,3,197,22,240,173,134,251,12,62,104,218,32,43
],[
2,2,2,2,2,2,2,2,103,208,169,143,127,246,45,101,20,51,196,249
],[
2,2,2,2,2,2,2,2,145,84,215,156,80,94,40,156,186,34,18,115
],[
175,19,19,63,40,85,135,114,26,22,182,203,158,33,17,133,80,176,185,206
],[
244,130,65,122,96,46,181,249,150,183,219,134,48,96,184,162,1,194,86,193
]
]