aLevelData = [
[
2,249,39,12,124,126,118,198,154,126,164,241,65,92,218,30,134,96,144,250
],[
2,59,172,174,219,41,113,241,152,154,98,145,158,27,105,33,64,127,153,182
],[
2,79,39,101,75,235,129,15,100,152,207,99,242,149,42,164,119,105,198,199
],[
2,106,190,119,223,221,114,116,217,93,236,92,105,26,172,118,68,72,38,61
],[
2,144,196,209,28,152,251,123,118,197,8,223,233,202,28,121,212,30,35,153
],[
2,22,175,164,183,25,213,233,6,16,132,97,75,124,199,66,240,245,105,114
],[
2,84,39,245,168,102,27,226,207,114,184,7,171,59,137,85,190,73,192,196
],[
2,109,132,123,142,95,2,71,156,38,30,226,61,33,202,70,30,160,38,226
],[
119,74,81,43,130,188,126,83,49,115,75,88,32,236,79,65,201,9,242,165
],[
247,183,130,108,125,206,131,217,39,57,70,201,241,86,189,53,119,159,141,254
],[
173,139,101,234,208,175,142,233,156,41,196,158,192,62,69,26,143,66,39,235
],[
248,184,238,85,184,187,94,223,206,157,142,18,47,205,62,125,188,254,106,252
],[
113,133,32,58,223,3,142,117,220,69,95,129,121,104,72,16,52,65,221,48
],[
111,252,170,21,33,2,127,25,204,33,11,1,175,231,172,130,60,78,134,4
],[
204,159,211,165,146,144,121,129,205,175,226,49,66,4,8,145,234,242,207,198
],[
232,95,152,128,189,21,19,125,191,103,84,79,200,23,42,94,43,119,172,48
],[
236,207,20,232,48,255,209,13,242,101,215,141,248,1,58,2,5,215,251,51
],[
81,149,34,222,54,118,12,181,44,102,7,166,247,103,28,95,31,51,44,18
],[
161,35,63,117,228,79,24,14,238,247,13,173,216,34,21,58,127,132,35,176
],[
125,165,178,106,88,64,161,158,248,233,66,39,95,243,174,135,148,145,91,44
]
]