aLevelData = [
[
2,2,24,159,187,129,77,63,86,122,71,232,218,180,130,176,79,40,236,99
],[
2,2,168,16,164,48,162,62,2,161,239,177,215,209,148,106,246,217,144,124
],[
5,2,243,139,190,99,42,99,252,150,3,186,141,96,117,61,188,235,201,158
],[
5,2,194,158,161,137,234,168,56,218,243,221,235,13,182,194,249,245,9,227
],[
5,5,135,177,226,109,231,221,192,248,25,5,70,165,146,95,41,105,61,185
],[
5,2,77,168,192,176,43,6,0,35,118,122,231,231,254,164,101,188,212,96
],[
5,2,180,128,175,155,225,163,142,101,136,219,159,72,223,25,96,216,245,187
],[
2,2,4,140,60,3,24,204,70,200,102,75,204,107,26,151,244,13,35,239
],[
211,255,220,84,49,122,236,226,141,145,107,97,97,99,70,24,168,149,228,225
],[
156,0,9,131,196,166,251,59,46,235,228,156,250,2,120,154,24,165,215,225
],[
81,9,181,107,140,17,184,81,74,194,33,225,116,247,175,242,86,85,192,116
],[
235,130,186,75,91,146,169,94,194,194,42,234,51,105,135,29,253,43,35,224
],[
44,112,25,244,83,20,32,64,137,97,178,105,178,58,109,164,0,152,185,200
],[
185,59,171,168,58,153,41,159,60,27,79,108,86,136,18,64,195,193,35,22
],[
102,176,22,67,11,123,196,78,240,253,238,1,132,118,35,192,110,129,227,26
],[
209,71,4,158,206,243,85,240,75,102,130,28,243,43,55,41,126,173,136,242
],[
51,167,145,49,171,221,89,221,215,10,253,182,69,25,10,30,158,151,42,42
],[
116,105,3,249,58,186,92,68,148,56,129,55,210,128,233,127,182,214,23,165
],[
126,26,190,154,30,247,40,147,206,94,216,22,196,51,111,85,67,70,204,188
],[
212,132,119,198,212,111,64,20,46,203,35,192,106,154,111,239,231,75,40,165
]
]