aLevelData = [
[
4,2,2,2,2,2,2,2,36,216,147,140,16,106,30,111,33,74,133,96
],[
5,2,5,3,2,2,2,2,26,62,73,111,24,0,13,68,117,146,155,17
],[
2,5,5,3,3,3,3,3,237,210,40,197,255,78,217,131,150,89,134,82
],[
3,3,5,5,5,5,5,5,233,95,189,22,160,117,10,191,56,52,117,192
],[
2,3,5,5,5,5,5,5,168,200,77,194,69,68,36,154,227,56,27,121
],[
3,3,5,5,5,5,3,3,61,134,96,99,151,113,244,227,161,247,178,252
],[
3,5,5,5,5,5,3,2,159,97,141,98,199,24,25,235,234,186,77,64
],[
3,5,5,3,3,3,3,8,87,109,135,216,253,116,208,39,207,0,97,18
],[
3,5,5,3,2,2,3,3,109,72,103,167,0,219,4,11,101,53,150,179
],[
3,5,5,3,2,2,2,2,143,145,59,215,38,255,149,36,116,182,202,178
],[
3,5,5,3,2,2,3,2,130,171,207,53,126,99,231,119,96,5,102,6
],[
5,5,5,3,2,2,3,2,206,179,187,41,60,26,173,25,87,72,229,110
],[
5,5,5,3,2,2,3,2,164,190,173,216,100,199,247,15,188,8,161,13
],[
5,3,3,3,2,2,3,2,18,87,247,122,186,209,122,104,210,38,224,64
],[
5,3,2,2,2,2,3,2,106,56,91,252,233,229,30,151,171,32,30,194
],[
5,3,3,2,2,2,3,2,239,71,21,217,241,176,205,21,83,134,155,3
],[
5,5,3,3,2,2,3,2,193,211,41,53,213,221,121,55,56,182,39,196
],[
5,5,5,5,3,3,3,2,11,15,239,58,133,77,110,76,221,223,45,247
],[
5,5,5,5,5,5,3,2,106,206,219,183,9,149,218,250,191,52,254,213
],[
159,128,145,246,238,189,154,218,134,110,94,64,120,108,40,221,245,54,70,81
]
]