aLevelData = [
[
2,2,3,3,3,3,3,3,3,83,73,184,108,123,61,221,57,157,120,129
],[
2,2,2,2,2,2,2,2,2,138,49,104,237,215,221,233,25,130,140,12
],[
3,2,3,3,3,3,3,3,3,102,187,192,22,143,161,41,204,221,169,118
],[
2,2,2,2,2,2,2,2,2,238,155,68,107,2,202,188,52,82,22,95
],[
3,2,3,3,3,3,3,3,3,249,56,8,224,178,153,124,250,61,176,86
],[
2,2,3,2,2,2,2,2,2,86,173,13,113,175,230,221,216,52,103,107
],[
3,2,3,2,2,3,3,3,3,57,46,102,231,150,226,34,103,62,185,117
],[
2,2,3,2,2,3,2,2,2,43,252,158,168,37,142,168,140,184,88,249
],[
2,3,3,2,2,3,3,3,3,198,193,90,230,107,212,96,88,205,200,120
],[
2,2,2,2,2,2,2,2,2,113,148,117,169,115,16,188,226,222,205,200
],[
3,3,3,3,2,2,2,2,2,49,217,104,148,53,211,162,173,214,106,179
],[
8,2,6,3,2,3,3,3,3,58,51,140,225,57,220,220,80,11,66,87
],[
28,51,108,55,165,91,235,23,42,151,15,89,154,238,91,197,166,23,55,114
],[
27,128,229,234,111,149,182,137,153,62,126,38,38,169,69,246,138,75,63,172
],[
180,33,255,229,229,60,231,196,193,124,227,217,167,156,87,72,62,110,85,39
],[
80,104,20,39,220,96,157,119,102,148,200,229,146,237,103,71,241,133,193,25
],[
27,102,66,103,254,149,112,238,117,79,33,126,29,146,235,162,100,223,221,131
],[
226,63,108,10,237,132,176,69,103,209,209,12,219,92,188,228,200,115,26,35
],[
61,189,130,85,166,195,237,223,230,174,107,226,166,82,21,98,236,108,67,168
],[
239,40,255,228,42,231,185,23,175,62,60,48,190,66,224,117,150,3,1,37
]
]