aLevelData = [
[
2,2,2,2,2,2,2,2,114,49,174,246,17,90,104,113,236,37,46,230
],[
2,2,2,2,2,2,2,2,117,17,23,99,148,51,116,70,63,123,4,162
],[
2,2,2,2,2,2,2,2,75,56,103,228,129,222,213,182,245,7,16,35
],[
2,2,2,13,2,2,2,2,147,185,151,252,251,231,29,123,143,58,57,39
],[
2,2,2,2,2,2,2,2,201,17,95,247,211,198,15,186,81,51,76,182
],[
2,2,2,2,2,2,2,2,129,116,80,144,135,239,126,108,2,146,152,84
],[
2,2,2,2,2,2,2,2,227,92,50,222,127,31,103,9,227,132,202,105
],[
2,2,2,2,2,2,2,2,103,79,159,132,134,228,76,123,236,10,10,237
],[
2,2,11,2,2,2,2,2,209,240,224,24,134,110,210,65,77,140,86,86
],[
2,2,2,2,2,2,2,2,110,72,7,211,135,148,157,226,36,159,29,198
],[
2,2,2,2,2,2,2,2,143,85,77,121,234,41,107,148,122,18,30,112
],[
2,2,2,2,2,2,2,2,70,211,173,139,225,128,111,45,132,62,131,75
],[
2,2,2,2,2,2,2,2,95,74,192,171,49,61,239,73,23,142,56,250
],[
2,2,2,2,2,2,2,2,161,88,219,79,43,93,33,188,107,76,145,249
],[
2,9,2,2,2,2,2,2,70,63,102,169,232,136,65,58,19,173,28,12
],[
183,177,127,213,196,149,246,68,60,31,194,228,140,218,207,68,28,94,230,85
],[
37,209,36,19,195,174,171,103,75,197,151,76,222,132,52,50,62,116,110,159
],[
225,6,136,28,68,144,17,79,130,147,20,101,37,63,144,179,60,57,39,156
],[
174,155,26,181,205,61,117,39,46,51,135,85,185,150,149,191,252,136,208,38
],[
196,114,131,242,239,144,145,208,124,176,31,159,228,54,142,141,173,100,172,125
]
]