aLevelData = [
[
4,216,115,81,151,85,214,213,64,250,75,138,41,108,180,87,233,242,7,234
],[
2,199,206,82,173,216,206,252,246,104,30,77,127,155,96,48,21,84,254,56
],[
2,148,86,191,226,18,170,153,26,91,64,199,0,158,217,27,235,101,35,148
],[
2,174,202,38,51,27,232,224,11,198,145,44,152,12,63,233,81,83,76,87
],[
2,128,146,101,196,82,21,60,105,42,122,125,143,59,0,4,246,86,1,77
],[
2,118,0,188,43,231,200,88,189,63,216,38,158,250,201,39,93,191,188,206
],[
2,45,64,166,6,221,98,235,119,10,158,47,5,147,166,104,154,77,76,56
],[
2,38,248,160,123,228,114,89,28,222,43,119,44,179,217,38,53,152,109,228
],[
2,203,157,69,230,101,50,163,184,107,233,94,37,144,125,215,86,98,20,47
],[
2,62,31,193,183,53,203,77,168,226,127,55,21,95,4,249,29,152,161,141
],[
2,101,244,48,48,198,56,119,102,66,168,182,62,61,111,125,215,233,64,192
],[
2,35,3,62,45,235,189,25,189,19,251,122,138,32,193,162,224,247,236,78
],[
2,150,231,33,221,159,234,4,180,220,40,170,226,52,189,80,0,231,188,77
],[
2,91,31,116,69,86,201,242,160,9,162,199,58,46,149,11,92,62,68,161
],[
2,236,215,229,189,224,97,79,164,248,241,84,179,173,109,82,163,101,242,5
],[
2,11,232,114,159,38,23,162,27,215,220,19,206,234,93,158,63,157,117,6
],[
2,56,95,100,217,29,215,197,151,125,40,193,22,231,116,131,37,255,159,235
],[
2,112,208,85,135,164,100,78,191,211,146,208,79,25,24,118,251,128,234,49
],[
2,125,33,201,140,195,140,22,52,87,106,233,183,31,97,94,140,70,56,47
],[
2,84,122,60,136,95,88,226,22,114,36,173,98,199,190,82,93,86,209,27
]
]