aLevelData = [
[
6,2,8,2,9,2,10,2,11,163,121,168,121,155,100,171,97,77,85,11
],[
2,2,2,2,2,2,2,2,12,238,227,24,110,248,103,226,78,230,54,236
],[
2,2,3,3,3,3,3,3,3,7,113,178,97,46,171,56,122,37,63,82
],[
2,2,3,2,2,2,2,2,2,231,236,250,45,114,58,138,77,223,205,134
],[
2,2,3,2,2,2,2,2,2,127,22,254,175,15,132,152,118,60,190,234
],[
2,2,3,2,3,3,3,3,3,190,233,103,27,226,149,85,190,250,141,239
],[
2,2,3,2,2,2,2,5,5,166,90,96,217,252,92,148,212,142,96,151
],[
2,2,3,5,5,5,2,3,3,223,106,16,248,162,172,233,215,13,148,247
],[
2,2,2,2,2,2,2,2,2,155,61,220,223,227,159,72,35,190,87,126
],[
2,3,2,2,3,1,3,2,2,162,30,227,24,94,138,251,248,130,20,188
],[
2,3,2,2,3,2,3,2,2,219,164,139,6,49,71,241,35,45,164,47
],[
169,24,170,8,161,234,67,76,232,27,217,78,214,183,25,151,30,177,246,220
],[
245,121,241,46,119,208,152,113,70,220,77,15,116,119,73,238,163,205,225,159
],[
106,38,7,216,251,0,19,36,3,97,196,217,210,107,129,74,188,49,229,63
],[
191,201,123,162,102,163,198,123,236,24,133,31,165,70,52,163,154,28,214,151
],[
115,177,242,241,155,218,220,72,158,251,53,67,214,29,181,80,70,65,40,153
],[
198,244,183,52,97,36,105,153,251,50,234,90,54,72,138,14,151,237,136,142
],[
229,215,145,101,210,0,132,129,222,252,120,47,119,137,0,70,101,104,174,161
],[
101,107,213,211,20,208,147,23,15,205,15,134,89,108,0,141,253,153,111,157
],[
244,121,189,36,72,254,231,189,122,185,9,163,34,239,33,108,213,238,22,244
]
]