aLevelData = [
[
5,5,5,5,5,2,2,2,2,135,190,99,139,253,87,228,93,197,131,20
],[
5,2,2,2,2,2,2,2,2,244,204,75,99,79,35,78,135,156,82,193
],[
5,2,5,3,3,3,3,3,3,113,89,238,180,127,185,110,151,243,73,58
],[
252,164,211,5,159,243,130,93,163,1,72,128,30,31,125,114,216,134,201,76
],[
80,73,67,215,0,135,218,89,226,229,245,175,51,59,86,156,119,142,68,97
],[
189,63,233,142,36,129,249,23,158,16,148,170,244,33,110,64,11,148,45,243
],[
101,113,18,15,234,146,220,107,233,157,233,250,90,54,159,157,102,114,10,59
],[
41,142,198,20,182,225,32,82,91,15,120,225,39,128,234,129,170,16,45,26
],[
252,8,186,79,1,78,49,85,234,216,249,6,255,102,39,49,156,113,162,53
],[
122,94,132,206,48,248,195,46,250,29,16,80,184,183,255,137,58,239,105,96
],[
186,157,15,159,170,2,127,170,177,185,60,16,240,235,25,96,137,195,230,62
],[
98,33,78,181,38,147,0,207,141,129,13,99,222,167,145,47,178,200,150,38
],[
250,161,53,11,67,29,254,63,57,199,155,216,106,132,175,242,77,130,4,74
],[
131,108,230,9,92,224,202,221,157,34,52,78,129,18,215,80,253,91,253,20
],[
72,238,41,36,155,175,251,175,54,109,85,33,163,24,188,247,62,46,1,210
],[
245,119,32,202,77,242,104,4,165,15,220,135,191,30,218,75,124,8,250,147
],[
231,61,57,125,117,237,87,216,140,123,125,53,65,47,35,65,102,43,49,82
],[
196,160,100,63,165,65,244,117,150,248,116,71,106,216,249,134,130,84,126,82
],[
76,174,135,47,10,178,5,92,213,163,122,96,225,118,93,229,2,62,192,201
],[
111,232,48,115,199,40,221,99,81,179,251,13,136,175,103,232,215,103,142,194
]
]