aLevelData = [
[
4,7,211,217,180,204,54,212,151,231,224,43,214,166,113,77,45,165,167,82
],[
105,78,210,154,122,161,136,177,202,49,153,118,205,111,69,125,218,43,173,177
],[
57,88,136,62,125,16,23,174,19,216,91,81,28,36,133,227,120,30,174,105
],[
35,163,200,92,197,142,213,9,132,58,87,56,29,66,7,12,51,139,201,42
],[
231,133,224,29,168,173,94,250,76,87,223,63,96,170,119,1,189,236,233,71
],[
92,0,26,177,108,44,197,93,161,32,111,10,206,52,158,126,182,242,70,38
],[
32,212,132,253,41,78,142,174,222,15,235,253,10,133,223,99,77,159,42,248
],[
110,214,242,151,242,110,253,60,238,249,35,176,25,30,3,105,37,152,246,171
],[
80,129,65,244,54,209,143,151,233,34,158,167,67,182,56,22,123,186,101,30
],[
247,204,223,224,97,188,198,76,253,143,149,64,58,202,85,244,135,237,16,149
],[
103,61,137,48,200,198,42,210,145,161,62,238,122,115,96,254,32,54,51,109
],[
89,60,84,181,196,112,141,197,165,224,76,165,240,120,83,92,164,16,176,18
],[
90,170,240,114,30,244,144,82,125,21,180,150,223,165,27,81,24,253,83,46
],[
57,178,41,15,172,92,100,243,128,156,179,29,1,93,227,115,140,89,85,36
],[
161,223,176,141,58,212,211,94,91,249,14,248,235,107,145,26,194,112,36,189
],[
3,112,25,60,172,66,127,184,107,170,153,187,180,31,143,27,16,209,98,34
],[
184,234,37,235,98,20,107,15,91,60,252,130,214,150,204,183,132,226,45,11
],[
100,237,67,96,221,90,184,8,10,162,178,230,85,90,2,207,71,181,159,54
],[
158,73,82,9,160,22,178,214,176,196,83,50,31,44,59,91,68,26,149,28
],[
207,81,170,241,90,208,12,108,65,84,20,215,180,30,143,27,10,246,181,225
]
]