aLevelData = [
[
5,5,3,5,5,5,5,5,5,5,3,5,5,191,145,13,112,175,236,189
],[
4,2,3,5,5,5,5,5,5,5,3,5,5,96,35,7,68,126,238,122
],[
2,2,3,2,3,3,3,3,3,2,3,3,3,173,62,0,134,5,2,138
],[
5,2,2,2,3,2,2,2,2,2,5,5,5,166,170,71,99,102,198,28
],[
2,2,2,3,2,2,2,2,2,2,5,5,5,171,120,22,217,174,5,240
],[
2,2,2,3,2,2,5,3,3,2,3,3,3,13,10,65,132,184,21,66
],[
2,2,2,2,2,2,5,5,3,2,2,2,2,98,187,121,18,60,140,33
],[
3,237,46,89,66,187,97,48,175,217,22,33,236,48,37,243,180,96,66,222
],[
111,1,46,239,3,46,42,174,236,68,177,253,143,231,102,67,203,70,76,202
],[
210,160,53,102,55,8,125,88,72,101,247,113,157,188,40,123,241,178,179,212
],[
49,76,21,92,211,250,146,145,105,212,111,249,118,35,98,193,128,35,71,163
],[
102,7,20,13,244,62,15,127,181,245,63,52,8,221,32,6,118,46,155,140
],[
67,236,52,133,67,105,134,121,239,11,236,157,184,79,130,248,156,14,76,196
],[
246,255,180,23,154,126,58,194,33,139,103,121,130,22,2,53,227,122,135,215
],[
174,71,213,14,230,68,39,122,188,180,69,18,93,217,252,195,15,183,203,89
],[
124,26,223,163,77,218,66,210,251,94,79,35,226,95,105,190,152,238,236,221
],[
124,185,100,48,146,138,253,129,142,16,59,148,46,226,235,81,205,193,90,36
],[
54,29,196,165,182,219,15,116,117,86,185,103,5,164,16,232,60,26,161,152
],[
63,18,242,57,224,235,116,202,42,82,179,243,57,192,208,164,80,68,49,250
],[
37,131,119,98,127,253,176,0,3,146,206,82,75,68,89,16,57,62,96,87
]
]