aLevelData = [
[
12,2,2,2,2,2,2,2,2,37,122,15,7,166,35,209,204,121,134,78
],[
2,2,2,2,2,2,2,2,2,150,144,33,38,92,153,50,166,2,121,100
],[
2,2,3,3,3,3,3,3,3,225,31,246,173,2,3,179,119,224,249,98
],[
11,2,3,2,2,2,2,2,2,254,211,201,53,249,199,129,149,124,142,117
],[
2,2,3,2,2,2,2,2,2,23,29,123,133,172,86,44,158,24,42,167
],[
2,2,3,2,2,2,2,2,2,132,165,11,169,206,24,252,58,50,228,243
],[
10,2,3,2,2,2,2,2,2,133,2,158,129,231,247,177,180,70,46,83
],[
2,2,3,2,2,2,2,2,3,61,164,112,183,206,243,182,132,198,43,236
],[
2,2,3,2,2,2,2,3,2,135,16,155,246,164,72,124,241,19,32,204
],[
187,201,3,90,181,51,248,29,199,42,200,201,165,36,99,164,81,167,128,150
],[
226,4,132,128,131,65,165,207,190,87,79,81,251,158,198,71,67,133,14,187
],[
74,134,8,20,173,89,221,231,120,104,159,16,235,132,46,2,126,214,89,91
],[
34,24,70,188,202,5,20,215,42,13,190,201,190,78,67,171,15,192,4,99
],[
50,175,109,192,145,111,215,199,238,75,173,71,164,190,206,180,48,230,51,49
],[
241,53,210,239,44,106,194,182,83,191,159,193,135,100,48,207,91,45,71,119
],[
219,136,233,188,205,177,175,225,54,41,108,127,32,100,16,212,155,193,205,94
],[
2,192,120,168,127,112,49,101,209,38,70,187,77,116,85,225,35,89,177,236
],[
227,182,7,230,64,1,66,33,19,61,171,202,163,42,85,193,35,185,184,168
],[
124,194,156,59,77,249,57,223,48,31,156,125,64,117,76,144,216,118,46,125
],[
157,197,166,36,190,101,255,180,122,40,13,195,227,106,16,158,226,254,220,221
]
]