aLevelData = [
[
2,2,2,2,2,2,229,174,230,184,67,82,6,116,247,181,153,198,37,2
],[
2,2,2,2,2,2,113,67,218,159,168,179,146,167,63,30,253,155,5,42
],[
2,2,3,2,3,2,2,84,186,164,5,60,117,92,101,190,67,54,73,251
],[
2,2,3,2,3,2,17,126,157,191,204,124,87,179,198,72,255,212,92,224
],[
2,2,3,2,3,2,110,35,214,120,214,158,142,17,2,112,85,77,223,101
],[
2,2,3,2,2,2,18,130,60,160,172,13,206,144,42,233,119,32,25,128
],[
2,2,3,2,3,3,199,46,46,192,196,63,45,114,230,113,9,199,102,177
],[
2,2,3,2,2,2,77,52,185,45,186,128,87,12,50,28,192,93,213,178
],[
2,2,3,2,3,3,193,78,105,0,243,159,255,231,134,86,211,191,60,179
],[
2,2,3,2,2,2,117,238,184,102,38,185,249,0,133,90,34,168,107,82
],[
2,2,3,3,3,3,124,15,19,0,189,166,126,115,139,14,21,125,60,207
],[
1,2,3,2,2,2,145,8,224,78,24,173,129,249,168,131,169,197,185,53
],[
37,218,30,88,9,140,45,251,244,142,31,127,149,98,186,169,110,20,45,245
],[
216,40,59,45,72,209,155,59,208,100,159,60,233,11,21,213,111,190,107,202
],[
237,111,22,204,27,133,51,147,165,140,111,45,46,43,37,150,149,86,199,136
],[
119,196,127,148,245,164,22,114,183,140,20,150,48,178,41,3,36,94,203,100
],[
104,159,33,89,234,62,32,15,241,240,244,19,165,207,161,104,209,11,234,215
],[
232,221,114,134,70,189,33,204,185,213,201,68,64,181,9,32,18,72,114,192
],[
226,7,233,132,98,108,76,222,6,170,89,171,10,155,203,195,182,250,197,206
],[
225,210,116,90,180,54,241,43,176,51,100,210,242,3,111,130,182,131,202,30
]
]