aLevelData = [
[
6,2,8,2,9,2,10,2,11,3,2,2,5,2,2,2,5,2,2,4
],[
2,2,2,2,2,2,2,2,12,3,5,2,2,2,5,2,2,2,5,2
],[
154,166,165,176,40,229,117,222,7,79,95,229,222,66,93,171,142,107,115,240
],[
102,47,136,212,151,73,116,154,231,181,90,171,169,205,56,222,236,179,188,246
],[
243,238,90,109,229,88,155,112,198,55,184,42,166,170,103,69,24,71,245,174
],[
230,2,149,153,3,80,248,198,193,141,29,2,68,155,107,240,55,205,253,9
],[
189,3,61,226,171,22,180,173,244,118,32,3,101,17,199,225,146,119,12,240
],[
16,60,64,9,228,158,186,248,60,104,42,128,93,23,42,160,221,58,22,21
],[
18,31,30,32,202,171,153,137,60,138,156,228,63,137,204,19,186,63,112,12
],[
92,243,203,221,141,186,168,237,164,224,54,132,90,137,22,141,126,152,179,155
],[
235,208,210,43,184,57,106,41,174,198,181,181,255,52,135,38,52,53,223,79
],[
104,206,187,2,180,254,49,211,234,160,188,30,134,146,212,76,225,23,193,81
],[
168,122,176,121,141,245,7,101,60,208,246,80,145,205,78,152,8,196,151,121
],[
117,139,93,27,245,24,202,207,36,234,122,149,144,165,138,227,110,252,242,161
],[
140,211,21,120,135,165,151,76,62,36,111,7,134,32,61,153,32,170,221,61
],[
232,121,60,253,78,141,106,120,10,17,241,227,12,134,102,78,178,30,61,40
],[
62,102,225,6,135,40,5,160,239,144,52,28,148,141,176,144,203,122,121,194
],[
202,254,172,50,164,49,14,90,123,0,233,52,240,210,23,253,223,108,92,57
],[
74,17,249,247,146,238,125,86,237,182,223,72,20,138,202,150,60,27,56,36
],[
72,18,66,119,61,176,54,116,246,177,235,106,25,119,81,83,73,100,76,87
]
]