aLevelData = [
[
4,2,2,2,2,2,2,2,2,2,8,2,2,2,2,3,2,2,2,2
],[
2,2,3,2,9,2,2,2,2,2,2,2,2,3,2,2,3,2,2,2
],[
2,3,2,2,2,2,3,2,2,3,2,3,2,2,3,2,2,3,3,3
],[
2,3,2,2,2,3,2,2,3,2,2,2,3,2,2,3,2,2,2,2
],[
2,3,2,2,3,2,2,3,2,2,2,2,2,3,2,2,3,2,2,2
],[
2,3,2,3,2,2,3,2,2,3,2,3,2,2,3,2,2,3,5,2
],[
2,2,3,2,2,3,2,2,3,2,2,2,3,2,2,3,2,2,3,2
],[
2,2,2,2,3,2,2,3,2,2,2,2,2,3,2,2,3,5,6,2
],[
2,2,2,3,2,2,3,2,2,3,2,3,2,2,3,5,2,3,2,2
],[
2,2,3,2,2,3,2,2,3,2,2,2,3,2,2,3,2,2,3,2
],[
2,2,5,2,3,2,2,3,2,2,2,2,2,3,5,2,3,2,2,2
],[
2,2,2,3,2,2,3,2,2,3,2,3,2,2,3,2,2,3,2,2
],[
2,2,3,2,5,3,2,2,3,2,2,2,3,5,2,3,2,2,3,2
],[
2,3,2,2,3,5,2,3,2,2,2,2,2,3,2,2,3,2,2,2
],[
2,2,2,3,2,2,3,2,2,3,2,3,2,2,3,2,2,3,2,2
],[
2,2,3,2,2,3,2,5,3,2,2,2,3,5,2,3,2,2,3,2
],[
33,169,54,15,54,30,2,112,5,26,10,158,232,103,135,62,6,90,6,249
],[
108,158,25,106,96,50,76,58,241,181,90,137,211,226,161,144,106,87,212,133
],[
37,154,240,191,13,93,113,27,158,1,197,158,213,90,1,92,138,178,211,152
],[
0,16,183,44,187,186,110,44,145,248,173,198,4,27,18,108,207,190,91,54
]
]