aLevelData = [
[
10,2,2,8,2,2,2,2,2,2,2,21,191,128,113,174,187,120,253,237
],[
2,2,2,2,2,2,2,2,2,2,2,147,110,233,1,16,14,0,26,237
],[
2,2,2,2,2,2,3,3,3,3,2,61,98,102,244,173,204,63,99,174
],[
9,2,2,2,2,2,2,2,2,3,2,25,163,148,71,9,228,221,133,66
],[
3,3,3,3,3,3,3,2,2,3,2,160,182,19,148,244,25,11,129,237
],[
2,2,2,2,2,2,2,2,2,3,2,47,12,253,63,40,141,114,58,106
],[
2,2,2,2,2,2,2,2,2,3,3,112,7,249,239,218,34,221,232,67
],[
2,2,2,2,2,2,2,2,2,2,3,43,58,167,201,148,79,187,202,22
],[
2,2,2,2,2,2,2,2,2,2,3,124,93,177,61,175,11,16,38,32
],[
2,2,2,2,3,3,3,3,2,2,3,114,240,136,62,145,101,241,232,28
],[
2,2,2,2,3,2,2,3,2,2,3,101,82,225,30,217,190,126,227,245
],[
2,2,2,2,3,2,2,3,2,2,3,111,162,21,197,10,236,37,9,35
],[
2,2,2,2,3,2,2,3,2,2,2,47,236,67,4,35,147,14,170,90
],[
2,2,2,2,3,2,2,3,2,2,2,176,177,17,117,177,244,178,151,126
],[
2,2,2,2,3,2,2,3,2,2,2,51,73,26,90,176,219,129,10,45
],[
2,2,2,2,3,2,2,3,2,2,2,248,174,58,187,62,86,28,205,30
],[
177,82,144,227,118,14,127,239,6,120,50,72,231,80,118,84,117,212,163,225
],[
212,228,42,104,41,100,110,147,10,226,213,252,51,120,30,56,122,244,245,20
],[
5,55,196,30,186,219,205,104,247,25,118,136,131,233,227,227,197,106,202,44
],[
52,133,131,39,15,205,95,179,78,170,59,7,216,183,85,60,246,104,94,12
]
]