aLevelData = [
[
4,241,50,245,9,228,122,241,210,143,166,42,54,120,240,122,246,106,202,34
],[
2,160,199,219,187,183,30,68,111,14,0,39,104,117,16,106,137,151,90,184
],[
2,92,35,230,201,76,42,140,228,21,201,9,162,120,7,83,244,51,0,42
],[
2,103,48,68,240,167,253,122,186,66,124,73,167,175,220,120,113,143,199,83
],[
2,65,50,221,81,200,93,98,245,139,75,51,242,126,241,255,146,213,135,179
],[
2,88,23,67,54,229,116,104,87,24,88,127,4,121,64,228,188,216,205,133
],[
2,70,49,22,231,164,211,67,106,67,193,88,205,116,89,78,244,32,51,104
],[
2,233,182,76,196,34,105,100,49,2,153,164,64,161,142,132,158,208,108,236
],[
2,160,88,99,153,32,131,39,195,136,222,160,253,44,60,226,92,221,254,95
],[
2,219,186,146,91,254,74,58,161,182,200,15,117,133,190,69,201,226,214,176
],[
2,180,223,236,135,31,9,103,105,194,144,202,157,79,168,134,158,236,46,19
],[
2,215,231,143,62,171,165,230,197,184,220,100,33,93,2,245,163,121,6,32
],[
2,194,118,61,47,180,135,159,145,59,45,51,124,194,0,200,215,168,172,230
],[
86,220,58,4,231,170,145,251,77,212,60,187,10,229,109,61,131,194,66,185
],[
95,130,72,24,48,127,62,172,85,173,27,31,31,43,82,169,50,24,84,134
],[
46,168,86,168,143,119,85,169,210,29,88,3,218,2,246,131,145,116,23,251
],[
210,246,255,56,135,219,136,51,14,20,174,139,226,71,81,51,119,33,55,104
],[
101,236,81,231,201,100,63,92,232,198,21,29,22,43,96,24,215,20,100,11
],[
67,70,168,243,175,216,181,198,137,138,26,100,132,88,179,203,245,79,43,139
],[
125,160,192,123,233,243,70,169,86,253,111,151,153,85,73,164,222,131,8,200
]
]