aLevelData = [
[
2,2,2,2,2,2,2,2,2,2,2,2,2,2,2,2,2,2,2,4
],[
2,2,2,2,2,2,2,2,2,2,2,2,2,2,2,2,2,2,2,2
],[
2,2,2,2,2,2,2,2,2,2,2,2,2,2,2,2,2,2,2,2
],[
2,2,2,3,3,3,3,3,3,3,3,3,3,3,3,3,3,3,2,2
],[
2,2,2,2,2,2,2,2,2,2,2,2,2,2,2,2,2,2,2,2
],[
2,2,2,2,2,2,2,2,2,2,2,2,2,2,2,2,2,2,2,2
],[
2,2,2,2,2,3,2,2,3,2,2,3,2,2,2,3,2,2,3,2
],[
12,139,189,202,165,64,94,227,167,150,136,40,213,85,171,211,210,166,39,92
],[
134,221,198,236,195,150,138,22,40,3,170,194,70,132,215,105,2,120,195,136
],[
58,84,228,78,172,242,118,152,19,43,191,32,146,167,150,241,86,244,38,31
],[
120,214,240,180,32,222,15,237,240,62,192,167,160,220,33,20,229,165,57,178
],[
152,36,57,126,20,83,1,101,224,177,230,251,142,148,179,111,226,193,237,191
],[
55,58,92,40,31,87,198,225,74,24,254,8,169,186,30,221,210,136,16,46
],[
167,244,83,18,50,230,251,218,212,84,250,69,159,19,159,243,0,237,92,28
],[
161,243,204,130,141,20,244,164,150,239,202,53,244,230,243,204,46,116,209,221
],[
62,192,189,232,240,114,145,240,139,197,106,47,179,221,172,8,142,92,70,61
],[
38,48,55,98,14,174,81,146,73,229,60,96,103,44,191,16,241,254,59,8
],[
7,8,120,129,72,127,164,130,242,183,153,15,74,242,95,158,63,118,242,202
],[
74,226,69,75,152,193,134,38,107,96,164,33,190,221,15,122,40,129,191,216
],[
2,79,119,130,204,221,75,207,205,99,96,222,250,18,243,134,25,167,156,144
]
]