aLevelData = [
[
4,2,5,5,2,2,2,2,2,2,2,2,2,2,2,2,2,2,2,2
],[
2,2,2,2,2,2,5,2,2,2,5,2,2,2,5,3,3,3,3,2
],[
2,2,2,2,2,2,3,3,3,3,3,3,3,2,2,2,2,5,2,2
],[
3,3,3,3,3,3,3,2,2,2,2,2,3,2,2,2,2,5,2,2
],[
2,2,3,2,2,2,2,2,2,2,2,2,3,2,2,2,2,3,2,2
],[
13,2,3,2,2,2,2,2,2,3,2,2,3,2,2,2,2,3,2,2
],[
2,5,3,2,2,2,2,2,2,3,2,2,3,2,2,2,2,3,2,2
],[
2,12,3,2,2,2,2,2,2,3,2,2,3,2,2,2,2,3,2,2
],[
5,2,3,3,3,3,3,3,3,3,2,2,3,3,3,3,3,3,2,2
],[
11,2,3,2,2,2,2,2,2,2,2,2,2,2,2,2,2,5,2,2
],[
2,5,3,2,2,2,2,2,2,2,2,2,2,2,2,2,2,5,2,2
],[
2,10,3,2,2,2,2,2,2,2,2,2,2,2,2,2,2,3,2,2
],[
5,2,2,2,2,2,2,2,2,2,2,2,2,2,2,2,2,3,2,2
],[
201,97,92,150,25,233,164,97,14,81,214,200,32,131,74,146,141,18,81,157
],[
79,102,200,32,76,26,237,52,206,162,113,147,50,49,206,159,228,217,218,166
],[
139,245,156,100,128,196,95,201,133,86,6,253,180,172,159,162,181,27,59,89
],[
52,241,252,135,146,91,111,89,219,134,28,5,249,5,92,83,39,115,107,93
],[
168,89,190,146,184,81,151,1,195,108,214,213,213,210,18,27,82,168,232,204
],[
231,55,147,7,192,74,189,158,251,215,149,212,93,226,34,101,68,159,215,199
],[
221,215,103,176,151,140,219,216,216,224,225,0,238,51,103,51,72,140,104,76
]
]