aLevelData = [
[
2,2,2,2,2,2,251,200,83,210,35,48,183,6,158,185,113,30,203,19
],[
2,3,5,3,5,5,252,241,52,118,65,25,26,230,197,84,85,181,32,42
],[
2,3,2,3,2,2,91,73,177,209,158,32,144,77,27,16,196,219,47,212
],[
2,2,2,2,2,2,182,144,173,196,230,62,47,228,221,151,169,32,99,149
],[
2,3,5,3,5,5,68,214,241,25,105,149,105,210,27,37,5,96,139,199
],[
2,3,5,3,5,5,141,185,230,189,206,204,114,13,71,101,217,131,37,81
],[
2,5,5,5,5,5,197,245,114,194,172,202,137,245,238,189,205,17,29,223
],[
154,83,155,219,124,104,107,126,159,26,65,119,135,47,219,91,1,142,148,236
],[
90,164,55,154,206,6,17,74,67,88,74,87,56,109,117,214,248,175,101,31
],[
19,194,66,137,14,100,221,116,90,152,65,141,131,3,139,77,170,150,251,195
],[
53,109,74,148,197,247,62,64,104,88,125,166,17,11,159,203,69,204,134,215
],[
22,181,242,96,85,167,80,235,4,235,211,176,10,25,198,158,42,57,33,159
],[
54,41,90,29,128,63,125,197,146,46,127,139,31,46,208,238,57,87,47,125
],[
195,78,194,154,42,36,102,126,80,123,68,125,201,235,165,139,74,164,7,0
],[
94,84,111,152,91,75,2,190,149,221,207,10,209,7,240,8,253,86,209,59
],[
30,5,207,97,137,101,5,249,86,130,98,3,18,4,255,7,180,83,176,88
],[
210,255,218,154,21,94,132,130,235,119,176,221,123,30,235,212,222,97,35,110
],[
140,35,185,86,20,7,215,223,17,144,4,69,89,134,245,54,119,155,166,144
],[
92,78,170,109,81,16,192,93,48,165,166,242,212,206,50,130,206,37,158,40
],[
89,72,36,12,145,57,202,228,223,5,128,187,184,164,104,241,135,33,117,132
]
]