aLevelData = [
[
2,2,2,2,2,2,2,2,54,28,123,94,35,57,182,50,88,195,221,174
],[
2,2,2,2,2,2,2,2,81,213,238,232,151,104,76,202,63,200,98,32
],[
2,2,3,2,3,2,2,2,179,73,138,239,181,53,45,8,160,10,43,222
],[
2,2,3,2,3,2,2,2,241,226,125,149,7,51,25,91,39,184,21,251
],[
2,2,3,2,3,2,2,2,195,175,16,175,252,69,206,54,101,79,34,39
],[
2,2,3,2,2,2,2,2,10,58,17,133,177,69,52,147,95,237,94,234
],[
2,2,3,2,3,3,3,3,30,169,127,200,254,216,200,171,90,248,16,31
],[
2,2,3,2,2,2,2,2,92,24,119,212,195,144,73,243,228,239,37,178
],[
239,53,94,39,116,67,161,89,38,143,216,157,222,28,79,32,227,170,21,192
],[
104,42,166,32,86,116,198,251,76,60,176,184,228,66,112,63,57,202,142,12
],[
166,76,236,129,208,108,241,129,230,44,231,58,39,97,162,66,165,100,99,230
],[
73,9,252,191,24,213,52,134,180,107,108,40,38,72,131,29,218,176,248,246
],[
235,232,78,54,162,166,181,99,57,198,230,93,228,62,79,238,18,84,112,161
],[
239,15,133,216,46,235,101,25,7,208,170,169,123,69,18,92,223,226,37,171
],[
152,3,24,7,36,196,242,109,90,41,237,59,242,156,31,66,71,157,89,28
],[
92,181,80,191,29,171,250,83,232,251,59,65,76,132,193,141,17,129,45,101
],[
120,186,115,250,195,252,131,142,248,198,41,206,227,69,49,99,90,130,208,196
],[
197,219,63,78,221,176,169,150,179,94,71,254,244,113,202,134,108,21,249,229
],[
202,206,155,217,163,105,151,187,185,51,90,86,124,104,121,249,209,238,151,203
],[
19,67,138,95,87,181,185,136,245,209,200,111,68,29,120,226,164,10,200,239
]
]