aLevelData = [
[
2,2,2,2,2,2,2,2,2,2,2,44,80,186,172,57,153,212,191,22
],[
2,2,2,2,2,2,2,2,2,2,2,253,245,180,111,137,199,28,222,130
],[
2,2,2,2,2,2,2,2,2,2,2,74,134,12,250,27,170,26,162,245
],[
2,2,2,13,2,2,2,2,2,2,2,231,63,223,120,240,178,32,41,194
],[
2,2,2,2,2,2,2,2,2,2,2,202,110,187,217,99,69,141,163,133
],[
2,2,2,2,2,2,2,2,2,2,2,162,115,53,64,93,185,61,218,185
],[
2,2,2,2,2,2,2,2,2,2,2,101,55,45,58,189,228,74,182,9
],[
2,2,2,2,2,2,2,2,2,1,2,248,98,175,154,19,231,224,11,243
],[
2,2,11,2,2,2,2,2,2,2,2,238,22,199,232,216,65,203,136,49
],[
2,2,2,2,2,2,2,2,2,2,2,203,174,163,216,40,222,122,96,175
],[
2,2,2,2,2,2,2,2,2,2,2,44,43,183,168,139,112,5,166,20
],[
2,2,2,2,2,2,2,2,2,2,2,137,215,23,78,119,125,25,173,107
],[
2,2,2,2,2,2,2,2,2,2,2,176,143,88,126,121,116,47,162,78
],[
2,2,2,2,2,2,2,2,2,2,2,112,13,217,125,169,74,165,206,220
],[
2,9,2,2,2,2,2,2,2,2,2,133,191,99,172,160,11,228,58,11
],[
2,2,2,2,2,2,2,2,2,2,2,204,217,245,70,21,87,180,161,128
],[
2,2,2,2,2,2,2,2,2,2,2,223,2,71,33,131,184,122,189,74
],[
210,32,56,214,123,127,77,68,106,69,130,84,113,203,90,202,83,154,204,20
],[
215,47,244,44,26,251,9,192,41,174,143,145,207,181,205,25,172,1,130,112
],[
135,11,212,112,230,21,137,24,219,178,121,46,32,136,67,40,102,85,64,77
]
]