aLevelData = [
[
10,2,2,8,2,2,2,2,2,2,2,2,221,4,156,29,113,221,147,243
],[
2,2,2,2,2,2,2,2,2,2,2,2,253,79,59,62,142,129,49,249
],[
2,2,2,2,2,2,3,3,3,3,2,2,198,226,54,178,138,16,130,141
],[
9,2,2,2,2,2,2,2,2,3,2,2,250,249,90,139,166,64,229,12
],[
3,3,3,3,3,3,3,2,2,3,2,2,254,226,60,147,11,25,192,202
],[
2,2,2,2,2,2,2,2,2,3,2,2,93,128,176,198,69,120,251,139
],[
2,2,2,2,2,2,2,2,2,3,3,2,68,203,82,211,194,144,130,11
],[
2,2,2,2,2,2,2,2,2,2,3,2,3,79,1,159,88,101,198,119
],[
2,2,2,2,2,2,2,2,2,2,3,2,146,169,94,194,188,79,61,242
],[
2,2,2,2,3,3,3,3,2,2,3,2,10,13,82,7,12,125,222,17
],[
2,2,2,2,3,2,2,3,2,2,3,2,39,195,133,240,70,111,166,95
],[
205,165,232,49,207,123,21,217,128,162,44,48,237,73,177,115,234,62,72,139
],[
76,86,130,146,89,16,247,146,125,117,149,144,63,66,55,201,114,73,121,59
],[
176,21,203,103,4,205,197,86,231,90,187,218,110,204,144,22,193,250,207,64
],[
207,105,247,166,64,112,23,239,171,153,155,164,10,73,102,239,107,164,33,162
],[
232,171,210,122,216,167,176,166,71,203,54,131,164,21,118,170,186,117,176,44
],[
226,49,35,28,118,136,35,78,136,150,108,95,212,119,182,245,244,175,137,72
],[
211,201,83,226,100,63,184,163,148,154,41,7,125,218,184,172,220,24,42,14
],[
197,106,78,149,149,7,142,211,41,172,196,6,77,62,79,229,119,176,101,153
],[
182,39,170,9,229,92,2,90,36,66,164,182,137,234,113,77,18,163,131,154
]
]