aLevelData = [
[
10,2,2,8,2,2,2,2,2,84,36,109,214,129,187,137,32,7,59,23
],[
2,2,2,2,2,2,2,2,2,141,187,112,195,234,195,59,247,197,5,56
],[
2,2,2,2,2,2,3,3,3,245,48,223,159,35,193,25,104,165,221,24
],[
9,2,2,2,2,2,2,2,2,179,49,54,84,102,31,147,12,24,192,208
],[
3,3,3,3,3,3,3,2,2,56,46,241,37,191,67,240,171,234,206,110
],[
2,2,2,2,2,2,2,2,2,27,24,254,229,217,180,233,43,50,101,230
],[
2,2,2,2,2,2,2,2,2,72,226,132,55,133,218,211,236,197,64,108
],[
2,2,2,2,2,2,2,2,2,3,24,182,247,212,142,223,32,173,73,31
],[
73,185,214,163,123,38,190,162,163,134,87,226,251,118,224,125,198,126,205,229
],[
64,57,96,38,213,182,121,107,145,29,175,196,216,150,159,38,87,102,132,180
],[
58,91,9,60,159,107,91,5,75,152,129,200,156,23,240,252,191,176,90,86
],[
35,104,200,145,46,94,232,107,46,243,168,240,146,45,3,250,90,94,27,249
],[
204,0,137,240,105,228,241,192,31,140,217,169,192,213,187,14,179,216,88,120
],[
234,19,80,222,19,196,240,36,19,150,75,225,176,127,140,101,141,233,138,251
],[
92,16,157,107,79,171,177,195,207,206,152,87,113,15,165,7,38,232,118,192
],[
178,92,17,70,95,221,51,48,242,110,228,52,222,5,79,164,184,51,209,57
],[
235,6,80,16,173,47,206,242,49,96,61,216,30,248,149,174,65,226,37,88
],[
126,186,38,243,13,50,150,93,227,181,68,247,109,74,39,169,132,186,243,39
],[
158,245,238,115,65,178,0,164,190,86,10,229,27,23,121,192,81,97,27,157
],[
184,120,49,133,191,96,197,44,224,250,62,47,211,111,49,154,2,209,122,173
]
]