aLevelData = [
[
2,2,2,2,214,5,36,246,99,34,196,113,29,170,67,235,8,39,84,95
],[
2,3,5,3,252,159,56,22,237,195,38,123,111,105,239,44,120,60,226,77
],[
2,3,2,3,104,178,237,33,72,63,6,219,79,201,201,177,171,91,99,51
],[
2,2,2,2,126,29,174,219,38,132,157,229,193,198,219,96,240,145,175,134
],[
2,3,5,3,220,252,35,73,119,190,101,46,5,157,109,94,218,42,224,251
],[
2,3,5,3,101,172,53,176,109,90,22,140,155,205,9,16,57,180,79,134
],[
57,202,12,149,121,5,169,19,69,16,119,26,30,252,149,94,185,51,19,189
],[
75,173,87,24,4,102,192,98,217,15,138,246,135,3,242,46,213,126,154,49
],[
25,9,46,12,253,57,72,5,131,153,145,43,71,229,42,50,5,121,74,126
],[
90,8,40,126,207,145,27,59,19,143,255,49,136,113,220,93,1,73,194,151
],[
203,200,247,34,234,106,85,130,164,238,237,141,68,9,240,197,24,91,208,229
],[
188,162,162,186,154,46,199,52,178,149,203,189,151,167,141,201,186,164,160,175
],[
235,173,242,183,29,121,171,116,106,73,88,84,87,30,73,117,88,41,55,186
],[
151,131,43,31,241,30,154,73,65,252,213,98,226,158,161,35,111,192,33,50
],[
205,67,253,175,108,107,189,9,201,74,118,23,56,124,169,100,224,21,104,202
],[
7,216,186,66,144,170,65,250,193,70,26,168,74,49,5,31,131,241,198,31
],[
246,122,203,114,29,233,14,52,109,116,61,115,147,161,25,248,253,183,28,99
],[
156,114,94,126,232,251,185,203,37,23,43,95,229,159,125,243,207,48,34,57
],[
158,35,98,108,109,192,184,43,49,174,120,135,135,174,180,91,176,138,97,220
],[
217,71,182,112,160,162,213,196,213,187,173,24,125,11,31,222,29,155,95,132
]
]