aLevelData = [
[
2,2,2,2,2,2,2,2,2,2,2,2,2,191,236,43,204,194,128,207
],[
2,2,13,5,5,2,2,12,5,5,2,3,2,250,34,221,130,194,104,117
],[
2,2,2,5,5,2,2,2,5,5,2,3,2,190,68,128,150,104,97,25
],[
2,2,2,2,2,2,2,2,2,2,2,3,2,62,85,42,77,48,13,151
],[
2,2,2,2,2,2,2,2,2,2,2,3,3,133,71,207,125,151,11,213
],[
2,2,2,2,2,2,2,2,2,2,2,2,2,186,50,130,216,178,124,73
],[
2,2,2,2,2,2,2,2,2,2,2,2,2,215,0,249,226,21,101,175
],[
2,2,2,2,2,2,2,2,2,2,2,2,2,80,97,4,136,225,153,210
],[
2,2,2,2,2,2,2,2,2,2,3,2,2,247,76,113,72,222,251,113
],[
2,2,2,2,2,2,2,2,2,3,3,2,3,91,176,170,61,173,211,49
],[
2,2,2,2,2,2,2,2,3,3,2,9,3,25,5,72,158,172,253,141
],[
2,2,2,2,2,2,2,2,3,2,2,2,3,135,4,250,194,159,219,97
],[
4,2,2,2,2,2,2,3,2,2,2,2,3,12,134,25,8,55,230,154
],[
2,2,2,2,2,3,3,2,2,2,2,3,3,235,159,187,48,33,80,242
],[
236,14,108,54,153,217,205,7,138,32,236,12,150,235,1,170,96,223,108,213
],[
220,181,84,38,14,234,142,46,21,183,192,11,105,67,198,56,97,24,84,170
],[
248,211,221,24,208,32,180,154,119,230,114,117,234,191,151,53,87,171,116,253
],[
39,5,72,28,60,182,169,224,119,168,37,175,126,126,42,83,188,130,35,150
],[
169,222,228,15,75,16,72,59,253,152,24,208,111,243,47,77,238,205,220,214
],[
229,115,136,63,164,135,153,103,97,247,150,199,124,47,139,74,8,142,175,95
]
]