aLevelData = [
[
6,2,8,2,9,2,10,2,11,3,2,136,212,135,219,8,176,27,227,224
],[
155,69,231,140,175,5,249,167,169,114,223,177,157,162,102,15,232,206,249,83
],[
103,178,113,190,230,51,47,3,219,68,104,78,85,10,193,133,47,62,28,206
],[
137,212,177,81,120,218,96,63,253,162,69,19,52,35,142,24,206,157,137,43
],[
193,124,1,194,62,127,203,45,228,25,156,28,51,24,30,98,67,132,66,248
],[
182,202,215,69,235,25,92,156,116,13,18,7,203,139,86,67,64,236,46,11
],[
54,93,34,154,143,133,77,107,101,105,179,67,251,141,213,113,243,92,131,84
],[
193,202,242,31,95,56,14,217,66,152,17,168,142,209,85,78,134,101,102,244
],[
70,81,92,39,180,53,104,32,180,180,172,72,155,30,80,251,231,76,210,140
],[
45,204,157,138,82,63,222,66,254,254,147,133,78,4,228,172,201,8,183,216
],[
150,233,127,127,236,79,84,36,201,144,73,101,231,208,250,59,236,109,100,126
],[
224,154,250,167,229,73,245,218,34,79,235,36,1,194,163,1,154,166,40,33
],[
111,201,28,107,89,236,79,67,194,35,144,8,21,127,195,225,115,233,52,186
],[
168,81,43,137,93,9,193,214,142,107,241,122,63,194,242,167,107,104,196,40
],[
62,43,10,234,132,245,23,188,96,173,75,83,65,88,160,145,18,132,128,7
],[
177,230,218,184,163,66,116,31,6,139,131,116,198,76,121,44,20,70,30,191
],[
20,90,226,173,214,170,113,195,136,252,137,154,234,95,8,98,2,16,74,221
],[
16,158,177,174,196,77,133,212,175,184,255,114,248,187,160,209,80,144,199,167
],[
39,56,131,154,32,29,166,0,195,245,27,233,115,233,121,95,159,247,215,236
],[
60,149,227,93,114,151,46,198,149,82,202,198,88,2,23,12,61,105,218,26
]
]