aLevelData = [
[
6,2,8,2,9,2,10,2,201,3,21,16,60,82,112,100,75,60,167,30
],[
2,2,2,2,2,2,2,2,64,55,104,5,81,240,191,194,23,234,46,159
],[
66,103,255,142,138,139,217,109,233,191,146,136,7,84,68,96,246,104,163,171
],[
31,14,141,155,124,169,227,99,8,153,152,248,116,26,7,20,28,104,138,129
],[
57,40,72,148,88,3,78,248,11,148,226,172,222,132,19,79,140,243,149,156
],[
115,26,204,49,70,47,39,148,2,137,175,119,35,5,224,59,23,168,183,180
],[
243,134,12,44,101,226,34,170,233,150,125,116,64,182,243,210,31,112,6,21
],[
36,54,113,216,13,32,1,134,44,139,166,28,22,7,202,48,156,112,225,51
],[
252,90,66,243,88,178,53,99,102,163,77,159,106,183,248,43,97,63,84,123
],[
127,244,68,185,220,222,196,194,107,117,121,114,43,7,140,33,161,89,185,109
],[
133,145,163,58,188,83,107,248,134,43,128,37,249,43,185,18,174,213,161,233
],[
186,59,18,239,223,100,5,7,4,242,168,120,227,2,177,239,2,84,242,200
],[
228,172,46,137,128,119,44,175,242,178,9,174,113,8,210,51,129,58,83,172
],[
105,196,41,10,232,190,31,197,36,0,183,33,227,137,6,177,253,34,197,25
],[
18,62,166,23,120,37,228,197,119,81,30,24,185,24,101,173,252,140,148,197
],[
10,160,223,142,235,140,175,164,89,114,174,215,116,65,29,47,183,218,110,45
],[
43,113,15,84,218,54,132,232,135,53,184,246,156,123,149,148,100,123,210,106
],[
122,176,12,113,130,131,25,251,22,110,153,244,3,98,205,103,182,102,173,67
],[
241,130,52,96,195,219,255,189,182,31,22,12,74,35,10,112,162,203,64,133
],[
126,43,140,161,105,235,1,89,52,240,8,71,162,56,176,11,101,6,69,144
]
]