aLevelData = [
[
2,2,32,22,145,128,65,64,175,144,19,7,228,147,96,93,103,182,48,124
],[
2,2,158,152,61,133,51,6,167,103,106,9,233,3,178,34,12,142,122,212
],[
5,3,27,54,69,99,214,8,1,220,170,17,148,85,225,195,185,118,23,155
],[
2,3,10,56,237,1,93,237,1,112,84,129,29,214,48,255,174,62,230,86
],[
120,172,117,94,137,72,118,22,107,191,245,48,158,231,127,207,69,162,124,143
],[
32,4,192,198,186,184,92,9,228,159,186,242,97,187,233,33,227,76,53,129
],[
55,56,251,204,188,176,187,82,25,17,111,246,47,8,27,121,77,250,166,251
],[
163,163,232,190,250,253,4,46,162,99,248,30,171,246,114,85,88,64,230,73
],[
208,23,221,42,23,196,144,34,61,101,181,220,213,144,153,67,169,57,111,140
],[
172,214,231,118,48,192,3,208,89,221,39,60,210,124,111,52,190,128,68,74
],[
242,193,50,180,97,175,244,7,215,57,209,67,235,237,44,16,47,96,86,71
],[
169,208,166,180,135,8,204,27,14,132,98,120,212,214,196,139,47,72,34,148
],[
237,195,211,92,69,239,236,116,14,156,18,193,47,97,140,57,87,130,156,231
],[
238,23,16,53,75,107,20,106,39,163,74,114,81,160,29,222,164,38,82,43
],[
55,61,223,71,211,215,1,81,170,180,137,160,69,131,118,8,191,74,201,88
],[
49,7,149,39,109,152,86,209,239,216,131,188,16,11,103,224,125,124,44,134
],[
232,100,57,79,253,14,190,121,152,57,140,94,53,190,43,61,168,114,38,61
],[
14,78,170,175,3,205,79,148,21,150,54,95,121,91,84,252,253,1,13,16
],[
62,1,5,131,27,14,51,60,105,248,55,43,232,208,237,141,118,77,66,107
],[
131,110,70,100,197,97,131,173,45,164,142,86,25,106,219,207,203,64,213,170
]
]