aLevelData = [
[
10,2,2,8,2,2,2,2,121,104,38,58,72,170,144,174,19,19,57,71
],[
2,2,2,2,2,2,2,2,205,152,210,65,209,246,182,217,121,244,33,177
],[
2,2,2,2,2,2,3,3,236,232,156,117,55,124,188,191,160,178,12,56
],[
9,2,2,2,2,2,2,2,54,38,72,1,173,148,204,81,105,153,75,95
],[
3,3,3,3,3,3,3,2,217,190,196,130,6,178,178,150,108,215,132,163
],[
2,2,2,2,2,2,2,2,8,0,76,185,178,122,187,30,173,73,77,172
],[
2,2,2,2,2,2,2,2,125,179,193,116,248,3,204,167,160,135,14,183
],[
48,219,69,185,117,105,193,14,95,49,24,66,88,198,26,52,212,153,7,119
],[
42,122,0,249,162,92,188,226,207,89,124,191,31,246,65,224,176,167,60,254
],[
101,150,134,34,58,160,17,193,212,160,223,44,93,241,113,40,142,46,131,216
],[
13,60,246,228,250,139,14,212,196,152,221,189,66,183,255,32,255,15,136,15
],[
213,230,59,145,189,31,253,72,229,0,137,81,3,57,100,108,234,34,20,93
],[
90,69,141,146,29,28,236,5,79,28,103,100,254,242,132,112,243,12,138,163
],[
206,91,53,21,89,87,174,160,22,68,186,66,26,180,50,196,30,78,179,153
],[
212,205,150,9,119,76,35,143,166,192,1,127,114,198,241,235,182,159,189,200
],[
167,120,106,77,171,239,181,156,111,212,190,164,51,44,254,70,105,124,126,182
],[
127,68,75,37,249,201,37,157,194,23,119,44,196,71,140,68,182,254,255,98
],[
53,54,115,238,23,65,133,98,252,10,255,175,37,159,78,221,138,236,55,241
],[
38,201,197,19,150,56,134,240,226,231,247,94,155,253,60,62,38,19,20,167
],[
87,127,13,65,66,217,244,238,77,184,144,176,138,189,144,199,68,211,193,25
]
]