aLevelData = [
[
2,2,2,5,2,2,2,5,2,2,2,230,107,238,92,161,215,17,2,193
],[
2,2,2,2,2,5,2,2,2,5,2,123,92,187,4,171,37,155,251,65
],[
2,2,3,3,3,3,3,3,3,3,3,43,110,17,146,193,78,201,161,47
],[
2,3,2,2,2,2,2,2,2,2,2,117,71,147,85,79,18,99,145,211
],[
2,3,2,2,2,2,2,2,2,2,8,24,215,227,20,243,179,79,19,106
],[
2,2,2,2,2,5,5,5,5,2,2,44,131,216,59,159,186,193,24,131
],[
2,2,3,3,3,3,2,3,2,3,2,224,25,239,157,247,236,110,114,185
],[
2,2,3,2,2,3,2,3,2,3,3,26,199,2,127,171,176,179,97,98
],[
2,2,3,2,2,3,2,3,2,3,2,174,140,159,149,148,163,64,60,70
],[
4,2,3,2,2,3,2,3,2,3,2,217,248,71,195,196,79,53,99,237
],[
2,2,3,3,3,2,2,3,2,3,2,0,226,93,60,159,160,139,176,127
],[
2,2,3,2,3,2,2,3,2,3,2,138,114,83,211,21,125,110,19,232
],[
2,2,3,2,3,2,2,3,2,3,2,137,249,162,238,166,85,173,169,28
],[
2,2,3,2,2,3,2,3,2,3,2,62,86,201,173,251,18,253,26,215
],[
2,2,3,2,2,3,2,3,2,3,2,79,9,233,213,91,25,100,160,129
],[
2,2,2,2,2,5,5,5,5,2,2,84,229,193,117,181,81,20,242,22
],[
2,3,2,2,2,2,2,2,2,2,9,227,125,161,142,43,215,61,253,86
],[
2,3,3,3,3,2,2,2,2,2,2,45,245,229,175,45,17,124,102,217
],[
217,255,144,128,178,72,112,237,139,163,245,222,119,222,131,184,155,159,247,120
],[
75,250,229,237,112,67,35,37,45,33,140,37,194,228,254,220,176,25,165,90
]
]