aLevelData = [
[
6,2,8,2,9,2,10,2,11,3,251,140,75,102,252,184,120,11,201,95
],[
2,2,2,2,2,2,2,2,12,3,157,141,174,167,24,99,157,211,243,254
],[
2,2,3,3,3,3,3,3,3,3,136,20,101,71,15,161,156,72,91,9
],[
2,2,3,2,2,2,2,2,2,2,185,41,74,200,29,95,204,25,227,32
],[
2,2,3,2,2,2,2,2,2,2,141,12,173,26,212,216,164,100,171,114
],[
2,2,3,2,3,3,3,3,3,3,186,181,64,95,51,212,139,198,99,79
],[
2,2,3,2,2,2,2,5,5,3,49,201,185,112,168,21,252,109,156,184
],[
2,2,3,5,5,5,2,3,3,3,213,223,146,52,142,117,204,209,25,234
],[
2,2,2,2,2,2,2,2,2,2,108,55,84,52,220,59,139,255,108,250
],[
62,89,61,36,37,175,95,155,114,248,54,61,86,48,34,253,198,8,94,57
],[
127,220,41,72,72,229,36,82,119,176,252,100,182,206,72,195,7,206,181,129
],[
6,104,96,79,110,251,131,146,223,58,84,185,223,33,42,205,30,47,226,73
],[
254,207,129,45,82,23,26,78,102,180,243,240,65,37,227,150,38,40,254,25
],[
97,114,117,248,64,163,183,239,95,121,220,203,40,68,68,124,155,154,123,108
],[
75,75,96,15,169,151,135,188,133,159,219,187,210,26,136,159,170,73,24,213
],[
146,45,219,126,254,247,141,122,24,192,51,197,189,122,70,7,200,39,19,102
],[
148,73,98,159,188,153,86,85,37,251,148,169,63,178,167,10,135,208,164,78
],[
81,241,9,2,196,41,235,255,38,59,81,62,90,12,219,238,166,87,167,195
],[
186,161,116,144,238,112,8,24,204,184,208,34,206,150,199,203,104,64,152,32
],[
73,61,7,236,223,209,141,207,25,188,66,144,112,36,1,180,40,207,198,80
]
]