aLevelData = [
[
2,2,2,5,2,2,2,5,2,2,2,5,2,2,2,5,2,2,2,24
],[
2,2,2,2,2,5,2,2,2,5,2,2,2,5,2,2,2,2,2,54
],[
2,2,3,3,3,3,3,3,3,3,3,3,3,3,3,3,2,2,2,109
],[
2,3,2,2,2,2,2,2,2,2,2,2,2,5,2,5,2,2,2,64
],[
2,3,2,2,2,2,2,2,2,2,8,2,2,2,2,2,2,2,2,205
],[
2,2,2,2,2,5,5,5,5,2,2,2,2,5,2,3,3,3,2,201
],[
221,180,106,71,159,254,29,188,219,181,243,140,185,118,226,100,126,124,12,112
],[
249,113,66,207,29,132,199,68,239,188,87,46,163,140,104,186,1,167,176,87
],[
14,21,231,106,233,135,206,67,243,232,112,80,50,52,168,145,248,141,227,76
],[
191,140,39,2,88,213,85,161,69,238,171,251,99,81,140,119,204,191,132,7
],[
251,216,135,90,49,233,121,82,24,5,244,184,166,87,69,47,69,182,183,102
],[
49,122,21,146,33,142,106,28,41,199,11,150,223,116,215,244,189,55,190,249
],[
198,19,128,239,108,197,183,155,178,88,24,112,142,244,246,3,145,247,7,191
],[
201,70,107,218,231,230,234,135,157,198,126,110,74,223,17,89,217,127,135,48
],[
230,226,255,39,35,3,86,54,251,177,237,202,117,229,173,186,90,83,72,124
],[
154,63,193,153,236,146,46,94,181,45,189,212,43,125,245,243,186,80,62,19
],[
167,231,164,163,243,76,216,29,130,230,119,57,124,74,143,98,244,84,96,102
],[
199,119,95,113,199,81,129,60,25,130,181,130,220,191,178,180,11,34,244,237
],[
165,196,1,40,11,142,241,177,169,76,45,217,216,3,119,238,3,133,43,106
],[
9,66,196,107,227,97,161,99,135,16,10,17,12,24,110,176,14,180,238,110
]
]