aLevelData = [
[
2,2,2,2,2,2,2,2,2,2,2,2,2,2,2,2,2,125,65,153
],[
2,2,2,2,2,2,2,2,3,3,3,3,3,3,3,3,3,214,196,184
],[
2,2,3,2,3,2,2,2,2,3,2,2,2,2,2,2,2,152,242,97
],[
2,2,3,2,3,2,2,2,2,2,3,2,2,2,2,2,2,78,199,206
],[
2,2,3,2,3,2,2,2,2,2,2,3,2,2,2,2,2,215,17,83
],[
2,2,3,2,2,2,2,2,2,2,2,2,3,2,2,3,3,238,106,192
],[
2,2,3,2,3,3,3,3,3,3,3,3,3,2,2,2,2,73,61,39
],[
2,2,3,2,2,2,2,2,2,2,2,2,2,2,2,2,2,201,182,165
],[
2,2,3,2,3,3,3,3,3,3,3,3,3,3,3,3,3,36,115,13
],[
2,2,3,2,2,2,2,2,2,2,2,2,2,2,2,2,2,221,9,93
],[
2,2,3,3,3,3,3,3,3,3,3,3,3,3,3,3,3,200,130,207
],[
1,2,3,2,2,2,2,2,2,2,2,2,2,2,2,2,2,39,82,106
],[
2,2,3,5,5,2,2,2,5,5,5,5,5,5,5,5,5,200,111,37
],[
2,2,3,2,2,5,5,5,5,5,2,2,2,2,2,2,2,53,224,255
],[
6,5,3,3,3,2,5,2,2,2,2,2,2,2,2,2,5,47,36,34
],[
5,2,3,2,2,3,2,5,2,2,2,2,2,2,2,5,3,68,123,47
],[
126,3,13,81,201,71,14,39,5,158,41,185,227,132,52,152,134,32,19,41
],[
138,46,217,64,69,61,49,240,76,26,253,162,57,140,60,101,172,65,49,133
],[
144,9,194,95,160,66,30,115,41,147,162,187,17,222,254,60,24,111,147,218
],[
94,122,32,112,38,196,158,32,217,160,104,232,78,29,159,118,72,126,205,62
]
]