aLevelData = [
[
4,2,2,2,2,2,2,2,169,100,147,214,204,25,82,59,244,219,159,217
],[
2,2,3,2,9,2,2,2,207,108,198,23,54,19,128,31,189,227,34,63
],[
2,3,2,2,2,2,3,2,136,63,21,143,96,158,134,213,5,140,94,165
],[
2,3,2,2,2,3,2,2,198,242,117,205,80,150,2,240,196,229,87,112
],[
2,3,2,2,3,2,2,3,12,241,203,145,110,182,247,220,97,161,37,194
],[
2,3,2,3,2,2,3,2,160,83,5,130,126,162,162,77,121,224,149,167
],[
2,2,3,2,2,3,2,2,17,96,120,16,219,55,158,228,209,64,1,128
],[
2,2,2,2,3,2,2,3,236,99,124,166,245,22,59,35,152,35,111,174
],[
186,172,70,20,12,109,26,146,224,66,233,130,60,233,5,59,45,8,12,50
],[
94,114,27,101,233,166,63,249,109,153,44,33,97,181,50,67,168,33,108,86
],[
101,67,59,143,16,131,242,60,202,82,211,240,237,107,59,224,232,89,25,141
],[
74,58,164,163,28,194,78,33,116,131,243,187,71,107,87,125,127,142,207,176
],[
77,37,62,1,193,215,67,224,152,56,177,39,85,144,64,252,147,221,130,248
],[
153,27,24,137,47,194,37,148,176,145,3,95,97,138,53,175,1,62,157,45
],[
161,74,239,14,182,34,102,243,109,13,182,14,62,113,65,135,196,81,141,30
],[
204,20,246,17,172,136,160,64,214,38,176,143,172,152,188,140,150,120,127,82
],[
82,91,210,173,140,14,216,126,175,31,120,97,250,159,16,142,214,39,103,253
],[
103,25,228,206,97,40,254,231,29,27,244,223,236,205,190,27,171,121,67,54
],[
151,52,204,166,99,187,185,157,136,111,115,46,221,158,161,177,103,4,159,104
],[
114,146,43,99,224,110,98,160,194,58,236,119,37,153,115,53,46,239,89,8
]
]