aLevelData = [
[
2,2,2,2,2,2,2,2,2,77,126,124,125,121,186,207,186,107,46,208
],[
2,2,2,2,2,2,2,2,3,222,196,11,189,195,81,251,109,118,47,179
],[
2,2,3,2,3,2,2,2,2,142,121,51,199,50,43,136,195,138,132,154
],[
2,2,3,2,3,2,2,2,2,119,240,5,51,146,43,239,228,115,239,180
],[
2,2,3,2,3,2,2,2,2,167,59,164,171,194,39,104,7,239,29,87
],[
2,2,3,2,2,2,2,2,2,10,185,132,10,118,41,89,93,69,162,127
],[
2,2,3,2,3,3,3,3,3,118,153,10,87,3,246,42,145,194,175,88
],[
2,2,3,2,2,2,2,2,2,66,71,158,83,54,250,24,110,135,95,32
],[
2,2,3,2,3,3,3,3,3,241,110,154,219,188,90,50,69,45,63,21
],[
2,2,3,2,2,2,2,2,2,33,68,49,220,54,5,49,81,184,30,71
],[
2,2,3,3,3,3,3,3,3,46,5,202,209,40,146,245,26,44,36,161
],[
1,2,3,2,2,2,2,2,2,46,233,67,136,237,142,235,3,95,213,134
],[
2,2,3,5,5,2,2,2,5,42,71,64,23,61,251,162,184,67,114,226
],[
2,2,3,2,2,5,5,5,5,70,240,159,252,91,204,253,72,124,146,108
],[
255,148,214,59,251,161,235,134,190,174,4,194,182,1,153,150,192,149,13,236
],[
234,203,141,73,125,92,59,89,59,146,140,207,229,184,238,108,0,207,175,92
],[
217,130,26,201,199,92,227,171,176,57,197,221,206,250,105,118,179,125,138,86
],[
139,205,87,255,162,149,24,167,38,219,21,139,45,234,179,133,249,144,225,225
],[
123,138,178,109,23,61,75,207,167,167,0,27,194,148,186,165,62,21,156,20
],[
243,46,230,184,194,207,25,30,215,5,92,225,42,114,30,194,76,251,253,251
]
]