aLevelData = [
[
2,2,2,2,2,2,2,2,2,2,2,2,2,2,69,115,10,150,239,28
],[
2,2,2,2,2,2,2,2,2,2,2,2,2,2,91,253,232,229,36,114
],[
2,2,2,2,2,2,2,2,2,2,2,2,2,2,89,98,125,60,186,60
],[
2,2,2,13,2,2,2,2,2,2,2,2,2,2,53,127,243,204,21,107
],[
2,2,2,2,2,2,2,2,2,2,2,2,2,2,193,232,105,180,92,253
],[
2,2,2,2,2,2,2,2,2,2,2,2,2,2,189,66,87,94,229,41
],[
2,2,2,2,2,2,2,2,2,2,2,2,2,2,199,220,64,219,167,151
],[
2,2,2,2,2,2,2,2,2,1,2,2,2,2,61,157,123,20,29,55
],[
2,2,11,2,2,2,2,2,2,2,2,2,2,2,52,143,251,240,84,146
],[
2,2,2,2,2,2,2,2,2,2,2,2,2,2,10,185,82,198,31,169
],[
2,2,2,2,2,2,2,2,2,2,2,2,2,2,64,10,111,169,171,194
],[
2,2,2,2,2,2,2,2,2,2,2,2,2,2,153,113,195,113,231,179
],[
2,2,2,2,2,2,2,2,2,2,2,2,2,2,187,139,208,149,115,132
],[
2,2,2,2,2,2,2,2,2,2,2,2,2,2,194,101,85,45,31,136
],[
2,9,2,2,2,2,2,2,2,2,2,2,2,2,125,64,134,180,28,57
],[
2,2,2,2,2,2,2,2,2,2,2,2,2,2,83,96,30,104,105,120
],[
2,2,2,2,2,2,2,2,2,2,2,2,2,2,10,69,47,84,42,3
],[
2,2,2,6,2,2,2,2,2,2,2,2,2,2,216,235,237,104,232,68
],[
2,2,2,2,2,2,2,2,2,2,2,2,2,2,137,219,243,46,228,191
],[
168,49,181,255,15,196,230,234,15,192,62,66,51,21,60,143,174,188,70,185
]
]