aLevelData = [
[
6,2,2,2,2,2,2,2,2,2,62,147,132,148,168,208,156,26,232,215
],[
2,2,2,2,2,2,2,2,2,2,113,34,134,36,94,36,100,25,8,196
],[
2,2,2,2,2,2,2,2,2,2,233,153,158,4,95,210,95,185,154,90
],[
3,3,3,3,3,3,3,3,3,3,93,60,219,126,129,97,244,215,208,173
],[
2,2,2,2,2,2,2,2,2,2,172,30,236,195,100,64,222,32,251,181
],[
2,2,2,2,2,2,2,2,2,2,18,8,240,14,163,192,198,206,218,254
],[
2,2,2,2,2,3,2,2,3,2,173,123,241,158,94,245,28,150,71,6
],[
2,2,3,3,3,3,3,3,3,3,202,44,232,57,39,103,125,240,230,195
],[
2,2,2,2,2,2,2,2,2,2,221,177,63,40,162,193,51,29,138,244
],[
2,2,2,2,2,2,2,2,2,4,23,58,29,195,80,219,144,159,92,28
],[
3,3,3,3,3,3,3,3,3,3,234,133,18,1,101,211,42,244,23,90
],[
2,2,2,2,2,2,2,2,2,2,255,117,209,180,148,13,72,215,213,131
],[
2,2,2,2,2,2,2,2,2,2,114,235,32,83,51,89,4,92,57,37
],[
2,2,3,3,3,3,3,3,3,3,73,217,37,125,48,146,235,146,251,84
],[
2,2,3,2,2,2,2,2,2,2,123,166,176,158,161,102,27,157,41,123
],[
2,2,3,2,2,2,2,2,2,2,18,90,72,92,253,51,55,102,149,136
],[
33,46,235,182,63,22,172,73,66,30,164,109,241,253,130,166,19,113,219,193
],[
143,211,113,11,210,238,180,192,113,17,137,198,15,99,75,155,130,119,15,141
],[
49,32,45,41,192,135,252,245,240,122,220,98,192,7,122,252,217,74,79,228
],[
40,131,106,128,205,107,112,113,52,201,225,197,129,64,156,110,50,107,166,243
]
]