aLevelData = [
[
2,2,2,2,2,2,2,2,2,6,5,2,2,2,2,164,203,117,136,204
],[
2,3,5,3,5,5,5,3,5,3,5,2,5,3,5,117,78,180,92,201
],[
2,3,2,3,2,2,2,3,5,3,5,2,5,3,5,134,177,192,208,19
],[
101,209,83,170,133,5,64,143,19,226,78,171,37,185,228,223,233,144,56,152
],[
230,96,180,163,132,129,157,67,207,98,246,129,120,125,162,196,28,138,202,161
],[
201,243,126,244,191,137,159,48,115,117,252,243,218,113,187,222,227,56,251,163
],[
70,58,183,95,124,149,237,43,14,65,0,237,19,138,92,117,244,196,88,197
],[
115,58,96,175,236,103,83,166,218,105,42,206,156,178,219,85,122,1,124,6
],[
227,144,172,27,248,143,47,83,79,210,216,69,240,199,172,244,164,170,68,163
],[
112,252,115,235,92,49,41,10,120,169,151,126,33,225,148,211,129,235,64,185
],[
85,27,231,89,243,4,40,233,139,162,86,126,173,217,30,34,11,30,106,39
],[
129,117,134,187,82,155,129,188,181,132,215,205,144,8,76,169,131,217,27,183
],[
40,184,80,223,153,232,115,157,51,227,102,83,154,77,144,228,253,38,60,126
],[
156,67,59,183,135,255,209,220,168,46,207,133,3,82,252,109,61,18,185,129
],[
91,231,229,55,205,25,255,33,171,234,138,194,62,16,182,160,194,105,60,154
],[
106,235,138,124,165,218,32,209,160,61,58,249,12,146,175,123,33,193,25,156
],[
227,79,54,48,164,212,142,176,202,175,86,141,210,248,149,196,149,182,133,179
],[
202,82,60,42,205,76,139,198,159,45,39,122,45,189,6,111,213,117,12,14
],[
38,55,231,91,231,61,56,132,91,80,243,185,196,58,8,63,38,125,67,192
],[
77,69,112,230,17,156,196,40,217,221,120,227,94,107,183,172,178,162,186,229
]
]