aLevelData = [
[
6,2,2,2,2,2,2,2,2,2,2,51,154,59,137,255,177,204,147,233
],[
2,2,2,2,2,2,2,2,2,2,2,25,100,157,147,251,87,58,151,160
],[
2,2,2,2,2,2,2,2,2,2,2,154,31,36,134,130,216,232,179,206
],[
3,3,3,3,3,3,3,3,3,3,3,185,51,73,232,22,89,91,104,183
],[
2,2,2,2,2,2,2,2,2,2,2,88,255,218,134,186,164,193,139,189
],[
2,2,2,2,2,2,2,2,2,2,2,166,220,26,178,32,167,75,163,2
],[
2,2,2,2,2,3,2,2,3,2,2,37,171,56,99,221,49,219,24,34
],[
2,2,3,3,3,3,3,3,3,3,3,116,27,133,152,26,78,179,244,148
],[
2,2,2,2,2,2,2,2,2,2,2,123,163,3,9,119,226,238,143,77
],[
2,2,2,2,2,2,2,2,2,4,2,94,188,161,227,120,24,206,219,90
],[
3,3,3,3,3,3,3,3,3,3,3,85,174,184,139,175,26,66,192,212
],[
2,2,2,2,2,2,2,2,2,2,2,156,43,246,163,37,242,189,51,254
],[
8,215,23,1,50,1,224,9,46,17,228,167,153,65,62,23,16,203,22,114
],[
150,182,35,36,53,239,109,161,232,155,88,84,185,172,222,216,39,178,28,107
],[
202,244,16,160,58,192,161,84,44,255,223,226,222,12,141,155,182,199,221,112
],[
38,229,122,242,210,138,203,125,245,25,119,175,0,75,36,31,133,126,133,76
],[
84,80,147,212,228,109,26,231,244,165,120,250,113,66,161,192,155,152,103,86
],[
100,221,249,190,24,59,169,142,67,36,242,233,208,230,185,175,110,127,211,241
],[
56,178,200,168,148,90,214,166,91,255,57,204,59,167,170,126,90,238,38,84
],[
60,89,240,18,231,232,217,219,69,234,191,161,201,21,84,224,85,214,32,140
]
]