aLevelData = [
[
2,2,2,2,2,2,2,2,2,2,2,2,2,2,2,2,2,2,2,51
],[
2,2,13,5,5,2,2,12,5,5,2,3,2,5,5,2,2,2,2,188
],[
217,138,206,175,244,158,163,57,120,225,165,15,157,194,85,66,123,3,65,182
],[
183,199,203,213,98,236,44,132,30,154,185,86,131,28,100,0,193,239,133,14
],[
134,25,219,212,34,188,205,166,233,235,246,76,216,188,225,176,124,159,17,218
],[
16,238,69,30,230,197,250,148,8,19,48,201,30,241,113,180,146,51,16,236
],[
243,61,175,24,151,25,3,166,133,198,220,192,145,210,95,123,201,43,150,82
],[
16,50,44,212,9,17,113,153,55,78,164,122,98,161,114,1,60,3,186,31
],[
68,8,147,29,235,110,144,213,245,246,67,34,35,114,255,149,15,32,226,106
],[
87,54,19,186,253,190,73,242,14,164,141,131,130,14,64,219,100,235,95,149
],[
51,207,6,236,135,254,51,118,247,199,205,15,59,19,229,18,142,61,59,208
],[
86,36,4,58,7,127,234,225,69,113,85,33,73,94,233,152,133,252,80,221
],[
139,173,57,111,43,12,160,236,219,197,80,132,93,171,167,172,155,4,154,23
],[
214,39,248,226,255,74,243,15,101,149,220,52,145,123,46,116,110,73,206,175
],[
174,255,145,246,104,96,255,66,6,69,87,101,94,54,211,64,31,59,44,55
],[
111,240,97,226,210,216,181,5,78,243,246,195,205,147,5,14,194,107,147,98
],[
15,233,41,179,39,198,107,164,111,219,157,249,235,54,102,79,22,109,212,10
],[
17,50,161,144,0,40,181,181,178,245,235,117,128,153,24,233,119,254,74,116
],[
185,207,77,62,32,142,116,227,37,225,149,108,0,45,86,126,17,102,167,209
],[
127,38,144,228,31,252,45,239,151,6,247,26,195,194,68,236,87,33,18,6
]
]