aLevelData = [
[
2,2,152,54,105,217,220,139,74,216,61,139,26,53,0,253,215,9,163,245
],[
2,2,145,50,98,75,20,94,0,75,199,102,195,174,212,222,193,202,137,234
],[
5,2,90,5,255,82,6,143,249,217,81,81,14,203,35,32,11,214,69,55
],[
5,2,147,26,33,228,8,131,201,129,175,87,59,166,14,11,228,157,153,91
],[
5,5,98,22,142,154,142,28,30,70,186,72,205,223,55,53,27,249,27,51
],[
5,2,100,145,64,64,5,157,144,52,192,230,128,59,98,26,219,136,162,29
],[
5,2,193,72,77,161,239,213,160,246,65,45,245,35,116,162,163,53,49,211
],[
2,2,31,215,71,218,103,35,57,199,160,184,248,78,253,13,241,188,228,5
],[
2,2,74,47,76,195,105,7,106,191,183,152,140,25,163,33,69,46,233,2
],[
2,2,202,106,20,41,156,93,65,206,103,16,39,96,42,153,84,191,153,237
],[
2,2,185,171,192,246,105,125,232,229,158,20,190,202,253,19,178,97,27,74
],[
2,2,158,47,63,113,168,206,106,28,105,134,148,235,79,29,57,1,63,239
],[
2,2,20,184,127,65,43,147,212,210,11,117,231,179,85,16,237,89,121,159
],[
2,2,135,241,194,216,231,243,147,28,53,250,240,242,49,211,63,179,25,211
],[
80,135,205,110,156,143,49,6,202,100,211,1,120,193,206,30,55,124,238,9
],[
215,187,20,45,230,100,220,201,115,213,126,70,23,214,242,200,55,203,88,3
],[
131,47,150,80,194,61,67,255,210,240,196,239,234,46,180,93,35,64,138,250
],[
55,134,117,64,136,105,139,5,100,144,35,81,135,87,127,109,225,125,175,60
],[
154,28,177,206,84,223,221,51,176,111,129,141,19,46,200,105,170,40,224,80
],[
171,71,91,152,222,198,214,128,93,231,217,125,152,233,255,206,155,52,87,86
]
]