aLevelData = [
[
2,2,2,2,2,2,217,24,215,85,28,174,53,25,111,28,253,208,99,56
],[
2,2,2,2,2,2,250,35,200,40,14,128,44,210,211,37,158,148,129,123
],[
2,2,3,2,3,2,184,53,19,166,220,28,165,90,189,192,33,240,33,96
],[
2,2,3,2,3,2,26,185,230,244,248,146,67,99,86,184,81,246,168,222
],[
2,2,3,2,3,2,202,13,33,125,16,17,212,108,113,169,25,176,169,49
],[
2,2,3,2,2,2,50,149,168,104,46,254,150,104,14,249,21,220,39,150
],[
2,2,3,2,3,3,198,109,199,250,14,125,27,175,26,24,80,62,32,39
],[
2,2,3,2,2,2,249,0,232,231,177,49,140,154,1,70,124,125,132,128
],[
2,2,3,2,3,3,196,249,72,194,146,29,120,160,242,76,56,184,221,51
],[
2,2,3,2,2,2,209,69,114,254,14,241,131,204,230,235,83,96,90,58
],[
2,2,3,3,3,3,158,25,161,81,218,36,131,227,189,240,3,248,255,226
],[
1,2,3,2,2,2,64,65,97,75,157,168,238,151,32,44,129,199,24,236
],[
2,2,3,5,5,2,135,33,3,129,6,37,174,145,223,196,158,161,80,205
],[
2,2,3,2,2,5,175,43,188,168,251,241,175,70,253,144,29,88,247,88
],[
6,5,3,3,3,2,234,191,144,91,175,68,194,196,188,138,243,107,89,64
],[
5,2,3,2,2,3,98,166,82,155,197,97,178,4,49,113,206,14,57,37
],[
5,3,2,2,2,2,133,170,90,30,199,158,151,97,84,51,96,171,198,46
],[
5,3,2,2,2,2,184,5,210,2,151,151,203,68,141,193,103,95,169,104
],[
5,3,2,2,2,2,198,137,153,142,176,246,18,38,31,75,115,38,253,85
],[
5,3,2,2,2,2,165,221,46,251,69,135,209,113,5,31,195,175,79,116
]
]