aLevelData = [
[
2,2,2,2,2,2,2,2,2,2,2,2,2,2,186,95,52,213,69,232
],[
2,2,2,2,2,2,2,2,3,3,3,3,3,3,90,101,211,203,77,246
],[
2,2,3,2,3,2,2,2,2,3,2,2,2,2,34,27,231,202,252,202
],[
2,2,3,2,3,2,2,2,2,2,3,2,2,2,95,14,105,18,27,96
],[
2,2,3,2,3,2,2,2,2,2,2,3,2,2,35,20,197,144,74,192
],[
2,2,3,2,2,2,2,2,2,2,2,2,3,2,161,163,89,244,30,30
],[
2,2,3,2,3,3,3,3,3,3,3,3,3,2,89,232,171,129,84,201
],[
2,2,3,2,2,2,2,2,2,2,2,2,2,2,203,17,13,164,108,218
],[
2,2,3,2,3,3,3,3,3,3,3,3,3,3,238,134,117,245,66,226
],[
2,2,3,2,2,2,2,2,2,2,2,2,2,2,158,7,164,50,132,10
],[
2,2,3,3,3,3,3,3,3,3,3,3,3,3,183,225,253,80,24,105
],[
1,2,3,2,2,2,2,2,2,2,2,2,2,2,168,196,145,185,201,116
],[
2,2,3,5,5,2,2,2,5,5,5,5,5,5,144,217,84,76,215,208
],[
2,2,3,2,2,5,5,5,5,5,2,2,2,2,72,36,116,198,62,254
],[
6,5,3,3,3,2,5,2,2,2,2,2,2,2,244,102,66,136,212,134
],[
5,2,3,2,2,3,2,5,2,2,2,2,2,2,225,233,56,10,131,185
],[
5,3,2,2,2,2,3,2,5,5,2,2,2,2,223,5,252,81,87,34
],[
93,70,109,67,16,48,232,103,36,176,119,209,229,177,231,103,176,237,153,88
],[
5,179,52,1,222,232,151,18,63,77,18,236,15,255,213,78,38,68,168,49
],[
167,132,221,240,144,150,131,172,143,62,221,239,24,243,19,143,180,229,38,214
]
]