aLevelData = [
[
5,5,5,5,5,2,200,148,182,48,205,202,135,161,19,108,130,75,131,19
],[
5,2,2,2,2,2,236,50,161,126,153,168,8,51,2,19,20,104,152,240
],[
5,2,5,3,3,3,222,35,88,24,109,161,160,66,42,245,65,202,149,241
],[
2,2,5,2,3,2,213,177,55,73,83,228,215,246,224,193,241,217,232,215
],[
2,2,3,2,3,2,100,161,110,237,107,238,160,70,206,182,175,36,90,233
],[
2,2,3,2,3,3,221,139,142,80,216,71,151,187,70,49,127,91,161,173
],[
4,2,3,2,2,2,161,109,69,119,96,24,199,160,24,153,137,211,85,157
],[
2,2,3,2,2,3,139,221,67,238,132,108,102,82,50,23,139,177,238,159
],[
2,2,2,2,2,3,255,117,131,117,254,54,64,124,110,151,76,15,206,107
],[
2,3,2,2,2,3,58,70,105,29,221,117,207,78,94,246,133,191,139,41
],[
2,3,2,2,2,3,252,114,114,184,192,12,47,32,242,126,2,109,248,228
],[
2,3,2,3,3,2,165,68,115,173,220,39,113,253,77,245,229,79,146,176
],[
2,3,2,3,6,2,84,95,141,131,208,71,251,4,42,232,76,182,100,139
],[
2,3,2,3,8,2,179,210,101,200,121,71,240,168,150,255,215,6,130,100
],[
108,59,73,35,57,250,222,47,241,120,177,10,166,208,131,64,59,167,121,52
],[
29,11,112,30,46,161,145,85,2,0,37,202,78,88,170,213,157,87,38,53
],[
69,77,187,82,154,142,124,196,97,24,127,25,136,117,51,211,20,227,244,177
],[
90,179,221,48,114,239,222,80,233,63,14,155,182,13,66,100,111,232,222,77
],[
189,38,235,12,14,206,106,110,137,181,232,155,71,230,83,157,192,71,12,28
],[
131,122,61,107,43,2,109,201,142,167,82,224,55,27,230,146,23,221,189,245
]
]