aLevelData = [
[
4,2,2,2,2,2,2,2,2,2,8,2,2,2,161,214,215,36,192,21
],[
2,2,3,2,9,2,2,2,2,2,2,2,2,3,141,236,231,93,182,168
],[
2,3,2,2,2,2,3,2,2,3,2,3,2,2,77,159,214,223,43,191
],[
2,3,2,2,2,3,2,2,3,2,2,2,3,2,139,193,192,141,183,186
],[
2,3,2,2,3,2,2,3,2,2,2,2,2,3,153,246,225,71,15,124
],[
217,9,17,227,155,24,36,45,118,153,167,201,110,147,92,8,222,254,36,208
],[
98,29,10,148,243,14,131,131,84,160,244,0,174,100,117,83,119,7,213,158
],[
151,222,222,18,206,195,218,98,80,32,86,120,179,73,37,104,11,15,168,162
],[
84,146,77,107,16,86,86,142,48,153,220,78,56,228,19,160,159,225,207,151
],[
116,108,71,32,72,236,25,239,71,228,143,185,168,197,33,164,72,7,59,252
],[
145,119,64,39,161,211,206,219,168,148,68,142,146,11,129,46,231,175,239,19
],[
239,182,193,50,25,226,120,147,157,158,172,5,97,73,9,16,26,210,152,43
],[
179,133,63,47,242,36,140,12,89,58,174,186,74,172,196,115,111,145,91,32
],[
89,67,49,17,103,182,63,240,234,9,247,248,134,91,203,98,220,224,238,32
],[
101,52,94,206,161,239,34,230,114,121,208,51,194,32,83,136,108,103,235,177
],[
90,161,117,170,235,191,237,15,151,103,49,212,213,70,8,54,60,166,98,241
],[
233,67,226,180,34,90,153,210,56,4,21,58,178,194,154,169,167,89,175,30
],[
108,224,220,143,112,23,179,218,99,250,13,254,158,150,150,139,191,28,140,87
],[
147,52,195,115,58,147,237,93,133,208,24,119,163,115,120,184,253,80,103,162
],[
94,19,170,116,87,27,246,160,226,140,178,127,69,159,255,68,57,61,246,47
]
]