aLevelData = [
[
2,2,2,2,112,41,112,58,48,192,105,87,253,41,254,98,191,122,130,177
],[
2,2,2,4,129,102,105,54,128,4,0,94,129,210,92,56,104,250,144,218
],[
7,212,36,1,52,171,194,247,30,196,49,186,225,156,136,90,87,114,155,163
],[
49,5,186,252,71,159,155,143,45,82,148,170,7,130,13,101,158,164,54,134
],[
179,68,245,161,147,77,35,132,235,133,247,210,222,87,194,237,85,213,221,25
],[
150,253,224,223,25,59,21,176,150,48,45,203,99,178,49,97,253,20,187,246
],[
229,167,101,10,173,128,130,249,82,124,12,32,204,130,222,65,228,8,35,40
],[
70,217,15,143,215,21,205,64,72,121,184,121,236,224,205,148,198,10,96,231
],[
231,157,15,234,247,105,245,151,17,240,32,23,212,38,68,154,182,117,176,135
],[
156,4,130,213,168,57,23,184,82,125,198,129,187,63,206,191,61,59,140,171
],[
71,252,242,195,104,159,52,180,169,219,196,125,32,62,129,210,194,185,44,190
],[
121,95,27,141,119,106,49,233,201,127,13,67,47,51,130,117,43,205,71,165
],[
88,77,240,108,253,174,29,55,226,105,242,238,98,58,199,212,194,38,32,175
],[
193,189,223,40,112,157,184,116,68,55,230,52,106,214,28,154,90,221,191,206
],[
175,79,82,144,54,149,50,30,69,124,131,88,78,126,106,34,179,66,124,10
],[
220,102,119,43,136,123,48,80,96,81,205,93,210,117,52,235,28,249,196,51
],[
167,115,66,45,151,72,22,249,160,43,183,125,27,224,100,80,89,70,21,214
],[
55,148,177,173,242,227,129,72,61,237,229,218,145,20,69,118,197,166,75,116
],[
222,95,79,22,40,47,19,108,134,62,177,116,6,46,209,134,184,160,31,239
],[
193,249,253,221,171,102,116,123,255,29,113,92,22,230,46,29,44,218,238,70
]
]