aLevelData = [
[
2,2,2,2,36,92,27,220,16,186,218,80,222,24,171,94,117,79,81,200
],[
2,3,5,3,96,79,78,25,209,17,7,54,230,205,35,54,44,108,52,115
],[
2,3,2,3,98,64,153,225,127,243,163,159,246,189,246,204,56,218,50,156
],[
2,2,2,2,122,60,211,171,185,125,86,145,252,23,158,182,218,215,149,104
],[
2,3,5,3,59,143,22,42,99,12,11,79,44,71,210,200,146,223,230,59
],[
2,3,5,3,117,199,187,85,155,60,233,96,245,251,141,24,35,176,236,186
],[
2,5,5,5,57,177,90,95,196,236,91,136,8,31,7,250,140,71,179,204
],[
2,3,5,3,217,90,205,190,126,56,8,204,87,223,185,3,15,223,129,148
],[
2,3,5,3,228,15,45,39,170,125,218,113,19,171,93,9,45,248,226,119
],[
2,5,5,5,44,92,210,142,106,88,251,253,172,45,235,32,167,77,156,28
],[
195,15,87,42,30,166,210,51,212,84,156,158,126,219,186,102,248,53,147,111
],[
104,132,9,26,123,76,233,23,242,224,133,122,94,26,159,17,39,79,137,245
],[
211,130,139,96,133,216,133,190,196,76,213,7,126,164,123,75,77,164,123,143
],[
248,129,131,215,61,153,206,132,206,96,72,224,153,158,243,248,76,216,137,170
],[
25,11,99,254,183,161,153,186,169,157,107,48,194,25,224,91,233,242,172,42
],[
26,194,87,28,173,14,156,13,219,193,16,80,126,217,4,253,24,97,171,140
],[
23,159,128,163,87,142,226,45,233,143,1,172,19,91,254,208,151,60,78,72
],[
56,125,96,216,123,30,127,172,171,205,249,236,31,18,129,144,192,202,210,118
],[
197,214,149,177,193,20,133,37,224,142,209,81,109,242,193,107,152,67,157,178
],[
119,205,203,0,74,94,55,158,3,179,248,93,6,49,48,226,45,214,51,66
]
]