aLevelData = [
[
6,2,8,2,9,2,10,2,11,3,2,2,5,2,2,42,172,21,0,255
],[
2,2,2,2,2,2,2,2,12,3,5,2,2,2,5,48,190,161,129,183
],[
2,2,3,3,3,3,3,3,3,3,2,2,3,3,3,70,249,238,84,254
],[
2,2,3,2,2,2,2,2,2,2,5,2,3,2,2,96,74,208,31,125
],[
2,2,3,2,2,2,2,2,2,2,2,2,3,2,2,174,170,188,106,227
],[
2,2,3,2,3,3,3,3,3,3,2,5,3,2,2,92,244,19,48,224
],[
2,2,3,2,2,2,2,5,5,3,2,2,3,2,2,108,223,111,115,253
],[
2,2,3,5,5,5,2,3,3,3,5,2,3,3,3,147,102,153,169,115
],[
2,2,2,2,2,2,2,2,2,2,2,2,5,2,2,85,97,212,170,204
],[
2,3,2,2,3,1,3,2,2,2,2,2,5,2,2,234,176,235,191,38
],[
2,3,2,2,3,2,3,2,2,2,2,5,5,2,2,250,89,220,222,228
],[
2,3,2,3,2,2,2,3,2,2,2,2,5,2,2,164,28,246,82,117
],[
2,3,2,3,2,2,2,3,3,3,2,2,3,3,3,153,243,72,13,159
],[
2,3,2,3,2,2,2,3,2,2,5,2,5,2,2,186,163,41,5,154
],[
8,40,190,141,27,111,171,187,241,13,179,64,199,155,22,47,244,102,254,215
],[
28,209,88,69,167,244,225,10,113,137,132,62,195,9,227,196,131,18,52,208
],[
167,12,78,167,239,12,3,166,212,248,177,134,188,237,20,222,111,221,94,233
],[
206,125,138,138,195,94,237,141,116,89,14,48,188,49,183,226,219,116,76,74
],[
108,162,92,139,152,145,118,199,138,16,62,226,34,203,191,136,238,111,3,113
],[
86,14,225,227,22,196,23,121,242,155,153,36,164,172,40,111,26,135,37,7
]
]