aLevelData = [
[
2,255,76,172,100,159,246,74,244,247,23,173,184,35,104,122,81,146,173,51
],[
2,206,104,140,183,31,32,159,8,204,118,200,81,231,132,197,40,63,43,4
],[
2,16,214,180,184,66,149,183,44,173,63,60,87,59,164,33,178,86,23,188
],[
2,70,171,33,192,9,45,119,101,106,93,42,195,43,201,30,127,111,211,189
],[
2,170,20,180,236,230,66,193,62,203,68,236,104,137,151,141,246,206,65,99
],[
2,60,234,100,213,142,49,19,126,180,160,100,233,152,196,199,153,66,216,150
],[
2,77,6,46,237,130,252,208,187,56,177,102,25,249,28,90,219,24,212,59
],[
101,55,128,95,193,11,142,205,238,100,40,89,122,103,99,17,83,30,186,216
],[
218,52,188,81,57,249,1,255,246,172,98,170,201,250,105,4,171,194,7,140
],[
48,27,133,179,22,152,189,61,30,203,138,235,26,7,125,87,72,106,210,31
],[
222,27,162,69,230,209,90,214,76,149,107,202,54,200,67,44,147,103,125,123
],[
247,142,84,79,166,59,94,63,239,85,119,3,187,237,250,214,101,195,56,30
],[
204,12,34,79,167,114,73,13,25,93,9,145,134,113,0,77,164,88,197,211
],[
213,193,215,243,180,168,212,35,237,216,236,37,83,175,148,227,44,34,127,158
],[
207,0,202,71,114,123,119,45,61,228,28,217,163,182,220,54,241,214,151,246
],[
39,25,94,48,8,7,42,78,109,223,205,38,222,219,40,103,99,180,159,55
],[
152,105,202,26,0,61,109,22,155,254,171,21,187,141,118,138,19,155,74,87
],[
17,177,27,239,110,115,140,183,3,37,97,179,222,110,55,94,149,92,114,217
],[
218,169,120,72,80,61,29,122,157,243,93,200,193,160,81,63,166,82,92,1
],[
247,213,166,232,54,124,203,109,9,29,212,200,213,94,102,89,142,47,57,71
]
]