aLevelData = [
[
2,2,90,62,204,37,254,246,248,226,73,213,88,5,78,179,56,63,82,209
],[
2,2,158,12,47,179,208,43,246,50,22,81,216,205,193,30,71,64,108,80
],[
3,2,88,88,130,55,108,5,1,105,15,177,125,182,32,208,103,94,51,184
],[
2,2,143,130,51,179,232,217,76,83,139,164,7,6,255,228,183,234,184,202
],[
3,2,21,227,221,111,39,234,79,197,102,168,230,206,31,67,254,11,26,120
],[
2,2,50,56,122,234,103,54,228,185,13,73,227,87,161,131,139,151,118,128
],[
3,2,93,7,182,84,107,128,163,194,189,251,35,175,242,166,124,213,42,56
],[
2,2,92,188,36,129,28,230,164,69,69,74,24,74,84,5,122,176,186,75
],[
2,3,120,129,39,163,211,137,8,84,5,104,79,26,38,229,114,30,16,133
],[
2,2,182,37,194,93,173,8,2,36,253,100,71,140,100,146,213,210,249,218
],[
3,3,42,148,181,227,153,228,49,110,53,154,177,68,240,238,98,109,4,70
],[
8,2,224,163,146,76,251,7,137,68,187,18,202,157,162,205,138,197,48,69
],[
2,2,247,66,173,57,30,255,34,23,12,227,169,39,51,168,230,5,16,235
],[
2,2,214,84,11,127,199,177,159,7,168,230,186,196,131,96,103,171,72,228
],[
2,2,170,187,204,125,171,141,17,185,23,45,200,20,196,40,20,181,148,230
],[
9,2,145,88,155,58,149,140,132,56,182,30,48,71,140,213,161,119,184,95
],[
2,2,23,20,36,140,120,123,141,186,245,44,63,145,235,33,32,240,7,94
],[
2,2,240,38,174,202,207,102,156,61,0,117,203,218,236,166,150,159,106,8
],[
2,2,30,58,61,222,237,30,222,79,217,215,125,95,43,154,66,30,1,33
],[
216,31,241,182,44,44,239,141,114,56,113,86,106,149,209,19,225,104,242,39
]
]