aLevelData = [
[
2,2,2,2,2,2,2,2,2,2,58,193,249,26,197,73,35,151,161,5
],[
2,2,13,5,5,2,2,12,5,5,66,131,71,24,60,58,115,220,85,1
],[
2,2,2,5,5,2,2,2,5,5,42,212,82,151,252,226,222,13,135,186
],[
2,2,2,2,2,2,2,2,2,2,46,216,60,151,225,37,102,45,42,108
],[
103,222,48,72,69,48,181,134,102,127,246,123,152,239,211,155,85,165,48,72
],[
68,55,155,232,2,96,47,58,35,249,184,234,116,36,24,99,131,203,233,228
],[
98,73,99,214,167,102,128,93,183,137,95,45,69,41,230,159,21,133,172,3
],[
6,149,22,56,79,64,192,123,9,207,30,125,238,162,99,184,96,33,161,2
],[
173,246,50,99,145,122,88,36,252,108,32,40,22,233,140,128,128,152,240,57
],[
221,38,157,120,146,242,189,202,201,9,126,181,188,84,115,147,48,16,55,160
],[
63,127,83,81,91,221,97,231,144,150,114,69,9,182,174,254,214,161,58,179
],[
237,4,95,156,110,11,232,100,43,213,203,58,103,37,12,37,222,90,223,151
],[
6,161,13,70,149,105,152,55,67,23,162,27,209,251,139,223,74,131,90,127
],[
137,175,94,27,251,197,21,76,166,70,76,184,106,32,136,228,135,37,165,74
],[
96,188,189,172,127,215,75,167,216,37,144,139,82,136,54,106,131,201,52,111
],[
187,139,241,113,69,125,172,200,233,212,27,96,181,249,82,12,254,126,231,28
],[
161,87,84,49,142,71,156,80,136,152,50,54,38,15,22,235,30,31,65,154
],[
194,93,67,160,203,52,43,227,86,218,167,101,44,130,108,25,70,212,216,245
],[
145,154,214,72,238,188,3,78,125,110,15,1,27,168,101,51,41,214,14,218
],[
144,210,210,171,1,15,161,234,130,23,50,128,38,55,234,78,27,120,255,193
]
]