aLevelData = [
[
4,2,5,5,2,2,2,2,2,2,2,2,2,2,134,4,6,125,212,11
],[
2,2,2,2,2,2,5,2,2,2,5,2,2,2,97,95,150,206,60,162
],[
2,2,2,2,2,2,3,3,3,3,3,3,3,2,144,210,152,147,238,100
],[
3,3,3,3,3,3,3,2,2,2,2,2,3,2,32,128,216,219,95,25
],[
2,2,3,2,2,2,2,2,2,2,2,2,3,2,70,29,49,28,22,101
],[
13,2,3,2,2,2,2,2,2,3,2,2,3,2,119,50,92,67,15,20
],[
2,5,3,2,2,2,2,2,2,3,2,2,3,2,249,228,4,241,111,147
],[
2,12,3,2,2,2,2,2,2,3,2,2,3,2,1,20,243,128,12,194
],[
196,192,112,97,188,150,251,224,36,241,106,82,205,53,34,220,92,62,33,210
],[
230,163,51,29,189,55,105,224,137,214,199,91,154,94,61,15,124,251,217,34
],[
204,168,58,6,75,242,72,86,49,255,34,0,196,208,88,169,40,195,91,77
],[
121,92,49,38,23,68,109,208,65,146,95,170,230,74,136,127,183,35,80,102
],[
129,142,252,230,186,243,218,94,90,62,190,164,236,154,178,237,228,124,234,237
],[
51,228,246,63,25,224,59,6,58,81,164,213,245,241,149,204,241,149,33,4
],[
248,176,124,46,9,25,179,118,168,14,154,174,121,120,6,168,13,112,61,227
],[
252,3,171,106,52,50,215,250,144,61,149,99,173,34,124,48,249,96,154,138
],[
12,0,103,90,60,214,248,174,107,5,117,94,36,193,205,239,231,89,168,183
],[
192,116,158,66,30,154,166,245,227,247,209,241,184,92,56,59,163,135,50,25
],[
219,164,203,191,219,20,114,42,181,108,242,77,169,193,164,107,246,35,226,196
],[
240,103,190,115,83,42,244,151,215,18,30,177,4,87,39,77,72,130,2,229
]
]