aLevelData = [
[
4,2,2,2,2,2,2,2,2,2,111,134,75,209,236,7,37,108,223,27
],[
2,2,3,2,9,2,2,2,2,2,89,185,123,0,195,119,145,16,223,127
],[
2,3,2,2,2,2,3,2,2,3,166,138,129,167,73,149,198,229,164,130
],[
2,3,2,2,2,3,2,2,3,2,74,184,80,82,155,195,110,120,238,187
],[
243,224,17,132,67,47,161,151,2,77,125,167,38,33,122,132,81,155,89,63
],[
95,248,246,143,58,65,193,115,246,21,114,25,26,169,249,255,59,13,180,88
],[
208,177,229,177,65,39,99,212,65,42,144,237,94,224,138,235,214,92,166,41
],[
173,103,26,78,252,128,249,114,140,33,101,130,163,68,0,229,30,38,163,95
],[
192,75,83,54,202,194,112,148,204,170,48,45,186,245,76,33,66,108,249,36
],[
93,243,26,220,37,15,180,138,230,165,162,237,119,5,138,100,203,38,15,82
],[
195,51,72,198,70,71,113,92,148,118,225,94,215,12,60,47,252,25,234,234
],[
192,45,200,70,14,96,29,189,136,149,207,237,100,0,215,62,121,230,242,197
],[
153,164,153,104,34,243,52,67,208,106,139,75,213,69,125,49,44,100,244,138
],[
42,151,24,44,86,24,195,219,122,89,53,37,250,0,10,138,101,48,105,224
],[
74,11,125,246,77,117,41,120,121,26,247,18,216,178,82,216,65,132,246,230
],[
114,40,164,67,95,146,26,12,201,76,66,206,17,3,170,51,79,69,52,225
],[
159,137,15,159,187,112,229,185,207,74,86,166,136,220,166,233,110,97,178,53
],[
117,206,41,212,206,90,248,74,3,62,6,53,67,185,34,119,251,88,58,151
],[
166,116,205,101,229,252,162,221,210,117,187,78,145,62,133,188,41,25,81,130
],[
146,231,7,59,16,179,25,227,191,242,183,58,110,9,66,105,176,16,2,232
]
]