aLevelData = [
[
4,2,2,2,2,2,2,2,2,2,2,2,2,2,2,2,2,184,11,43
],[
5,2,5,3,2,2,2,2,2,2,2,2,2,2,2,2,2,51,209,2
],[
2,5,5,3,3,3,3,3,3,3,3,3,3,3,3,3,3,192,65,126
],[
3,3,5,5,5,5,5,5,5,5,3,2,2,2,2,2,2,186,158,219
],[
2,3,5,5,5,5,5,5,5,5,3,6,2,2,2,2,2,86,126,174
],[
3,3,5,5,5,5,3,3,3,3,3,3,3,3,3,2,3,211,56,192
],[
3,5,5,5,5,5,3,2,2,2,2,2,2,2,2,2,2,111,61,50
],[
3,5,5,3,3,3,3,8,2,2,2,5,5,5,5,5,5,104,246,107
],[
3,5,5,3,2,2,3,3,3,3,2,5,3,3,3,5,3,161,108,51
],[
3,5,5,3,2,2,2,2,2,3,2,5,3,5,5,5,5,28,154,161
],[
117,240,137,209,48,31,24,13,255,107,83,68,229,83,9,21,216,138,117,226
],[
128,167,29,38,60,30,251,8,102,111,219,48,216,157,4,217,174,226,26,39
],[
78,161,67,187,166,156,137,134,181,103,128,218,77,29,40,199,23,81,20,164
],[
215,71,204,236,241,100,113,76,45,228,159,249,183,203,151,71,106,30,158,120
],[
77,82,160,209,94,5,25,244,143,236,54,105,15,13,55,126,202,46,23,81
],[
51,141,111,43,65,209,152,15,183,65,15,147,169,52,30,239,60,200,185,84
],[
173,215,167,127,149,39,226,141,107,225,63,17,74,69,81,100,244,155,139,60
],[
24,109,166,128,208,243,66,91,110,207,208,144,120,251,175,13,241,255,149,194
],[
218,103,49,179,249,116,15,76,217,18,187,245,18,10,41,231,202,121,84,62
],[
124,129,38,79,249,62,152,59,172,251,26,197,33,166,53,96,201,130,111,140
]
]