aLevelData = [
[
4,167,174,40,252,228,111,185,13,166,139,126,179,21,90,254,168,21,0,96
],[
2,203,25,239,219,194,60,173,109,227,142,216,208,85,171,103,170,114,147,50
],[
2,4,112,181,181,253,65,77,16,191,183,240,83,179,236,101,249,241,225,183
],[
3,178,251,101,136,102,170,57,168,118,104,113,231,69,160,29,39,247,115,41
],[
2,181,120,173,130,217,192,247,122,171,86,78,110,41,19,179,166,135,41,36
],[
13,124,198,100,204,193,136,175,119,92,35,217,72,52,244,153,174,81,246,208
],[
2,148,62,146,15,216,177,185,89,255,109,49,42,39,104,44,183,60,41,31
],[
2,120,111,117,209,228,228,42,179,124,171,107,111,10,242,253,195,43,121,241
],[
5,144,11,70,132,46,112,153,67,3,250,34,115,84,169,114,175,90,159,176
],[
11,211,153,39,141,25,109,247,121,130,230,178,24,120,213,177,239,177,39,3
],[
2,100,86,114,178,229,101,206,72,103,84,230,146,18,247,79,164,58,163,24
],[
2,29,146,148,162,173,156,140,177,212,100,189,196,236,110,233,162,105,237,200
],[
5,54,96,53,170,156,70,115,93,124,251,156,81,151,6,163,250,159,35,239
],[
118,76,251,12,112,172,50,161,68,187,166,162,99,51,246,198,250,165,66,60
],[
206,201,50,154,106,19,58,22,125,134,28,248,126,205,174,79,145,136,221,227
],[
174,228,242,108,0,110,20,1,139,41,14,211,18,221,83,27,56,179,63,81
],[
229,255,160,159,235,93,117,149,234,255,246,30,113,69,212,179,101,142,193,206
],[
167,79,51,162,241,98,101,9,1,160,159,190,250,177,184,204,7,35,217,70
],[
65,186,131,57,211,7,212,223,91,60,6,21,148,63,56,15,51,253,113,75
],[
14,1,226,195,131,69,107,103,24,72,97,202,95,96,143,28,29,82,122,88
]
]