aLevelData = [
[
2,2,2,2,2,2,2,2,2,2,2,2,2,2,2,2,2,2,2,2
],[
2,2,2,2,2,2,2,2,2,2,2,2,2,2,2,2,2,2,2,2
],[
2,2,2,2,2,2,2,2,2,2,2,2,2,2,2,2,2,4,2,2
],[
2,2,2,13,2,2,2,2,2,2,2,2,2,2,2,2,2,2,2,2
],[
2,2,2,2,2,2,2,2,2,2,2,2,2,2,2,2,2,2,2,2
],[
2,2,2,2,2,2,2,2,2,2,2,2,2,2,2,2,2,2,2,2
],[
2,2,2,2,2,2,2,2,2,2,2,2,2,2,2,2,2,2,2,2
],[
2,2,2,2,2,2,2,2,2,1,2,2,2,2,2,2,2,2,8,2
],[
2,2,11,2,2,2,2,2,2,2,2,2,2,2,2,2,2,2,2,2
],[
2,2,2,2,2,2,2,2,2,2,2,2,2,2,2,2,2,2,2,2
],[
4,11,112,201,84,92,251,234,234,243,106,63,63,56,19,25,113,156,53,10
],[
222,219,45,71,241,125,237,81,60,163,169,213,199,0,211,208,168,38,74,246
],[
212,3,207,85,53,171,184,54,253,88,232,68,57,174,254,240,169,68,205,19
],[
207,97,13,213,70,3,79,207,85,38,55,108,196,66,229,149,238,22,180,141
],[
24,164,39,25,1,125,32,229,186,62,83,35,184,91,251,117,40,27,203,13
],[
130,228,40,18,97,185,149,70,146,1,111,231,107,138,218,211,94,205,251,239
],[
206,116,104,200,32,25,220,123,22,81,48,211,88,233,134,178,84,111,200,178
],[
72,244,81,11,157,17,233,184,119,40,247,213,138,236,242,76,47,36,25,176
],[
183,172,100,105,255,188,186,18,68,108,100,31,57,120,194,195,87,65,60,17
],[
117,21,124,97,152,176,218,245,12,3,24,220,180,52,80,23,158,229,42,251
]
]