aLevelData = [
[
2,2,2,2,2,2,2,2,2,2,2,2,2,2,2,2,2,2,2,200
],[
2,2,2,2,2,2,2,2,2,2,2,2,2,2,2,2,2,2,2,147
],[
2,2,2,2,2,2,2,2,2,2,2,2,2,2,2,2,2,4,2,173
],[
162,233,207,92,168,222,28,51,42,127,2,104,23,81,1,73,23,170,40,125
],[
194,22,227,141,15,250,21,163,15,119,102,145,219,145,223,20,203,145,180,90
],[
232,167,96,195,164,212,247,229,201,7,184,210,176,135,226,157,179,144,202,26
],[
228,65,41,230,0,182,186,167,158,113,5,149,172,254,117,58,28,214,177,117
],[
219,133,41,197,3,8,239,196,81,121,201,242,217,238,132,180,248,158,139,157
],[
139,69,184,235,94,202,105,85,232,31,215,4,53,106,163,223,35,98,178,11
],[
209,251,59,178,85,69,30,4,173,145,120,124,248,215,116,101,231,84,100,156
],[
110,119,16,151,191,254,77,166,120,93,210,121,27,95,72,227,192,15,160,221
],[
6,217,169,206,79,237,226,10,45,228,141,152,23,166,4,56,97,139,80,164
],[
107,192,248,23,24,237,23,12,129,20,177,72,235,189,71,26,247,80,169,226
],[
25,194,12,208,75,115,92,238,3,87,212,97,98,85,203,236,174,236,209,181
],[
2,28,250,76,68,132,122,233,88,200,114,245,147,53,10,204,115,168,192,194
],[
141,171,0,100,198,226,244,0,198,166,157,103,170,239,35,241,249,119,105,194
],[
218,28,229,76,132,134,175,21,245,11,215,186,231,207,252,53,0,48,26,91
],[
73,97,164,168,225,84,211,63,243,222,61,45,229,22,169,238,210,254,34,50
],[
59,101,74,225,249,11,241,92,118,7,230,6,29,102,13,3,15,21,178,63
],[
24,1,29,178,225,124,103,227,103,227,140,171,171,125,192,60,172,167,7,97
]
]