aLevelData = [
[
6,2,2,2,2,2,2,2,2,2,131,237,57,102,157,238,136,200,213,115
],[
2,2,2,2,2,2,2,2,2,2,180,82,65,73,38,101,24,219,109,218
],[
2,2,2,2,2,2,2,2,2,2,23,3,203,129,35,31,243,205,47,104
],[
3,3,3,3,3,3,3,3,3,3,17,205,96,127,11,94,111,73,6,160
],[
2,2,2,2,2,2,2,2,2,2,80,253,45,166,17,123,173,114,4,224
],[
2,2,2,2,2,2,2,2,2,2,4,32,32,87,124,97,165,50,242,43
],[
2,2,2,2,2,3,2,2,3,2,255,57,220,175,237,65,139,140,226,1
],[
2,2,3,3,3,3,3,3,3,3,173,66,172,34,21,233,83,149,191,35
],[
2,2,2,2,2,2,2,2,2,2,68,41,14,79,174,93,89,255,45,114
],[
2,2,2,2,2,2,2,2,2,4,166,172,166,197,181,169,114,92,65,86
],[
3,3,3,3,3,3,3,3,3,3,190,191,130,150,49,9,246,131,208,62
],[
2,2,2,2,2,2,2,2,2,2,97,96,31,223,19,206,137,188,105,67
],[
2,2,2,2,2,2,2,2,2,2,2,10,150,185,235,181,163,163,54,248
],[
2,2,3,3,3,3,3,3,3,3,181,37,202,42,143,132,41,219,87,220
],[
80,31,157,17,223,42,153,7,121,29,180,22,110,32,75,184,151,177,175,133
],[
130,59,112,98,207,235,219,245,218,191,193,92,155,224,122,30,202,49,42,97
],[
70,40,67,94,183,221,75,19,114,96,224,55,158,80,249,115,149,169,110,207
],[
141,222,187,107,120,40,1,111,41,29,77,68,183,132,29,5,38,104,32,48
],[
68,107,62,162,210,93,216,194,228,13,81,252,139,95,205,113,176,159,56,236
],[
67,21,139,24,150,218,74,241,3,234,81,121,213,121,209,172,102,139,150,181
]
]