aLevelData = [
[
10,50,14,127,10,2,194,60,146,114,159,94,60,135,101,62,74,141,1,158
],[
2,203,102,156,152,192,35,215,212,126,209,85,254,83,149,123,119,108,252,115
],[
2,75,246,140,119,100,132,159,76,253,177,113,12,89,6,119,41,180,30,242
],[
9,175,122,7,197,201,183,236,131,135,206,241,205,222,111,95,219,241,195,1
],[
3,88,142,233,206,115,252,166,199,51,244,88,35,10,237,44,170,174,157,145
],[
2,95,36,188,237,97,29,11,142,19,134,149,227,123,91,52,236,232,188,88
],[
2,239,216,66,4,109,24,147,25,84,45,52,215,118,243,159,161,58,132,150
],[
2,0,145,91,182,235,44,186,79,70,237,72,115,168,155,255,77,97,217,69
],[
2,180,188,89,89,0,129,77,241,29,190,30,34,222,199,97,127,147,124,7
],[
2,133,221,202,211,55,193,117,18,5,252,20,134,242,150,93,163,246,186,162
],[
2,254,161,197,156,2,2,157,104,228,199,68,207,218,165,173,202,136,251,206
],[
2,69,187,178,246,36,90,103,97,132,154,204,10,67,112,75,192,194,76,237
],[
2,124,233,4,123,242,108,14,227,102,77,243,220,193,163,0,205,228,153,63
],[
2,235,60,185,166,162,150,107,141,55,53,184,102,171,34,84,168,226,196,220
],[
2,12,5,176,92,252,36,194,20,72,32,109,124,28,200,79,133,47,66,9
],[
34,60,173,77,7,182,4,57,176,184,69,227,166,59,211,53,254,139,25,251
],[
34,252,113,58,212,216,68,195,111,157,114,9,112,101,244,48,54,166,192,102
],[
6,27,236,118,82,2,23,154,59,136,5,145,84,130,137,242,169,93,168,192
],[
0,88,251,62,94,240,85,5,205,156,166,83,93,187,31,166,105,203,151,138
],[
27,219,46,175,50,67,48,62,3,146,60,109,190,200,165,82,243,198,24,244
]
]