aLevelData = [
[
10,2,2,8,30,193,102,60,31,53,230,103,213,170,255,244,234,114,204,92
],[
2,2,2,2,132,112,183,52,116,121,73,175,177,0,64,99,4,243,226,80
],[
2,2,2,2,4,224,146,30,69,92,161,166,205,165,102,180,199,134,145,11
],[
9,2,2,2,124,123,188,170,126,22,67,78,38,161,86,56,65,5,76,48
],[
3,3,3,3,7,235,58,202,77,32,197,232,251,62,52,128,191,137,202,160
],[
2,2,2,2,3,23,82,175,29,52,251,245,198,4,102,94,206,106,254,122
],[
2,2,2,2,14,41,136,201,157,73,250,54,71,189,145,225,58,66,30,33
],[
2,2,2,2,3,138,161,202,185,154,24,171,120,113,153,91,17,234,159,54
],[
2,2,2,2,0,227,162,162,159,159,234,151,153,105,164,94,160,122,54,152
],[
2,2,2,2,99,29,208,131,186,17,67,121,36,47,23,185,116,76,215,106
],[
2,2,2,2,199,97,176,221,185,234,59,19,217,139,150,127,90,249,185,12
],[
2,2,2,2,11,24,7,98,137,97,36,101,178,135,7,255,94,90,80,32
],[
74,235,219,3,85,241,149,178,239,107,142,204,206,135,80,134,226,195,112,240
],[
140,82,98,122,11,193,145,182,55,218,175,95,113,201,74,155,218,125,161,125
],[
195,81,181,206,101,236,163,13,210,101,48,180,44,171,166,189,21,37,223,101
],[
102,149,159,48,36,66,39,45,176,86,6,123,61,133,51,12,135,239,89,169
],[
195,72,114,54,209,54,151,56,185,250,22,148,85,83,198,153,75,159,151,65
],[
63,68,109,180,70,78,47,14,157,90,26,98,155,178,92,255,228,185,222,242
],[
224,138,97,204,107,220,204,165,206,41,196,96,238,15,126,49,196,246,209,93
],[
13,243,144,65,67,236,22,150,203,253,34,243,112,27,230,147,16,247,90,89
]
]