aLevelData = [
[
2,2,199,247,189,156,222,39,10,91,237,87,170,47,151,40,6,233,53,35
],[
2,2,215,118,214,170,67,108,132,46,72,227,202,163,94,134,115,49,88,234
],[
2,2,147,45,140,30,204,71,51,131,202,5,19,221,16,112,91,171,247,13
],[
2,2,206,180,243,14,35,227,25,202,172,84,222,107,55,175,34,230,50,181
],[
2,2,109,49,18,24,120,176,245,144,239,240,133,43,117,151,32,229,233,155
],[
2,2,55,120,231,179,244,117,146,11,32,148,145,60,67,72,88,123,13,151
],[
2,2,169,16,244,41,90,11,31,159,88,50,131,38,236,61,76,75,61,70
],[
2,2,126,17,23,123,220,64,234,22,9,1,22,143,237,168,101,15,90,209
],[
2,2,217,41,239,174,169,197,61,159,134,92,41,3,34,107,145,79,243,33
],[
2,2,51,93,53,91,202,6,46,211,121,242,181,148,109,175,245,178,191,1
],[
2,2,111,55,151,121,62,96,151,73,159,10,119,87,176,103,236,144,120,245
],[
2,2,207,127,40,177,123,30,160,136,119,236,53,14,85,63,178,114,217,220
],[
156,178,94,197,187,11,118,82,213,180,209,131,189,203,96,149,141,144,185,211
],[
47,209,190,175,34,165,121,17,122,93,75,239,41,184,70,30,126,86,215,104
],[
235,111,168,222,11,197,196,111,227,215,253,186,105,88,139,33,66,223,245,31
],[
208,224,53,219,108,219,23,253,240,211,226,192,121,2,58,72,107,203,69,55
],[
181,240,13,123,86,5,37,105,32,37,144,16,187,227,222,199,238,131,152,9
],[
26,107,222,131,7,212,79,106,227,197,41,18,136,66,177,189,254,193,214,177
],[
65,221,17,141,68,78,143,220,53,25,146,235,3,4,21,216,30,77,175,236
],[
126,155,185,42,230,53,179,40,106,114,228,30,47,113,65,61,114,9,144,66
]
]