aLevelData = [
[
4,2,2,2,2,2,2,2,2,2,2,81,146,198,117,246,124,192,159,109
],[
5,2,5,3,2,2,2,2,2,2,2,115,1,161,87,38,212,171,242,109
],[
2,5,5,3,3,3,3,3,3,3,3,248,142,152,199,70,210,136,7,147
],[
3,3,5,5,5,5,5,5,5,5,3,2,233,74,216,75,12,44,145,70
],[
2,3,5,5,5,5,5,5,5,5,3,242,60,98,17,14,173,0,164,75
],[
3,3,5,5,5,5,3,3,3,3,3,78,79,98,81,188,200,239,4,213
],[
3,5,5,5,5,5,3,2,2,2,2,30,66,78,113,33,251,31,77,226
],[
3,5,5,3,3,3,3,8,2,2,2,246,178,72,24,32,17,210,194,137
],[
3,5,5,3,2,2,3,3,3,3,2,219,161,14,187,69,165,122,75,95
],[
3,5,5,3,2,2,2,2,2,3,2,63,57,173,153,174,216,76,133,202
],[
33,218,222,244,64,229,202,77,36,172,92,38,40,48,93,184,243,142,76,21
],[
156,139,163,95,18,113,92,56,188,26,180,121,92,74,47,39,57,66,220,163
],[
125,145,218,32,220,46,27,90,118,196,104,134,255,77,165,132,29,226,87,92
],[
17,209,99,232,154,241,24,206,22,50,112,178,235,120,147,169,37,170,157,240
],[
97,5,161,222,233,183,238,23,32,169,145,3,33,156,27,126,163,119,164,209
],[
32,223,15,225,54,9,144,167,77,204,108,224,122,251,0,6,163,241,5,126
],[
228,109,18,19,50,161,98,163,62,133,216,24,156,113,64,154,37,235,216,4
],[
154,190,15,148,138,76,140,230,117,36,114,35,49,215,227,118,141,8,195,191
],[
53,195,190,140,213,16,140,69,129,199,115,166,85,165,14,114,88,160,78,102
],[
166,120,190,108,207,143,11,18,122,250,195,58,78,216,93,19,18,226,122,72
]
]