aLevelData = [
[
2,2,2,2,5,5,2,2,2,2,2,2,56,87,26,98,7,13,199,42
],[
126,119,94,38,135,164,65,127,185,158,225,48,44,239,50,178,139,100,92,216
],[
106,17,180,248,218,149,234,75,59,160,131,150,82,178,138,10,156,37,131,105
],[
225,109,161,107,11,159,57,96,57,48,117,22,16,255,77,253,81,150,179,137
],[
177,173,14,216,229,240,234,149,252,3,238,28,241,194,14,223,129,205,2,8
],[
58,68,246,96,213,207,131,111,197,226,222,229,16,63,79,56,94,188,229,143
],[
79,70,105,223,18,38,144,83,52,131,116,242,181,40,69,124,97,136,60,148
],[
93,255,209,36,1,91,46,254,229,155,227,191,63,247,219,249,108,32,143,145
],[
204,200,121,101,211,101,204,50,93,50,98,182,66,119,246,17,43,11,147,113
],[
164,23,76,238,114,28,46,179,38,56,115,95,242,165,248,171,188,130,242,76
],[
113,214,220,27,156,210,180,115,55,86,102,218,192,183,137,228,144,192,73,85
],[
105,246,164,134,78,32,218,10,151,7,30,144,68,123,146,11,146,150,114,17
],[
204,69,143,129,100,3,0,105,66,232,20,39,92,227,139,206,135,68,5,203
],[
140,125,186,200,127,41,108,208,76,77,154,180,147,222,247,174,182,132,26,69
],[
48,158,119,112,40,134,142,254,69,22,98,53,197,107,45,186,201,232,82,177
],[
243,126,147,36,51,43,132,169,222,193,63,63,1,233,90,122,244,103,22,224
],[
50,160,217,146,103,89,223,47,203,193,44,245,175,178,197,41,85,52,31,185
],[
5,67,216,33,93,210,165,139,233,15,140,58,244,233,83,40,157,207,56,238
],[
45,187,226,229,167,112,152,139,161,0,177,40,83,144,75,177,238,95,64,236
],[
47,5,86,213,51,249,182,65,141,86,160,193,150,223,92,201,4,64,116,17
]
]