aLevelData = [
[
4,2,5,163,195,120,80,82,91,5,228,35,126,19,145,210,142,204,237,112
],[
2,2,2,232,105,87,168,22,155,211,71,69,41,21,252,249,218,219,91,255
],[
2,2,2,149,128,40,164,199,206,211,36,5,21,63,101,243,121,199,229,100
],[
3,3,3,144,131,241,194,45,199,25,177,118,237,224,239,61,85,184,126,141
],[
2,2,3,169,45,6,130,102,96,117,94,152,183,232,218,229,211,206,186,204
],[
13,2,3,194,74,164,47,118,218,50,15,118,55,70,152,212,124,158,93,95
],[
2,5,3,137,168,228,25,170,151,101,236,116,182,207,152,240,252,12,240,252
],[
225,134,70,237,113,234,36,121,159,44,61,213,219,203,162,26,231,86,57,237
],[
230,47,108,95,182,143,30,18,127,202,227,158,140,212,112,50,90,4,80,127
],[
239,25,217,209,109,123,95,127,231,195,167,134,115,124,158,113,129,43,75,124
],[
107,142,3,248,77,34,220,241,22,231,100,15,223,103,146,186,124,245,252,129
],[
81,51,75,189,103,215,236,113,192,174,9,117,231,225,184,212,202,119,114,114
],[
204,27,198,242,23,31,78,214,47,194,227,232,205,174,13,217,234,197,189,41
],[
26,29,63,70,27,73,106,248,174,219,26,252,165,38,224,240,62,73,247,111
],[
175,105,122,124,2,61,213,36,35,208,122,95,56,130,213,56,48,80,129,45
],[
159,86,188,217,201,146,24,208,252,235,116,203,36,114,43,5,153,231,139,228
],[
59,127,137,220,193,228,178,145,78,126,101,59,69,241,64,79,95,231,216,92
],[
251,15,173,50,181,102,93,74,57,181,23,98,90,90,83,104,94,76,192,153
],[
156,90,126,234,74,179,142,167,144,171,135,90,224,188,138,238,138,203,119,20
],[
139,173,97,230,166,234,64,202,183,193,230,154,67,108,53,2,83,165,142,41
]
]