aLevelData = [
[
2,2,2,2,2,2,2,2,2,2,2,2,2,2,2,2,182,182,31,215
],[
2,2,13,5,5,2,2,12,5,5,2,3,2,5,5,2,65,0,191,188
],[
2,2,2,5,5,2,2,2,5,5,2,3,2,5,5,2,135,142,52,61
],[
2,2,2,2,2,2,2,2,2,2,2,3,2,2,2,2,164,157,26,152
],[
171,129,190,248,234,226,128,73,112,36,124,75,205,39,105,229,25,49,192,189
],[
56,40,33,5,91,5,244,152,202,133,76,69,226,33,16,106,89,65,92,197
],[
202,173,37,136,109,68,28,171,37,240,213,134,193,217,41,159,123,217,217,193
],[
197,49,115,78,70,122,122,213,31,222,193,231,114,135,24,39,37,88,42,161
],[
227,219,166,93,100,123,157,51,239,244,44,224,29,7,90,90,223,114,67,97
],[
194,31,119,87,114,156,157,81,125,203,92,110,90,219,123,104,170,118,70,104
],[
189,60,52,31,88,113,200,18,182,242,181,53,204,110,69,188,210,210,251,46
],[
254,5,120,187,147,214,155,207,26,51,236,231,239,155,59,164,0,213,132,29
],[
210,227,22,122,197,50,244,191,152,19,124,229,47,111,70,47,148,181,79,187
],[
61,24,87,88,141,248,135,151,156,157,87,37,59,43,175,87,51,210,76,7
],[
206,70,102,159,153,111,144,115,103,97,223,84,153,142,78,97,157,58,97,33
],[
181,48,9,207,250,180,200,245,160,184,21,61,123,83,2,131,194,110,28,46
],[
20,193,147,193,184,254,155,173,41,75,17,106,210,246,98,197,22,100,169,124
],[
147,75,23,8,168,33,152,186,52,213,179,9,161,188,178,43,34,206,4,226
],[
56,18,223,153,123,87,42,175,151,37,153,19,149,243,26,17,92,154,112,107
],[
119,10,29,172,24,60,134,185,93,104,82,169,211,119,19,214,57,187,40,52
]
]