aLevelData = [
[
2,2,2,5,2,2,2,5,2,2,2,5,2,2,2,5,2,2,237,15
],[
2,2,2,2,2,5,2,2,2,5,2,2,2,5,2,2,2,2,236,122
],[
2,2,3,3,3,3,3,3,3,3,3,3,3,3,3,3,2,2,142,137
],[
160,58,1,89,247,30,211,166,11,45,4,59,12,39,96,139,51,175,12,242
],[
248,175,96,62,133,249,244,110,106,42,254,186,146,212,219,211,118,220,235,107
],[
144,32,162,248,19,93,220,181,217,81,113,234,157,28,10,110,106,236,51,106
],[
83,217,177,95,101,14,21,107,218,42,145,200,143,230,11,149,185,247,112,217
],[
211,54,75,197,219,254,150,57,189,213,207,138,16,79,79,131,0,48,216,169
],[
139,209,109,195,241,197,102,154,101,187,195,254,9,166,193,9,25,28,171,168
],[
102,252,243,86,7,84,129,43,75,130,75,22,242,153,38,103,156,6,219,144
],[
129,115,126,44,99,235,251,64,193,63,242,193,78,169,197,87,161,176,239,97
],[
46,75,151,57,117,73,100,185,121,240,148,254,116,229,72,107,201,76,34,241
],[
58,47,18,142,91,36,109,20,70,42,64,44,145,213,227,154,125,171,209,195
],[
112,205,182,108,166,218,202,196,35,16,94,165,236,180,180,23,118,180,20,22
],[
95,140,28,149,92,102,88,194,115,133,19,140,106,227,108,98,127,25,172,62
],[
89,128,214,227,63,150,128,99,136,163,226,227,82,156,45,162,119,71,30,56
],[
189,160,210,28,77,124,220,105,103,108,149,226,83,228,179,51,155,156,29,122
],[
119,55,254,5,137,35,24,93,202,192,92,132,197,196,183,124,3,222,46,8
],[
198,153,45,183,250,132,28,29,104,144,52,100,45,185,145,4,106,232,136,206
],[
62,24,58,47,241,184,105,179,114,81,139,200,4,105,29,197,52,167,58,42
]
]