aLevelData = [
[
2,2,2,2,2,2,2,2,2,2,81,75,204,169,229,231,51,8,77,98
],[
2,2,2,2,2,2,2,2,2,2,228,205,178,84,232,113,253,19,17,9
],[
2,2,2,2,2,2,2,2,2,2,60,130,130,189,71,41,113,124,163,139
],[
2,2,2,3,3,3,3,3,3,3,44,238,166,179,90,170,220,17,132,170
],[
2,2,2,2,2,2,2,2,2,2,170,132,212,251,49,184,28,185,117,178
],[
2,2,2,2,2,2,2,2,2,2,25,59,191,169,250,139,64,24,28,25
],[
2,2,2,2,2,3,2,2,3,2,246,17,24,176,212,212,255,168,29,160
],[
2,2,2,3,3,3,3,3,3,3,228,94,17,201,155,225,203,11,193,238
],[
2,2,2,2,2,2,2,2,2,2,106,30,252,31,111,138,132,95,102,189
],[
2,2,2,2,2,2,2,2,2,2,227,161,201,91,249,210,33,213,66,11
],[
2,2,3,3,3,3,3,3,3,3,110,61,92,12,201,89,195,230,72,246
],[
2,2,2,2,2,2,2,2,2,2,224,247,34,126,66,27,19,205,43,33
],[
2,2,2,2,2,2,2,2,2,2,2,65,78,124,226,16,215,59,214,223
],[
2,2,3,3,3,3,3,3,3,2,172,60,152,144,242,156,27,91,212,113
],[
2,2,3,2,2,2,2,2,2,2,111,32,127,188,230,251,113,153,117,26
],[
2,2,3,2,2,2,2,2,2,2,244,185,92,203,229,18,9,217,186,213
],[
2,2,3,3,3,3,2,2,2,2,58,25,196,161,99,64,176,246,79,247
],[
2,2,2,2,2,3,2,2,2,2,84,236,9,50,169,37,253,189,19,0
],[
91,23,233,15,188,132,49,204,8,94,171,135,151,172,18,163,150,246,158,2
],[
173,87,205,190,222,211,99,26,177,235,175,184,142,111,17,12,106,148,185,16
]
]