aLevelData = [
[
4,2,5,5,2,137,245,9,185,17,65,185,40,139,192,184,248,237,93,210
],[
2,2,2,2,2,28,116,56,53,81,241,168,110,73,100,129,148,9,203,146
],[
2,2,2,2,2,195,144,60,114,204,185,50,125,43,98,37,25,58,206,93
],[
62,164,72,7,53,27,9,137,159,78,92,19,186,21,0,118,224,239,206,58
],[
80,175,155,234,49,114,96,179,212,212,153,46,58,100,234,121,214,85,8,140
],[
147,118,215,202,25,100,208,215,76,253,166,170,22,25,41,227,103,117,106,94
],[
122,240,32,8,89,250,74,241,163,73,22,163,141,205,2,179,39,231,65,149
],[
225,214,96,180,77,114,41,194,38,28,200,77,146,245,44,148,164,78,176,152
],[
37,96,251,118,148,61,36,243,107,7,26,89,164,96,68,130,124,33,100,50
],[
119,79,193,170,164,75,133,121,34,72,100,150,227,2,126,172,176,174,135,181
],[
109,44,37,202,159,132,153,57,43,144,162,217,96,246,158,154,56,90,243,96
],[
219,209,173,18,101,152,105,237,233,6,113,31,182,191,40,145,217,43,169,4
],[
227,38,171,95,236,249,168,71,215,137,62,241,216,207,213,52,52,136,130,227
],[
72,46,43,89,205,38,236,85,90,59,186,9,42,75,70,109,32,64,36,217
],[
8,66,45,211,32,44,34,38,215,60,146,52,212,14,253,140,58,203,57,191
],[
43,158,21,112,139,103,61,171,6,180,93,120,84,237,137,175,187,206,221,13
],[
214,26,96,136,150,142,46,224,134,20,215,119,83,58,2,98,139,226,86,192
],[
165,59,154,74,66,240,26,44,178,159,77,20,186,140,182,136,148,151,8,124
],[
56,107,141,36,218,249,200,7,180,37,90,85,5,190,34,122,90,180,168,243
],[
12,133,188,96,10,249,90,219,216,15,209,137,216,55,36,110,201,193,177,134
]
]