aLevelData = [
[
2,2,3,3,3,3,3,3,3,3,3,3,3,9,169,15,254,2,240,226
],[
2,2,2,2,2,2,2,2,2,2,2,2,2,200,20,166,63,119,247,113
],[
3,2,3,3,3,3,3,3,3,3,3,2,3,192,140,51,137,80,147,54
],[
2,2,2,2,2,2,2,2,2,2,2,2,2,120,226,6,164,30,99,110
],[
3,2,3,3,3,3,3,3,3,3,3,3,3,238,247,236,203,38,161,61
],[
2,2,3,2,2,2,2,2,2,2,2,2,3,54,18,152,103,197,127,69
],[
3,2,3,2,2,3,3,3,3,3,3,3,3,200,175,215,55,60,176,246
],[
2,2,3,2,2,3,2,2,2,2,2,3,3,176,146,175,58,99,61,159
],[
2,3,3,2,2,3,3,3,3,2,2,2,2,217,124,76,163,120,225,157
],[
2,2,2,2,2,2,2,2,2,3,2,3,2,117,249,183,77,8,148,41
],[
3,3,3,3,2,2,2,2,2,3,2,3,2,114,108,41,100,13,243,212
],[
8,2,6,3,2,3,3,3,3,3,2,3,2,230,58,146,195,249,170,137
],[
2,2,2,3,2,3,2,2,2,3,2,3,2,68,122,83,70,34,223,102
],[
2,2,2,2,2,3,2,2,2,3,2,3,3,135,50,121,130,192,41,245
],[
2,2,2,2,2,3,2,2,2,3,2,2,2,39,188,176,41,109,134,187
],[
14,246,138,22,8,33,248,64,110,128,105,125,70,141,197,39,80,152,100,69
],[
71,4,115,95,99,179,154,144,34,191,219,220,72,107,190,196,36,89,171,24
],[
22,253,151,13,78,81,227,143,214,202,128,216,211,139,88,66,8,218,233,89
],[
155,208,51,53,28,84,213,7,195,74,115,241,249,7,90,27,26,8,103,3
],[
122,228,37,20,166,128,53,123,236,130,243,54,29,8,86,109,145,153,24,6
]
]