aLevelData = [
[
4,2,5,5,2,2,2,42,1,233,158,37,204,149,177,227,234,113,187,45
],[
2,2,2,2,2,2,5,16,45,57,222,192,22,213,69,27,151,220,203,246
],[
2,2,2,2,2,2,3,0,242,214,47,135,5,237,65,141,127,28,23,34
],[
3,3,3,3,3,3,3,192,154,30,202,203,169,158,129,63,190,74,254,138
],[
2,2,3,2,2,2,2,226,22,53,89,88,72,31,82,128,210,189,6,251
],[
13,2,3,2,2,2,2,223,91,33,16,172,18,228,78,153,144,214,115,128
],[
2,5,3,2,2,2,2,28,182,141,69,212,179,95,174,57,224,6,117,238
],[
2,12,3,2,2,2,2,226,221,156,189,235,157,1,219,237,201,50,109,7
],[
5,2,3,3,3,3,3,73,130,74,68,84,93,3,132,148,216,33,186,133
],[
11,2,3,2,2,2,2,140,173,88,31,165,246,8,180,54,142,157,27,208
],[
2,5,3,2,2,2,2,150,73,14,82,59,16,209,2,129,124,20,221,64
],[
2,10,3,2,2,2,2,147,27,44,107,6,28,88,152,171,233,255,189,45
],[
5,2,2,2,2,2,2,206,71,56,3,189,115,19,158,168,180,133,231,47
],[
65,188,232,123,169,217,201,106,104,61,255,236,185,3,192,173,172,205,186,244
],[
120,196,4,203,18,218,85,96,255,83,116,171,102,131,239,81,105,217,16,200
],[
181,28,13,188,88,245,127,178,212,174,21,236,113,57,138,140,215,116,212,252
],[
219,171,159,140,154,94,249,93,196,69,79,127,59,146,152,86,221,118,208,66
],[
157,230,168,126,217,159,124,73,232,104,133,68,242,151,80,28,4,214,110,104
],[
99,39,110,213,33,38,8,128,239,142,155,163,50,255,218,116,89,255,193,74
],[
109,62,207,2,233,30,111,161,205,114,183,58,238,134,84,19,144,97,197,3
]
]