aLevelData = [
[
5,5,5,5,5,2,2,2,2,2,2,2,2,2,2,2,2,2,120,1
],[
5,2,2,2,2,2,2,2,2,2,2,2,2,2,2,2,2,2,199,134
],[
5,2,5,3,3,3,3,3,3,3,2,2,3,3,3,3,3,3,136,119
],[
2,2,5,2,3,2,2,2,2,2,2,2,3,2,2,2,2,3,184,248
],[
2,2,3,2,3,2,2,2,2,2,2,2,3,2,2,2,2,3,162,17
],[
2,2,3,2,3,3,3,3,3,3,2,2,3,5,5,5,5,5,112,129
],[
4,2,3,2,2,2,2,2,2,3,2,2,3,2,2,2,2,2,52,25
],[
2,2,3,2,2,3,3,3,3,3,2,2,3,3,3,2,2,3,93,231
],[
2,2,2,2,2,3,2,2,2,2,2,2,2,2,3,2,2,3,181,186
],[
2,3,2,2,2,3,2,2,2,3,2,2,3,3,3,2,2,3,82,196
],[
2,3,2,2,2,3,2,2,2,3,2,2,3,5,5,5,5,5,43,111
],[
2,3,2,3,3,2,2,3,2,3,2,2,3,2,2,2,2,2,42,148
],[
2,3,2,3,6,2,2,3,3,3,2,2,3,3,3,3,2,3,241,187
],[
2,3,2,3,8,2,2,3,2,2,2,2,2,2,3,2,2,3,175,13
],[
2,3,2,3,9,2,3,3,2,2,2,2,2,2,3,2,3,3,183,27
],[
2,3,2,3,10,2,3,3,3,2,2,2,2,2,3,2,2,3,186,175
],[
2,3,2,3,11,2,3,3,3,2,2,2,2,2,3,3,2,3,202,57
],[
155,155,150,98,186,168,105,58,127,180,121,174,112,56,41,43,153,31,136,13
],[
49,217,26,91,122,171,220,177,233,73,130,125,135,166,3,110,151,11,87,42
],[
121,103,127,64,206,230,199,93,221,196,72,194,54,100,176,245,148,156,70,183
]
]