aLevelData = [
[
4,2,5,5,202,19,77,75,128,196,254,47,48,227,90,51,29,113,235,7
],[
2,2,2,2,69,73,183,239,241,94,111,33,138,68,233,110,174,242,208,37
],[
2,2,2,2,131,198,155,53,75,201,187,145,57,53,25,217,131,52,191,54
],[
3,3,3,3,185,235,213,134,85,183,208,185,147,182,230,122,131,138,197,18
],[
2,2,3,2,92,89,132,138,19,24,218,16,44,10,142,157,209,131,46,212
],[
13,2,3,2,33,242,4,44,202,30,70,81,218,176,141,200,210,242,136,210
],[
2,5,3,2,252,214,242,148,255,58,193,116,177,106,161,198,44,231,160,168
],[
2,12,3,2,36,103,43,42,120,28,57,179,6,57,198,160,196,179,131,45
],[
5,2,3,3,13,68,204,153,56,182,218,133,111,94,58,158,190,231,125,123
],[
11,2,3,2,107,81,50,200,134,56,17,165,192,90,121,73,129,84,29,235
],[
2,5,3,2,52,172,250,226,230,20,140,11,15,237,65,107,175,11,46,21
],[
157,184,0,78,28,251,54,240,176,26,142,12,48,93,189,211,27,21,99,183
],[
47,221,62,205,56,32,158,118,39,219,25,62,99,164,127,4,100,236,17,92
],[
125,129,237,49,249,86,205,175,106,135,241,95,62,152,90,148,147,254,57,7
],[
77,224,167,190,101,30,150,50,131,147,8,176,208,151,127,0,5,200,180,69
],[
201,11,139,36,57,205,71,40,200,143,250,101,73,161,64,92,74,45,45,31
],[
164,120,132,182,80,101,42,192,124,59,218,93,222,167,25,76,73,5,109,81
],[
126,219,202,218,68,166,77,225,187,218,45,20,237,36,238,52,166,242,215,187
],[
134,53,167,193,84,101,132,32,149,198,52,215,93,235,143,172,102,120,52,22
],[
95,44,124,89,134,30,172,243,121,70,111,55,73,64,131,56,209,77,178,232
]
]