aLevelData = [
[
5,5,5,5,5,2,2,107,25,242,238,210,79,72,65,23,4,227,131,88
],[
5,2,2,2,2,2,2,102,134,122,23,136,78,222,245,15,149,178,188,46
],[
5,2,5,3,3,3,3,23,212,163,212,83,210,206,35,53,255,21,37,241
],[
198,6,186,50,63,45,213,116,0,147,232,174,54,132,157,53,244,149,199,221
],[
202,230,152,97,154,165,20,5,167,211,197,121,239,75,177,1,187,0,137,211
],[
116,134,35,192,184,212,42,23,173,72,21,199,149,235,85,195,163,247,211,171
],[
13,150,153,168,99,237,207,152,31,89,234,107,125,248,32,204,141,108,31,4
],[
134,219,254,28,93,58,116,66,150,204,72,111,91,229,8,70,203,244,254,62
],[
148,192,96,3,196,242,199,26,220,212,226,196,38,88,108,38,73,92,91,166
],[
27,44,91,152,182,73,122,26,206,105,37,60,66,190,83,101,240,123,0,242
],[
206,149,221,31,55,198,70,43,130,216,116,183,217,32,244,112,72,73,87,237
],[
21,83,44,218,80,218,43,87,170,156,179,155,139,54,119,221,94,46,116,116
],[
48,54,38,61,121,175,251,61,57,109,8,135,71,186,250,96,230,157,80,162
],[
154,92,200,94,58,63,23,197,69,151,221,73,121,255,216,255,162,226,88,72
],[
177,61,243,176,13,166,121,22,46,142,43,14,103,195,39,131,3,56,39,161
],[
148,9,107,241,136,186,244,198,253,192,243,217,215,66,129,48,15,32,144,68
],[
77,53,34,98,186,217,185,82,15,170,14,55,243,141,5,182,131,239,225,90
],[
50,81,180,55,211,3,26,206,244,47,39,49,110,26,158,104,58,167,100,18
],[
134,29,52,79,8,41,147,222,147,39,7,131,232,157,132,172,206,8,39,83
],[
101,220,39,38,183,198,8,230,144,52,17,13,144,23,1,179,126,231,254,178
]
]