aLevelData = [
[
6,2,2,2,2,2,2,2,2,2,2,2,2,2,2,2,31,170,80,56
],[
2,2,2,2,2,2,2,2,2,2,2,2,2,2,2,2,226,236,41,23
],[
2,2,2,2,2,2,2,2,2,2,2,2,2,2,2,2,77,212,55,219
],[
3,3,3,3,3,3,3,3,3,3,3,3,3,3,3,3,125,28,31,35
],[
223,136,99,254,151,190,226,94,35,88,158,202,59,56,194,84,252,27,228,203
],[
70,113,135,49,99,109,228,111,233,88,234,72,225,42,131,140,40,91,25,142
],[
22,247,89,215,94,241,54,28,53,185,49,110,183,16,216,177,134,28,141,79
],[
180,183,137,46,227,13,33,223,170,102,71,24,59,64,83,100,67,161,4,25
],[
18,171,193,138,252,113,37,127,255,9,187,226,166,227,6,187,44,88,197,95
],[
229,134,116,227,218,92,22,215,179,241,50,49,219,26,28,136,222,59,117,131
],[
22,93,245,144,134,129,104,217,6,52,247,116,161,100,169,217,59,114,42,154
],[
118,136,202,78,215,45,200,206,37,23,209,165,18,64,196,193,30,60,184,111
],[
183,201,64,134,165,168,238,225,165,171,21,19,84,16,211,87,79,13,79,198
],[
153,172,64,205,61,217,175,221,52,185,253,100,136,62,39,253,186,249,73,227
],[
98,47,97,172,21,46,86,52,139,225,57,215,1,163,202,227,221,81,62,76
],[
145,163,63,162,193,188,53,65,168,255,196,200,184,37,149,204,128,140,90,205
],[
211,210,12,104,39,163,119,207,59,207,249,119,253,160,135,16,170,106,240,186
],[
55,99,102,118,240,181,58,218,95,210,231,10,111,8,82,227,209,85,80,121
],[
159,124,105,196,63,88,220,150,139,113,226,208,46,205,55,214,81,9,215,64
],[
120,168,5,211,166,170,146,175,200,96,92,201,80,128,21,156,33,117,70,28
]
]