aLevelData = [
[
4,2,2,2,2,2,2,2,2,2,214,192,95,28,5,26,219,78,196,34
],[
2,2,3,2,9,2,2,2,2,2,54,38,191,227,28,50,163,103,69,218
],[
2,3,2,2,2,2,3,2,2,3,130,133,247,218,120,251,205,246,143,189
],[
2,3,2,2,2,3,2,2,3,2,184,232,224,140,67,158,251,201,27,162
],[
2,3,2,2,3,2,2,3,2,2,137,140,206,218,48,241,211,113,183,178
],[
2,3,2,3,2,2,3,2,2,3,203,21,107,251,6,99,193,121,73,159
],[
2,2,3,2,2,3,2,2,3,2,60,181,206,169,145,160,141,44,10,110
],[
186,25,40,168,143,84,140,125,75,173,23,90,123,17,81,186,120,1,7,62
],[
49,68,57,0,42,217,51,37,197,48,249,177,193,154,232,159,0,253,155,50
],[
141,204,12,134,221,54,251,106,85,158,148,114,13,76,76,71,212,98,12,66
],[
116,17,145,57,55,12,19,153,169,61,36,181,160,184,220,94,122,237,51,180
],[
166,33,174,59,102,31,62,50,210,42,101,32,33,55,154,175,36,89,239,189
],[
19,125,241,177,140,87,207,11,217,156,191,64,114,114,158,196,194,37,214,104
],[
46,27,133,230,84,10,220,186,144,104,197,52,197,35,200,204,90,147,47,181
],[
130,173,104,181,193,121,172,51,172,198,222,146,240,28,182,189,149,242,30,3
],[
132,33,220,38,71,153,114,174,17,82,66,131,254,134,246,187,155,30,31,177
],[
169,106,28,87,30,20,62,205,109,87,42,50,7,108,126,186,34,69,183,0
],[
185,126,82,158,212,145,49,252,9,73,65,101,67,121,90,96,194,237,102,61
],[
99,161,198,238,34,49,241,24,221,145,94,106,91,254,165,46,140,52,225,29
],[
18,226,88,120,1,91,94,84,227,142,118,54,0,56,187,223,220,88,126,105
]
]