aLevelData = [
[
6,2,8,2,9,2,10,2,11,3,2,2,5,2,2,2,5,2,51,119
],[
2,2,2,2,2,2,2,2,12,3,5,2,2,2,5,2,2,2,67,7
],[
2,2,3,3,3,3,3,3,3,3,2,2,3,3,3,3,3,3,116,116
],[
2,2,3,2,2,2,2,2,2,2,5,2,3,2,2,2,2,3,75,50
],[
2,2,3,2,2,2,2,2,2,2,2,2,3,2,2,2,2,3,106,109
],[
2,2,3,2,3,3,3,3,3,3,2,5,3,2,2,2,2,2,21,248
],[
2,2,3,2,2,2,2,5,5,3,2,2,3,2,2,2,2,2,235,170
],[
2,2,3,5,5,5,2,3,3,3,5,2,3,3,3,2,2,3,86,137
],[
121,124,174,87,207,126,219,119,186,27,45,74,42,80,57,92,137,179,210,140
],[
75,181,53,110,199,36,132,237,69,244,118,53,88,62,76,208,110,137,7,14
],[
165,73,216,171,224,165,216,172,27,125,249,138,251,172,60,146,169,138,37,140
],[
225,181,109,155,70,18,246,100,249,14,4,114,105,42,169,217,109,182,129,26
],[
144,220,160,71,171,225,201,104,186,168,224,28,232,120,162,132,236,254,148,92
],[
152,150,57,107,175,198,136,30,248,11,157,112,144,217,175,12,132,221,66,182
],[
159,133,158,231,129,194,127,183,241,13,14,0,117,168,16,193,31,38,94,192
],[
169,45,149,116,197,123,14,33,174,39,17,69,3,41,69,51,213,29,107,254
],[
255,68,76,152,181,204,240,59,96,81,17,8,169,163,207,239,212,202,166,206
],[
80,71,156,221,140,157,191,73,12,16,206,31,187,173,55,108,131,138,65,163
],[
27,79,139,62,32,245,181,168,104,206,93,91,147,198,77,69,226,232,242,113
],[
77,36,17,227,207,79,181,196,5,107,108,191,247,41,178,170,54,172,174,105
]
]