aLevelData = [
[
5,5,5,5,5,2,2,2,2,122,18,0,129,206,104,74,5,97,144,104
],[
5,2,2,2,2,2,2,2,2,35,219,230,91,172,89,98,75,249,99,188
],[
5,2,5,3,3,3,3,3,3,27,43,29,211,65,183,193,79,213,35,76
],[
2,2,5,2,3,2,2,2,2,133,231,10,120,156,22,102,235,238,94,15
],[
2,2,3,2,3,2,2,2,2,174,177,50,126,224,215,203,215,172,50,191
],[
2,2,3,2,3,3,3,3,3,39,120,220,213,233,95,214,24,208,226,239
],[
4,2,3,2,2,2,2,2,2,42,192,218,232,219,29,177,213,250,73,210
],[
2,2,3,2,2,3,3,3,3,198,108,104,94,167,122,103,33,101,111,60
],[
2,2,2,2,2,3,2,2,2,196,83,99,111,68,203,82,217,163,24,113
],[
2,3,2,2,2,3,2,2,2,172,221,147,193,179,29,13,228,219,49,109
],[
2,3,2,2,2,3,2,2,2,48,243,59,154,2,176,170,156,84,244,105
],[
2,3,2,3,3,2,2,3,2,254,146,79,86,118,170,199,246,200,99,212
],[
2,3,2,3,6,2,2,3,3,103,231,239,175,150,93,195,204,178,238,166
],[
2,3,2,3,8,2,2,3,2,165,224,120,8,186,48,30,150,214,207,165
],[
2,3,2,3,9,2,3,3,2,11,147,127,30,73,32,69,198,168,66,97
],[
2,3,2,3,10,2,3,3,3,42,142,153,131,143,64,37,60,144,247,9
],[
179,9,55,142,153,52,92,106,95,18,118,67,166,13,86,111,247,219,233,254
],[
180,165,197,250,78,105,2,237,185,157,75,164,29,21,52,51,207,38,206,57
],[
127,12,122,101,179,137,250,57,116,207,206,14,70,160,189,89,94,180,178,44
],[
16,91,201,0,135,99,170,177,184,60,22,202,152,90,191,3,141,219,93,8
]
]