aLevelData = [
[
2,2,2,138,221,254,125,202,56,216,108,197,41,164,115,181,144,13,158,63
],[
2,2,2,13,132,173,248,115,226,34,39,121,79,152,205,179,99,86,226,193
],[
2,2,3,140,36,226,199,176,94,136,29,19,70,217,71,122,158,101,39,145
],[
2,3,2,119,202,113,138,68,121,96,7,50,189,167,58,188,249,171,74,121
],[
2,3,2,49,239,249,57,203,207,133,81,151,114,203,51,14,250,178,66,215
],[
2,2,2,253,199,228,144,57,37,216,202,131,152,202,85,1,2,36,191,153
],[
2,2,3,253,40,23,169,193,60,246,249,73,132,193,238,177,182,40,0,227
],[
2,2,3,42,242,109,114,49,253,47,198,168,128,44,122,205,148,174,2,81
],[
2,2,3,243,18,145,174,255,196,57,186,6,107,85,124,196,96,36,63,41
],[
4,2,3,101,182,230,93,148,12,127,2,149,123,27,185,20,81,220,231,114
],[
187,79,185,187,230,252,101,217,101,60,179,7,211,75,189,136,185,158,242,152
],[
177,119,97,163,204,182,53,181,50,242,123,50,8,200,44,199,151,115,103,160
],[
170,157,254,219,55,117,52,61,66,2,197,36,255,183,39,189,55,71,16,119
],[
236,187,56,184,64,193,96,206,147,71,147,40,236,72,172,198,154,230,24,238
],[
27,186,221,33,60,104,219,77,130,118,82,68,201,94,165,109,43,225,94,185
],[
35,159,113,217,242,229,197,175,66,198,240,2,10,109,67,117,177,177,6,186
],[
118,234,4,3,15,3,75,185,144,209,45,113,143,163,138,28,134,27,82,125
],[
120,60,69,225,216,195,253,10,166,187,47,108,219,76,46,156,7,212,176,5
],[
57,57,213,221,31,125,101,87,110,146,89,26,132,112,158,243,77,102,21,198
],[
99,173,222,203,121,67,214,246,249,246,94,183,236,191,95,228,27,82,139,244
]
]