aLevelData = [
[
2,2,3,80,28,163,60,19,27,10,28,120,32,163,151,121,8,105,9,15
],[
2,2,2,186,55,55,3,172,56,234,0,169,160,221,238,209,153,217,123,225
],[
128,31,250,180,82,6,113,10,97,229,237,137,76,51,25,1,45,237,15,244
],[
20,56,110,86,181,72,173,145,93,128,175,204,43,219,151,109,124,138,221,220
],[
167,223,162,138,235,105,64,51,165,97,38,96,198,68,227,47,133,194,128,86
],[
81,215,19,102,10,56,145,77,112,240,228,31,220,75,61,22,46,243,172,215
],[
6,89,238,246,55,86,134,189,120,19,15,41,93,38,208,54,134,253,145,92
],[
23,128,173,90,103,242,105,50,253,24,132,117,184,158,15,192,77,182,127,135
],[
247,2,1,17,105,180,13,196,8,244,62,163,87,130,97,21,178,156,204,232
],[
64,34,241,149,35,248,50,198,241,172,247,21,104,88,254,23,93,202,243,153
],[
246,227,65,41,25,61,39,217,36,16,14,63,223,87,26,192,175,46,255,15
],[
12,127,22,240,52,221,176,66,33,176,170,60,185,147,65,247,70,250,40,44
],[
37,24,216,64,194,0,40,125,196,10,29,163,132,120,3,159,196,89,188,154
],[
158,174,89,53,186,204,231,19,196,1,139,153,29,122,210,241,209,100,66,85
],[
202,82,53,138,67,223,231,170,127,148,205,39,186,12,40,13,96,85,219,135
],[
125,154,121,165,116,255,163,92,245,205,145,207,41,207,238,204,47,252,233,154
],[
204,85,137,242,94,17,64,75,18,248,196,91,87,13,26,218,147,111,243,137
],[
20,129,60,115,73,73,241,114,50,22,50,246,21,102,152,2,115,6,201,119
],[
58,123,74,149,60,161,149,191,224,146,108,126,23,201,108,201,146,136,229,132
],[
51,118,233,70,193,141,163,95,223,51,234,26,63,167,22,63,19,159,19,220
]
]