aLevelData = [
[
12,2,2,40,51,143,183,120,186,214,142,51,13,147,119,87,66,82,95,110
],[
2,2,2,200,150,77,182,251,29,150,128,246,102,80,214,168,113,8,96,43
],[
2,2,3,198,184,137,80,184,243,221,127,235,99,181,190,20,117,23,15,0
],[
11,2,3,83,216,255,216,19,3,124,163,45,127,231,12,51,235,106,101,188
],[
2,2,3,205,140,237,162,236,2,78,109,250,200,106,14,118,113,87,209,209
],[
2,2,3,188,168,141,208,103,239,29,49,72,128,20,145,153,119,173,141,148
],[
10,2,3,252,1,40,64,197,125,108,138,221,146,85,151,164,174,234,89,24
],[
2,2,3,108,173,96,82,8,53,243,83,21,26,96,1,114,17,144,109,122
],[
2,2,3,88,222,87,123,85,41,244,105,122,40,239,212,107,254,173,24,99
],[
9,2,3,15,213,212,212,17,16,157,77,102,13,243,161,169,201,115,70,135
],[
2,2,3,13,79,251,208,56,252,173,205,62,42,156,213,241,249,186,27,127
],[
2,2,3,106,83,202,60,19,243,84,162,24,133,6,150,86,184,225,237,225
],[
8,2,3,167,165,47,177,184,46,155,152,196,3,107,119,121,45,89,178,253
],[
69,97,225,212,209,201,201,4,209,95,138,119,148,2,25,160,208,99,241,98
],[
242,13,6,45,179,163,251,106,236,105,148,25,171,6,110,184,134,137,238,103
],[
47,169,119,75,73,81,224,48,122,92,37,114,194,157,92,29,11,34,235,83
],[
1,185,249,238,35,180,34,103,26,234,111,247,74,254,133,251,168,228,28,157
],[
203,160,179,177,69,81,130,221,51,111,177,253,19,81,199,197,214,242,101,168
],[
54,244,52,249,74,229,28,81,88,194,183,48,234,185,5,231,36,51,97,181
],[
84,18,179,48,203,55,232,230,236,72,159,69,130,176,37,184,87,231,164,19
]
]